Chromosome,strand,trans-spliced position,percent SL2,binomial exact p-value for the percent SL2,number of reads,number of SL1 reads,number of total SL2 reads (SL2+SL2 variant reads),number of SL2 variant reads,non-trans-spliced reads at this position,"type of trans-splice site (gene, cis, other)",gene name,gene rank (within operon),position of first AUG,average exp of the gene (dcpm),distance to upstream gene 3' end,position of the upstream gene 3' end,length of 5' UTR (trans-splice site to first AUG),position of the closest annotated 5' end,distance from the closest annotated 5' end to trans-splice site,distance from the closest annotated 5' end to first AUG downstream of trans-splice site
I,+,11618,0.00119665,0.0,5014,5008,6,6,0,gene,Y74C9A.2,0,11640,9.13074,0,0,22,11618,0,-22
I,+,47463,0.00413223,0.0,484,482,2,2,0,gene,Y48G1C.12,1,47471,0.498897,2786,44677,8,47472,9,1
I,+,49921,0.907895,3.80872e-27,152,14,138,98,4,gene,Y48G1C.4,2,50450,0.354835,64,49857,529,49919,-2,-531
I,+,71847,0.0,0.0,270,270,0,0,6,gene,Y48G1C.2,1,71987,1.03737,17422,54425,140,71858,11,-129
I,+,72511,0.0,9.86076e-32,103,103,0,0,8,gene,Y48G1C.2,1,72530,1.03737,18086,54425,19,72511,0,-19
I,+,81203,0.901408,4.22302e-36,213,21,192,122,36,gene,Y48G1C.10,2,81222,0.282732,136,81067,19,81234,31,12
I,+,81223,0.8,0.15625,5,1,4,2,616,gene,Y48G1C.10,2,81233,0.282732,156,81067,10,81234,11,1
I,+,86824,0.0,0.25,2,2,0,0,0,gene,Y48G1C.11,3,86840,0.391463,1834,84990,16,86841,17,1
I,+,91404,0.882194,0.0,1477,174,1303,766,471,gene,Y48G1C.9,4,91408,3.26721,731,90673,4,91404,0,-4
I,+,91442,0.926829,4.84761e-09,41,3,38,16,1068,gene,Y48G1C.9,4,91511,3.26721,769,90673,69,91404,-38,-107
I,+,91448,1.0,0.25,2,0,2,0,675,gene,Y48G1C.9,4,91511,3.26721,775,90673,63,91404,-44,-107
I,+,93083,0.0,2.86986e-42,138,138,0,0,205,gene,Y48G1C.1,5,93091,0.562813,363,92720,8,93031,-52,-60
I,+,93108,0.0,5.55112e-17,54,54,0,0,243,gene,Y48G1C.1,5,93181,0.562813,388,92720,73,93031,-77,-150
I,+,111038,0.00154781,0.0,71714,71603,111,92,29,gene,F53G12.10,0,111054,136.399,16157,94881,16,111038,0,-16
I,+,113239,0.1875,0.00854492,16,13,3,3,0,gene,F53G12.13,2,113313,0.107346,927,112312,74,113314,75,1
I,+,127292,0.0384615,3.8743e-07,26,25,1,1,19,gene,F53G12.5,0,127296,3.20451,6396,120896,4,127297,5,1
I,+,128697,0.00580552,0.0,1378,1370,8,8,0,gene,F53G12.5,0,128697,3.20451,7801,120896,0,128697,0,0
I,+,173412,0.0,6.61744e-24,77,77,0,0,2,gene,F56C11.6,0,173421,0.396126,26641,146771,9,173412,0,-9
I,+,178526,0.0,1.45519e-11,36,36,0,0,4,gene,F56C11.5,0,178566,0.826222,2536,175990,40,178538,12,-28
I,+,180390,0.0,0.0,594,594,0,0,41,gene,F56C11.5,0,180393,0.826222,4400,175990,3,180260,-130,-133
I,+,183364,0.0,0.0,174,174,0,0,5,gene,F56C11.4,0,183367,0.29645,1200,182164,3,183364,0,-3
I,+,189645,0.0,0.5,1,1,0,0,1,gene,K10E9.1,0,189646,0.280672,1955,187690,1,189654,9,8
I,+,252114,0.0217391,6.53699e-13,46,45,1,1,3,gene,Y48G1BM.1,0,252118,0.0390798,7602,244512,4,252118,4,0
I,+,280120,0.0,3.38813e-21,68,68,0,0,2,gene,C53D5.3,0,280234,0.30345,25864,254256,114,280120,0,-114
I,+,291216,0.00485437,0.0,206,205,1,1,0,gene,C53D5.1,0,291237,0.589411,5101,286115,21,291216,0,-21
I,+,295336,0.0,7.62939e-06,17,17,0,0,3,gene,C53D5.1,0,295367,0.589411,9221,286115,31,295364,28,-3
I,+,295793,0.0,0.5,1,1,0,0,8,gene,C53D5.1,0,295835,0.589411,9678,286115,42,295793,0,-42
I,+,302596,0.0,6.93889e-18,57,57,0,0,3,gene,C53D5.1,0,302671,0.589411,16481,286115,75,302596,0,-75
I,+,323856,0.0,0.0,187,187,0,0,15,gene,Y48G1A.4,1,323860,0.512686,18393,305463,4,323861,5,1
I,+,332612,0.569492,0.00268844,295,127,168,115,2,gene,Y48G1A.3,2,332613,0.64453,1624,330988,1,332613,1,0
I,+,347504,0.00675676,0.0,296,294,2,2,51,gene,Y48G1A.2,0,347577,0.686447,9664,337840,73,347472,-32,-105
I,+,347511,0.0,2.38419e-07,22,22,0,0,243,gene,Y48G1A.2,0,347577,0.686447,9671,337840,66,347472,-39,-105
I,+,348522,0.581818,0.0518042,55,23,32,29,101,gene,Y48G1A.1,0,348537,0.112655,162,348360,15,348538,16,1
I,+,364520,0.00356718,0.0,841,838,3,3,2,gene,R119.7,0,364521,1.30239,7302,357218,1,364522,2,1
I,+,382831,0.0,0.0,521,521,0,0,31,gene,R119.6,0,382835,0.617139,14547,368284,4,382836,5,1
I,+,398894,0.00276243,0.0,362,361,1,1,5,gene,Y50C1A.1,0,398918,0.903571,10327,388567,24,398894,0,-24
I,+,420929,0.0,5.87747e-39,127,127,0,0,0,gene,C07F11.2,0,420936,0.0705429,8416,412513,7,420925,-4,-11
I,+,444002,0.0162602,7.05579e-34,123,121,2,2,0,gene,C07F11.1,1,444006,0.941942,20284,423718,4,444002,0,-4
I,+,461998,0.426605,0.000346172,436,250,186,99,0,gene,W04C9.4,2,462002,1.86445,390,461608,4,461998,0,-4
I,+,488610,0.00863465,0.0,1853,1837,16,13,18,gene,W04C9.2,0,488618,4.68833,6592,482018,8,488619,9,1
I,+,506474,0.00226831,0.0,3086,3079,7,7,33,gene,Y65B4BL.2,0,506479,1.43483,10318,496156,5,506480,6,1
I,+,506517,0.0,0.00390625,8,8,0,0,364,gene,Y65B4BL.2,0,506588,1.43483,10361,496156,71,506480,-37,-108
I,+,534458,0.0224719,0.0,178,174,4,4,5,gene,Y65B4BR.8,1,534460,1.1496,1144,533314,2,534461,3,1
I,+,535794,0.00572224,0.0,12932,12858,74,64,9,gene,Y65B4BR.5,2,535810,54.9572,447,535347,16,535794,0,-16
I,+,537125,0.172543,0.0,1333,1103,230,194,7,gene,Y65B4BR.4,3,537132,2.75551,457,536668,7,537125,0,-7
I,+,550699,0.0,0.0,156,156,0,0,3,gene,Y65B4BR.3,0,550710,0.709752,8487,542212,11,550711,12,1
I,+,618197,0.0,0.125,3,3,0,0,92,gene,F56A6.1,0,618209,0.173737,32881,585316,12,618210,13,1
I,+,645454,0.0,0.0,213,213,0,0,0,gene,Y65B4A.2,1,645455,0.360179,7603,637851,1,645454,0,-1
I,+,654123,0.0414201,9.20526e-40,169,162,7,5,74,gene,Y65B4A.1,2,654130,0.640065,133,653990,7,654099,-24,-31
I,+,680424,0.0,4.33681e-19,61,61,0,0,4,gene,Y18H1A.11,0,680432,0.193774,21660,658764,8,680433,9,1
I,+,720072,0.0,4.33681e-19,61,61,0,0,136,gene,Y18H1A.6,0,720080,0.301488,28741,691331,8,720014,-58,-66
I,+,745849,0.0,7.62939e-06,17,17,0,0,1,gene,Y18H1A.12,0,745872,0.0284729,3971,741878,23,745755,-94,-117
I,+,745907,0.0,0.125,3,3,0,0,0,gene,Y18H1A.12,0,746138,0.0284729,4029,741878,231,745755,-152,-383
I,+,763776,0.0,0.25,2,2,0,0,31,gene,T06A4.3,0,763809,0.329291,3328,760448,33,763677,-99,-132
I,+,803370,0.0126582,1.30695e-22,79,78,1,0,0,gene,ZC123.3,0,803395,0.690718,27000,776370,25,803370,0,-25
I,+,837998,0.0,6.31089e-30,97,97,0,0,4,gene,ZC123.1,0,837998,0.6685,2701,835297,0,837998,0,0
I,+,853455,0.00441696,0.0,1132,1127,5,5,2,gene,Y95B8A.8,0,853460,0.985459,11707,841748,5,853461,6,1
I,+,884906,0.0,0.5,1,1,0,0,0,gene,Y95B8A.6,0,885044,0.306009,12949,871957,138,884906,0,-138
I,+,886509,0.0,0.5,1,1,0,0,4,gene,Y95B8A.6,0,886538,0.306009,14552,871957,29,886509,0,-29
I,+,897288,0.0,0.0,239,239,0,0,0,gene,Y95B8A.5,0,897291,0.729815,7416,889872,3,897288,0,-3
I,+,938510,0.00255102,0.0,392,391,1,0,138,gene,Y95B8A.2,0,938626,0.872478,27314,911196,116,938485,-25,-141
I,+,989673,0.0,0.0,251,251,0,0,0,gene,F54A5.1,0,989684,0.422422,41961,947712,11,989673,0,-11
I,+,995758,0.0,0.00195312,9,9,0,0,2,gene,C54G6.3,0,995832,0.0344172,3577,992181,74,996047,289,215
I,+,1016407,0.000549451,0.0,16380,16371,9,9,0,gene,C54G6.5,0,1016411,26.0543,5640,1010767,4,1016407,0,-4
I,+,1018837,0.00221117,0.0,1809,1805,4,4,0,gene,Y34D9A.11,0,1018844,1.62865,1659,1017178,7,1018837,0,-7
I,+,1034469,0.0,0.0625,4,4,0,0,92,gene,Y34D9A.3,1,1034474,0.241097,15238,1019231,5,1034474,5,0
I,+,1041476,0.840206,3.21187e-23,194,31,163,136,2,gene,Y34D9A.7,2,1041485,0.363713,612,1040864,9,1041486,10,1
I,+,1049598,0.257418,0.0,2494,1852,642,510,8,gene,Y34D9A.6,3,1049604,5.33125,494,1049104,6,1049596,-2,-8
I,+,1085991,0.0,0.125,3,3,0,0,1,gene,R06A10.1,0,1086391,0.378286,9599,1076392,400,1085970,-21,-421
I,+,1088918,0.333333,0.375,3,2,1,0,6,gene,R06A10.5,0,1089126,0.0702146,317,1088601,208,1089127,209,1
I,+,1089092,0.0,0.5,1,1,0,0,5,gene,R06A10.5,0,1089126,0.0702146,491,1088601,34,1089127,35,1
I,+,1156581,0.0079968,0.0,30012,29772,240,215,8,gene,Y48G8AL.8,1,1156598,115.451,24827,1131754,17,1156581,0,-17
I,+,1157560,0.9,0.00976562,10,1,9,6,1,gene,Y48G8AL.7,2,1157572,0.360859,67,1157493,12,1157571,11,-1
I,+,1157573,0.929688,5.60202e-26,128,9,119,95,42,gene,Y48G8AL.7,2,1157650,0.360859,80,1157493,77,1157571,-2,-79
I,+,1176475,0.00316456,0.0,316,315,1,1,3,gene,Y48G8AL.6,1,1176476,0.750652,13598,1162877,1,1176475,0,-1
I,+,1193160,0.935065,0.0,462,30,432,292,0,gene,Y48G8AL.5,2,1193199,1.33683,2327,1190833,39,1193160,0,-39
I,+,1211487,0.838235,5.1942e-09,68,11,57,44,3,gene,Y48G8AL.1,3,1211496,0.581505,51,1211436,9,1211494,7,-2
I,+,1211494,0.931707,3.27974e-41,205,14,191,145,50,gene,Y48G8AL.1,3,1211496,0.581505,58,1211436,2,1211494,0,-2
I,+,1254771,0.928571,2.10146e-17,84,6,78,59,2,gene,Y48G8AL.15,4,1254777,0.30183,101,1254670,6,1254771,0,-6
I,+,1305563,0.0,4.33681e-19,61,61,0,0,2,gene,K12C11.4,0,1305565,0.614665,17333,1288230,2,1305576,13,11
I,+,1335393,0.0,0.000976562,10,10,0,0,135,gene,K12C11.3,0,1335395,0.182869,1318,1334075,2,1335396,3,1
I,+,1337015,0.00791139,0.0,632,627,5,2,2,gene,K12C11.6,1,1337020,0.80308,147,1336868,5,1337021,6,1
I,+,1338787,0.874564,3.3292e-41,287,36,251,123,2,gene,K12C11.7,2,1338807,0.15322,567,1338220,20,1338786,-1,-21
I,+,1338796,1.0,0.5,1,0,1,0,701,gene,K12C11.7,2,1338807,0.15322,576,1338220,11,1338786,-10,-21
I,+,1340686,0.00623547,0.0,9462,9403,59,54,3,gene,K12C11.2,3,1340703,25.2793,929,1339757,17,1340679,-7,-24
I,+,1348506,0.0,0.03125,5,5,0,0,2,gene,Y92H12BL.1,0,1348524,0.64759,7251,1341255,18,1348504,-2,-20
I,+,1365310,0.0206298,0.0,921,902,19,14,2,gene,Y92H12BL.5,0,1365521,0.649258,6796,1358514,211,1365310,0,-211
I,+,1394570,0.00546448,0.0,183,182,1,1,2,gene,Y92H12BR.7,1,1394598,0.189466,18692,1375878,28,1394570,0,-28
I,+,1405936,0.74359,4.2736e-08,117,30,87,58,1,gene,Y92H12BR.6,2,1405944,0.275226,3701,1402235,8,1405945,9,1
I,+,1416589,0.00470035,0.0,1702,1694,8,7,0,gene,Y92H12BR.3,0,1416591,1.57483,3488,1413101,2,1416592,3,1
I,+,1436280,0.00740741,0.0,270,268,2,2,1,gene,Y92H12BR.8,0,1436292,1.18377,11028,1425252,12,1436280,0,-12
I,+,1436293,0.00768246,0.0,781,775,6,4,479,gene,Y92H12BR.8,0,1436368,1.18377,11041,1425252,75,1436280,-13,-88
I,+,1446655,0.0,2.98023e-08,25,25,0,0,1,gene,F47G6.4,0,1446666,0.425242,5319,1441336,11,1446667,12,1
I,+,1483084,0.0134228,1.54507e-41,149,147,2,2,1,gene,F47G6.1,0,1483106,0.319994,3160,1479924,22,1483084,0,-22
I,+,1514758,0.00692042,0.0,289,287,2,2,1,gene,Y92H12A.4,0,1514762,0.364444,24095,1490663,4,1514763,5,1
I,+,1543526,0.0,0.0,220,220,0,0,0,gene,Y92H12A.2,0,1543573,0.678027,2606,1540920,47,1543526,0,-47
I,+,1566932,0.00353357,0.0,283,282,1,0,1,gene,Y92H12A.1,0,1566973,1.41892,10737,1556195,41,1566932,0,-41
I,+,1567602,0.0,0.5,1,1,0,0,2,gene,Y92H12A.1,0,1567609,1.41892,11407,1556195,7,1567602,0,-7
I,+,1586168,0.0,0.5,1,1,0,0,1,gene,Y73E7A.3,0,1586285,0.17911,5970,1580198,117,1586168,0,-117
I,+,1601839,0.00990099,3.98375e-29,101,100,1,1,1,gene,Y73E7A.2,0,1601840,0.395823,8170,1593669,1,1601841,2,1
I,+,1610389,0.00917431,0.0,327,324,3,2,0,gene,Y73E7A.9,0,1610390,0.31678,3462,1606927,1,1610391,2,1
I,+,1629006,0.0176991,0.0,565,555,10,5,1,gene,Y73E7A.1,0,1629022,1.40756,8985,1620021,16,1629006,0,-16
I,+,1667624,0.0,0.25,2,2,0,0,1,gene,Y71G12B.17,0,1667728,0.416455,12224,1655400,104,1667502,-122,-226
I,+,1667661,0.0,7.70372e-34,110,110,0,0,8,gene,Y71G12B.17,0,1667728,0.416455,12261,1655400,67,1667502,-159,-226
I,+,1698350,0.00189215,0.0,3171,3165,6,6,37,gene,Y71G12B.15,1,1698351,4.68562,13153,1685197,1,1698350,0,-1
I,+,1701362,0.0516454,0.0,6351,6023,328,228,13,gene,Y71G12B.14,2,1701372,8.46531,233,1701129,10,1701359,-3,-13
I,+,1701370,0.125,0.03125,8,7,1,1,2736,gene,Y71G12B.14,2,1701372,8.46531,241,1701129,2,1701359,-11,-13
I,+,1702106,0.00306748,0.0,326,325,1,1,4,gene,Y71G12B.13,3,1702123,0.482053,299,1701807,17,1702124,18,1
I,+,1702369,0.0,0.5,1,1,0,0,10,gene,Y71G12B.13,3,1702572,0.482053,562,1701807,203,1702124,-245,-448
I,+,1709588,0.767986,1.07837e-38,556,129,427,291,78,gene,Y71G12B.12,4,1709601,1.32411,1002,1708586,13,1709588,0,-13
I,+,1721593,0.00137741,0.0,1452,1450,2,2,6,gene,Y71G12B.11,0,1721597,2.10246,6029,1715564,4,1721593,0,-4
I,+,1751482,0.00685871,0.0,729,724,5,5,2,gene,Y71G12B.10,1,1751493,0.933656,10801,1740681,11,1751482,0,-11
I,+,1755330,0.66537,3.16621e-08,257,86,171,115,1,gene,Y71G12B.9,2,1755330,0.79659,920,1754410,0,1755330,0,0
I,+,1767888,0.918367,1.4013e-45,245,20,225,144,21,gene,Y71G12B.8,3,1767900,0.685682,1490,1766398,12,1767888,0,-12
I,+,1793255,0.0,0.0,236,236,0,0,0,gene,Y71G12B.6,0,1793260,1.12296,3097,1790158,5,1793255,0,-5
I,+,1823448,0.0204082,0.0,539,528,11,11,12,gene,Y71G12B.1,0,1823454,1.14074,4868,1818580,6,1823448,0,-6
I,+,1831801,0.0,0.5,1,1,0,0,0,gene,Y71G12B.28,0,1831896,0.003409,2079,1829722,95,1831801,0,-95
I,+,1832898,0.0193906,0.0,361,354,7,7,0,gene,C53H9.2,1,1833012,2.54033,835,1832063,114,1832898,0,-114
I,+,1833220,0.0,0.5,1,1,0,0,1,gene,C53H9.2,1,1833337,2.54033,1157,1832063,117,1833220,0,-117
I,+,1834884,0.860278,0.0,66024,9225,56799,37249,6,gene,C53H9.1,2,1834889,129.53,124,1834760,5,1834884,0,-5
I,+,1841995,0.0,0.000976562,10,10,0,0,5,gene,M01D7.6,0,1842225,2.45235,58,1841937,230,1842444,449,219
I,+,1842446,0.00355745,0.0,2811,2801,10,6,8,gene,M01D7.6,0,1842460,2.45235,509,1841937,14,1842446,0,-14
I,+,1845209,0.133333,2.31497e-07,45,39,6,5,18,gene,M01D7.4,0,1845221,0.243595,1240,1843969,12,1845222,13,1
I,+,1895231,0.0,3.05176e-05,15,15,0,0,13,gene,Y71G12A.2,0,1895235,0.252989,11036,1884195,4,1895236,5,1
I,+,1917035,0.0,0.03125,5,5,0,0,20,gene,Y51F10.6,1,1917045,0.277366,5419,1911616,10,1917046,11,1
I,+,1924301,0.946809,0.0,282,15,267,185,0,gene,Y51F10.5,2,1924309,0.387333,1204,1923097,8,1924301,0,-8
I,+,1924405,0.0,0.0625,4,4,0,0,85,gene,Y51F10.5,2,1924424,0.387333,1308,1923097,19,1924301,-104,-123
I,+,1932345,0.982456,3.95517e-16,57,1,56,39,10,gene,Y51F10.4,3,1932353,0.490136,84,1932261,8,1932353,8,0
I,+,1932353,0.945355,0.0,366,20,346,227,89,gene,Y51F10.4,3,1932353,0.490136,92,1932261,0,1932353,0,0
I,+,1961641,1.0,0.5,1,0,1,1,1,gene,Y51F10.11,1,1961666,0.151491,16422,1945219,25,1961617,-24,-49
I,+,1967774,0.899384,0.0,487,49,438,294,1,gene,Y51F10.3,2,1967819,1.27924,2692,1965082,45,1967820,46,1
I,+,2026318,0.00593472,0.0,337,335,2,2,3,gene,Y20F4.2,0,2026408,0.729539,42904,1983414,90,2026318,0,-90
I,+,2064295,0.00426309,0.0,6568,6540,28,24,8,gene,Y37E3.3,1,2064306,5.36484,30336,2033959,11,2064295,0,-11
I,+,2064978,0.487776,0.00246094,5072,2598,2474,1752,21,gene,Y37E3.4,2,2065069,7.51932,181,2064797,91,2064978,0,-91
I,+,2071354,0.00975419,0.0,2563,2538,25,20,12,gene,Y37E3.9,1,2071354,6.0085,2303,2069051,0,2071354,0,0
I,+,2072682,0.891943,0.0,1055,114,941,638,0,gene,Y37E3.10,2,2072690,3.27819,111,2072571,8,2072682,0,-8
I,+,2078963,0.336554,7.10822e-17,621,412,209,151,1,gene,Y37E3.11,3,2078969,1.74164,2037,2076926,6,2078970,7,1
I,+,2097348,0.00334169,0.0,1197,1193,4,4,5,gene,Y37E3.15,0,2097348,1.26586,11700,2085648,0,2097348,0,0
I,+,2128592,0.50234,0.0312822,641,319,322,271,2,gene,Y37E3.17,0,2128680,2.14146,5151,2123441,88,2128592,0,-88
I,+,2160044,0.0,9.62965e-35,113,113,0,0,3,gene,W03F11.6,0,2160058,1.5688,10738,2149306,14,2160044,0,-14
I,+,2216101,0.0487805,3.72893e-10,41,39,2,1,6,gene,W03F11.5,0,2216203,0.0820303,6466,2209635,102,2216101,0,-102
I,+,2250132,0.00314465,0.0,318,317,1,1,1,gene,F12B6.2,0,2250145,0.251606,2850,2247282,13,2250132,0,-13
I,+,2279836,0.0,0.0,544,544,0,0,1,gene,Y39G10AL.1,0,2279847,0.589141,24935,2254901,11,2279835,-1,-12
I,+,2293133,0.00133869,0.0,1494,1492,2,1,25,gene,Y39G10AR.11,0,2293217,2.72477,11907,2281226,84,2293133,0,-84
I,+,2300087,0.00222469,0.0,899,897,2,1,6,gene,Y39G10AR.10,0,2300113,3.15101,2741,2297346,26,2300087,0,-26
I,+,2307405,0.0060423,0.0,331,329,2,2,10,gene,Y39G10AR.9,1,2307410,0.850411,4563,2302842,5,2307405,0,-5
I,+,2308977,0.869318,3.98358e-25,176,23,153,109,0,gene,Y39G10AR.21,2,2308977,0.431761,64,2308913,0,2308977,0,0
I,+,2312497,0.384567,8.51201e-40,3188,1962,1226,982,14,gene,Y39G10AR.20,3,2312510,5.72974,367,2312130,13,2312497,0,-13
I,+,2313272,0.00601017,0.0,2163,2150,13,10,4,gene,Y39G10AR.8,0,2313311,3.61185,265,2313007,39,2313272,0,-39
I,+,2316308,0.0111732,0.0,179,177,2,2,2,gene,Y39G10AR.7,0,2316309,0.474575,293,2316015,1,2316308,0,-1
I,+,2402233,0.00362976,0.0,551,549,2,2,1,gene,Y39G10AR.2,0,2402235,0.813493,29268,2372965,2,2402233,0,-2
I,+,2415134,0.0,0.0,160,160,0,0,0,gene,F23C8.13,0,2415173,2.3194,5148,2409986,39,2415134,0,-39
I,+,2434005,0.00188857,0.0,1059,1057,2,2,2,gene,F23C8.4,0,2434011,1.66359,15467,2418538,6,2434005,0,-6
I,+,2438768,0.0306122,4.7993e-25,98,95,3,1,2,gene,F23C8.3,0,2438775,0.123594,3058,2435710,7,2438802,34,27
I,+,2485868,0.00690846,0.0,1158,1150,8,8,3,gene,Y74C10AR.1,1,2485869,3.18805,2143,2483725,1,2485870,2,1
I,+,2489977,0.797688,4.31483e-16,173,35,138,93,4,gene,Y23H5B.6,2,2489984,0.691872,195,2489782,7,2489977,0,-7
I,+,2498135,0.811715,1.20668e-23,239,45,194,136,1,gene,Y23H5B.5,3,2498136,0.615048,754,2497381,1,2498135,0,-1
I,+,2533269,0.0,1.2326e-32,106,106,0,0,0,gene,Y23H5B.4,0,2533291,0.160332,21116,2512153,22,2533269,0,-22
I,+,2552734,0.0,0.03125,5,5,0,0,2,gene,Y23H5B.1,0,2552744,0.0856308,2535,2550199,10,2553035,301,291
I,+,2553047,0.0,0.000488281,11,11,0,0,86,gene,Y23H5B.1,0,2553094,0.0856308,2848,2550199,47,2553035,-12,-59
I,+,2606755,0.00357143,0.0,280,279,1,0,0,gene,Y23H5A.5,0,2606783,0.995132,4106,2602649,28,2606755,0,-28
I,+,2620657,0.00754717,0.0,795,789,6,5,2,gene,Y23H5A.3,1,2620659,1.69208,234,2620423,2,2620660,3,1
I,+,2621958,0.963687,0.0,358,13,345,267,0,gene,Y23H5A.2,2,2621994,0.420049,99,2621859,36,2621958,0,-36
I,+,2629686,0.0,1.45519e-11,36,36,0,0,0,gene,Y23H5A.1,0,2629700,0.103598,6511,2623175,14,2629686,0,-14
I,+,2642725,0.0117371,0.0,426,421,5,5,37,gene,F40E3.2,0,2642740,0.898509,3258,2639467,15,2642741,16,1
I,+,2668168,0.00888099,0.0,563,558,5,3,7,gene,F32B5.6,0,2668168,1.59663,22766,2645402,0,2668168,0,0
I,+,2668794,0.0,0.5,1,1,0,0,11,gene,F32B5.6,0,2668848,1.59663,23392,2645402,54,2668794,0,-54
I,+,2697402,0.0,1.29247e-26,86,86,0,0,2,gene,F32B5.2,0,2697416,0.112091,3317,2694085,14,2697441,39,25
I,+,2707600,0.0031746,0.0,315,314,1,1,0,gene,Y71F9B.5,0,2707629,0.717804,5504,2702096,29,2707600,0,-29
I,+,2727015,0.00506829,0.0,11641,11582,59,50,1,gene,Y71F9B.4,1,2727018,8.99733,9471,2717544,3,2727015,0,-3
I,+,2730005,0.0770389,0.0,3985,3678,307,232,14,gene,Y71F9B.3,2,2730010,8.66835,2100,2727905,5,2730005,0,-5
I,+,2731563,0.902736,0.0,329,32,297,220,9,gene,Y71F9B.2,3,2731564,0.436655,106,2731457,1,2731565,2,1
I,+,2774913,0.0,0.0,376,376,0,0,4,gene,Y71F9B.1,0,2774913,0.658065,39599,2735314,0,2774914,1,1
I,+,2791688,0.012987,5.09543e-22,77,76,1,1,7,gene,W03D8.8,0,2791689,0.205357,4141,2787547,1,2791690,2,1
I,+,2796133,0.0,0.00012207,13,13,0,0,0,gene,W03D8.7,0,2796160,0.0202279,1170,2794963,27,2796384,251,224
I,+,2802810,0.0140845,1.79564e-39,142,140,2,2,1,gene,W03D8.6,0,2802822,0.53485,5548,2797262,12,2802823,13,1
I,+,2846716,0.0,0.125,3,3,0,0,0,gene,W10C8.1,0,2846720,0.0166902,25901,2820815,4,2846721,5,1
I,+,2866509,0.00220751,0.0,906,904,2,2,1,gene,Y71F9AL.10,0,2866540,1.23225,16716,2849793,31,2866509,0,-31
I,+,2876933,0.00265403,0.0,5275,5261,14,11,4,gene,Y71F9AL.9,1,2876936,9.43854,6765,2870168,3,2876933,0,-3
I,+,2878579,0.987421,1.68156e-44,159,2,157,126,3,gene,Y71F9AL.8,2,2878615,0.27713,57,2878522,36,2878579,0,-36
I,+,2887511,0.0,0.25,2,2,0,0,29,gene,Y71F9AL.7,0,2887539,0.591919,6647,2880864,28,2887801,290,262
I,+,2901328,0.00406229,0.0,1477,1471,6,6,6,gene,Y71F9AL.5,0,2901341,0.313813,10066,2891262,13,2901342,14,1
I,+,2925241,0.0,0.0,282,282,0,0,65,gene,Y71F9AL.1,0,2925245,0.379682,6407,2918834,4,2924933,-308,-312
I,+,2928396,0.00314465,0.0,3816,3804,12,9,20,gene,Y71F9AM.6,1,2928397,11.484,261,2928135,1,2928396,0,-1
I,+,2929834,0.234421,0.0,1011,774,237,191,1178,gene,Y71F9AM.5,2,2929840,2.20818,144,2929690,6,2929785,-49,-55
I,+,2931462,0.975524,0.0,286,7,279,179,44,gene,Y71F9AM.4,3,2931476,0.618405,101,2931361,14,2931462,0,-14
I,+,2935626,0.0,0.125,3,3,0,0,0,gene,Y71F9AM.4,3,2935683,0.618405,4265,2931361,57,2935624,-2,-59
I,+,2935988,0.0,0.015625,6,6,0,0,1,gene,Y71F9AM.4,3,2936042,0.618405,4627,2931361,54,2935988,0,-54
I,+,2996469,0.142857,0.0546875,7,6,1,1,106,gene,Y54E10BL.4,0,2996510,0.382404,47719,2948750,41,2996407,-62,-103
I,+,3010691,0.00422654,0.0,1183,1178,5,3,123,gene,Y54E10BL.2,0,3010799,6.40587,4748,3005943,108,3010691,0,-108
I,+,3015743,0.0100775,0.0,1290,1277,13,12,4,gene,Y54E10BR.4,1,3015745,2.33872,3302,3012441,2,3015743,0,-2
I,+,3021652,0.856703,0.0,649,93,556,389,3,gene,Y54E10BR.3,2,3021664,1.27149,122,3021530,12,3021650,-2,-14
I,+,3104364,0.0,4.23516e-22,71,71,0,0,3,gene,C45E1.1,0,3104368,0.55052,34969,3069395,4,3104364,0,-4
I,+,3148015,0.00363636,0.0,825,822,3,2,49,gene,K09H9.2,0,3148017,0.528468,9572,3138443,2,3148015,0,-2
I,+,3162814,0.00542888,0.0,921,916,5,5,347,gene,Y54E10A.7,1,3162816,1.52864,8421,3154393,2,3162814,0,-2
I,+,3163689,0.949198,0.0,374,19,355,230,2,gene,Y54E10A.6,2,3163692,0.652458,58,3163631,3,3163689,0,-3
I,+,3168194,0.944109,0.0,662,37,625,452,9,gene,Y54E10A.5,3,3168212,1.21357,715,3167479,18,3168194,0,-18
I,+,3168211,1.0,0.25,2,0,2,2,591,gene,Y54E10A.5,3,3168212,1.21357,732,3167479,1,3168194,-17,-18
I,+,3206802,0.0021978,0.0,455,454,1,1,37,gene,Y54E10A.17,0,3206804,2.70346,35576,3171226,2,3206802,0,-2
I,+,3211047,0.0,5.68434e-14,44,44,0,0,1,gene,Y54E10A.4,0,3211058,0.189175,782,3210265,11,3211047,0,-11
I,+,3212991,0.0,5.42101e-20,64,64,0,0,1,gene,Y54E10A.4,0,3213032,0.189175,2726,3210265,41,3212991,0,-41
I,+,3229432,0.00475436,0.0,2524,2512,12,11,3,gene,Y54E10A.3,1,3229448,1.80969,12067,3217365,16,3229433,1,-15
I,+,3233392,0.94012,1.88835e-35,167,10,157,109,36,gene,Y54E10A.2,2,3233409,0.601355,97,3233295,17,3233392,0,-17
I,+,3259800,0.0,5.82077e-11,34,34,0,0,0,gene,Y44E3B.2,0,3259871,0.142683,3716,3256084,71,3259872,72,1
I,+,3267095,0.0183983,0.0,924,907,17,14,2,gene,W01B11.3,0,3267102,5.60073,2832,3264263,7,3267095,0,-7
I,+,3352435,0.0,0.25,2,2,0,0,6,gene,W05F2.7,0,3352463,0.1283,12233,3340202,28,3352464,29,1
I,+,3368826,0.0,0.125,3,3,0,0,76,gene,W05F2.6,1,3368860,0.631252,5394,3363432,34,3368815,-11,-45
I,+,3368852,0.0,0.0,519,519,0,0,21,gene,W05F2.6,1,3368860,0.631252,5420,3363432,8,3368815,-37,-45
I,+,3371758,0.733333,0.00545096,30,8,22,19,6,gene,W05F2.5,2,3371769,0.0956465,312,3371446,11,3371770,12,1
I,+,3421160,0.0,0.25,2,2,0,0,1,gene,K03E5.2,0,3421163,1.41816,6059,3415101,3,3421159,-1,-4
I,+,3423210,0.0,0.5,1,1,0,0,3,gene,K03E5.2,0,3423227,1.41816,690,3422520,17,3423208,-2,-19
I,+,3423881,0.0,0.03125,5,5,0,0,0,gene,K03E5.2,0,3423883,1.41816,1361,3422520,2,3423881,0,-2
I,+,3439104,0.0112994,0.0,177,175,2,2,1,gene,Y47G6A.28,1,3439108,0.356545,5896,3433208,4,3439109,5,1
I,+,3449327,0.86194,7.84017e-36,268,37,231,197,1,gene,Y47G6A.11,2,3449327,0.53872,151,3449176,0,3449328,1,1
I,+,3467133,0.00977199,0.0,921,912,9,7,10,gene,Y47G6A.10,1,3467134,0.667445,4956,3462177,1,3467133,0,-1
I,+,3479357,0.877844,0.0,835,102,733,559,2,gene,Y47G6A.9,2,3479395,0.82548,837,3478520,38,3479330,-27,-65
I,+,3481988,0.016,1.82202e-34,125,123,2,1,1,gene,Y47G6A.8,3,3482030,1.68252,549,3481439,42,3481988,0,-42
I,+,3481998,0.0249633,0.0,681,664,17,16,108,gene,Y47G6A.8,3,3482030,1.68252,559,3481439,32,3481988,-10,-42
I,+,3502740,0.0027248,0.0,367,366,1,1,2,gene,Y47G6A.7,0,3502792,0.790217,18237,3484503,52,3502740,0,-52
I,+,3502904,0.0,7.62939e-06,17,17,0,0,448,gene,Y47G6A.7,0,3502927,0.790217,18401,3484503,23,3502904,0,-23
I,+,3534797,0.0,0.25,2,2,0,0,5,gene,Y47G6A.5,0,3534807,0.310367,11405,3523392,10,3534797,0,-10
I,+,3564045,0.0,0.25,2,2,0,0,14,gene,Y47G6A.33,0,3564089,None,6611,3557434,44,3564066,21,-23
I,+,3603367,1.0,0.5,1,0,1,1,6,gene,Y47G6A.31,0,3603425,0.213185,459,3602908,58,3603345,-22,-80
I,+,3608520,0.00511509,0.0,391,389,2,2,0,gene,Y47G6A.2,1,3608617,0.852491,3998,3604522,97,3608520,0,-97
I,+,3611944,0.885463,0.0,454,52,402,342,6,gene,Y47G6A.1,2,3612081,0.32617,116,3611828,137,3611944,0,-137
I,+,3620620,0.0,0.125,3,3,0,0,27,gene,Y47G6A.32,0,3620686,0.0591838,2301,3618319,66,3620584,-36,-102
I,+,3629439,0.00515464,0.0,194,193,1,0,1,gene,T28F2.3,0,3629472,0.740492,3887,3625552,33,3629473,34,1
I,+,3637355,0.0,0.0,215,215,0,0,2,gene,T28F2.2,0,3637502,0.509458,6278,3631077,147,3637355,0,-147
I,+,3637556,0.0,0.5,1,1,0,0,2,gene,T28F2.2,0,3637576,0.509458,6479,3631077,20,3637556,0,-20
I,+,3653999,0.0,0.25,2,2,0,0,1,gene,T28F2.8,0,3654133,16.1891,1577,3652422,134,3653960,-39,-173
I,+,3684787,0.0,1.97215e-31,102,102,0,0,7,gene,D1037.1,0,3684803,0.425854,29460,3655327,16,3684804,17,1
I,+,3698104,0.0,0.0,176,176,0,0,5,gene,H26D21.1,0,3698113,0.289618,7951,3690153,9,3698097,-7,-16
I,+,3727029,0.0,0.015625,6,6,0,0,4,gene,T12F5.3,1,3727062,0.360231,13914,3713115,33,3727029,0,-33
I,+,3731354,0.847059,1.90975e-11,85,13,72,61,5,gene,T12F5.2,2,3731372,0.140618,118,3731236,18,3731354,0,-18
I,+,3741460,0.0143541,0.0,209,206,3,3,1,gene,T12F5.1,0,3741469,0.617858,8518,3732942,9,3741470,10,1
I,+,3746674,0.0,0.125,3,3,0,0,1,gene,Y8G1A.1,0,3746676,0.00909021,4026,3742648,2,3746677,3,1
I,+,3769675,0.0,0.25,2,2,0,0,0,gene,ZK770.1,0,3769682,0.0217592,21451,3748224,7,3769683,8,1
I,+,3781775,0.0,0.25,2,2,0,0,2,gene,C32E8.5,0,3781781,0.953873,4305,3777470,6,3782120,345,339
I,+,3782120,0.00573888,0.0,697,693,4,4,0,gene,C32E8.5,0,3782138,0.953873,4650,3777470,18,3782120,0,-18
I,+,3786590,0.00598802,0.0,1336,1328,8,5,23,gene,C32E8.3,1,3786595,2.12198,2362,3784228,5,3786596,6,1
I,+,3788038,0.00672674,0.0,23637,23478,159,131,2,gene,C32E8.2,2,3788043,111.374,542,3787496,5,3788038,0,-5
I,+,3818076,0.00575013,0.0,1913,1902,11,9,8,gene,F53F10.5,0,3818080,1.53582,21369,3796707,4,3818076,0,-4
I,+,3824417,0.0,0.00390625,8,8,0,0,1,gene,F53F10.4,1,3824533,6.135,2910,3821507,116,3824949,532,416
I,+,3824949,0.134682,0.0,4893,4234,659,516,2,gene,F53F10.4,1,3824952,6.135,3442,3821507,3,3824949,0,-3
I,+,3827221,0.410569,3.4653e-09,984,580,404,262,3,gene,F53F10.3,2,3827238,3.57314,710,3826511,17,3827221,0,-17
I,+,3831119,0.0213707,0.0,1357,1328,29,26,28,gene,F53F10.2,0,3831218,4.22036,1796,3829323,99,3831119,0,-99
I,+,3831364,0.0,0.25,2,2,0,0,1,gene,F53F10.2,0,3831493,4.22036,2041,3829323,129,3831364,0,-129
I,+,3867543,0.00174346,0.0,4015,4008,7,4,2,gene,T03F1.3,1,3867553,3.41277,13303,3854240,10,3867543,0,-10
I,+,3867550,0.0,7.52316e-37,120,120,0,0,1226,gene,T03F1.3,1,3867553,3.41277,13310,3854240,3,3867543,-7,-10
I,+,3869223,0.922078,1.04798e-29,154,12,142,96,557,gene,T03F1.2,2,3869250,0.441646,90,3869133,27,3869223,0,-27
I,+,3874367,0.00900901,0.0,555,550,5,5,7,gene,T03F1.1,0,3874372,1.32075,4243,3870124,5,3874367,0,-5
I,+,3877065,0.0120773,0.0,414,409,5,5,1,gene,C50F2.3,1,3877067,1.1061,1068,3875997,2,3877065,0,-2
I,+,3881818,0.905738,3.81293e-42,244,23,221,181,4,gene,C50F2.2,2,3881834,0.443286,1059,3880759,16,3881830,12,-4
I,+,3908749,0.00636704,0.0,2670,2653,17,10,2,gene,T20F5.2,0,3908753,4.56235,13476,3895273,4,3908749,0,-4
I,+,3932212,0.0,0.5,1,1,0,0,1,gene,T21E3.1,0,3932213,0.500247,646,3931566,1,3932212,0,-1
I,+,3983186,0.00253325,0.0,1579,1575,4,4,12,gene,F28H1.3,0,3983206,3.02605,9412,3973774,20,3983186,0,-20
I,+,3995711,0.00281426,0.0,1066,1063,3,2,2,gene,F28H1.1,0,3995726,1.56171,7013,3988698,15,3995711,0,-15
I,+,4094171,0.0,0.000488281,11,11,0,0,61,gene,C24G7.4,0,4094179,0.0669555,3286,4090885,8,4094611,440,432
I,+,4103708,0.0,4.54747e-13,41,41,0,0,2,gene,C24G7.2,0,4103713,0.0419363,5380,4098328,5,4103714,6,1
I,+,4109402,0.0,0.0625,4,4,0,0,0,gene,C24G7.1,0,4109407,0.00477216,1332,4108070,5,4109408,6,1
I,+,4114848,0.0,0.5,1,1,0,0,0,gene,H31G24.4,0,4114878,1.28509,2462,4112386,30,4114862,14,-16
I,+,4116846,0.0,0.25,2,2,0,0,1,gene,H31G24.3,0,4116851,0.0842376,485,4116361,5,4116852,6,1
I,+,4132501,0.0125899,0.0,556,549,7,7,0,gene,E01A2.2,0,4132501,1.91374,3190,4129311,0,4132501,0,0
I,+,4133159,0.0,1.81899e-12,39,39,0,0,9,gene,E01A2.2,0,4133181,1.91374,3848,4129311,22,4133159,0,-22
I,+,4140650,0.00897868,0.0,891,883,8,7,12,gene,E01A2.1,0,4140666,1.60798,5350,4135300,16,4140650,0,-16
I,+,4162047,0.00319489,0.0,313,312,1,0,9,gene,R12E2.5,1,4162057,0.831941,11412,4150635,10,4162058,11,1
I,+,4165136,0.948207,0.0,251,13,238,153,7,gene,R12E2.4,2,4165181,0.67756,111,4165025,45,4165136,0,-45
I,+,4175320,0.00804829,0.0,994,986,8,8,3,gene,R12E2.3,0,4175323,3.82296,1668,4173652,3,4175320,0,-3
I,+,4178813,0.0035461,0.0,1128,1124,4,2,22,gene,R12E2.2,1,4178832,1.27304,1541,4177272,19,4178813,0,-19
I,+,4182222,0.972222,0.0,216,6,210,136,2,gene,R12E2.1,2,4182251,0.436024,92,4182130,29,4182222,0,-29
I,+,4186551,0.0,0.0,391,391,0,0,9,gene,C18E3.7,1,4186563,0.13893,1558,4184993,12,4186551,0,-12
I,+,4190160,1.0,0.5,1,0,1,1,1,gene,C18E3.6,2,4190190,0.564596,230,4189930,30,4190160,0,-30
I,+,4193243,0.92284,0.0,324,25,299,247,9,gene,C18E3.5,3,4193249,0.419218,112,4193131,6,4193243,0,-6
I,+,4203460,0.0,2.91038e-11,35,35,0,0,2,gene,C18E3.3,5,4203461,0.257068,155,4203305,1,4203460,0,-1
I,+,4210981,0.00932836,0.0,536,531,5,4,2,gene,C18E3.2,1,4210998,1.34126,2443,4208538,17,4210981,0,-17
I,+,4229578,0.0,0.0,197,197,0,0,2,gene,C43E11.6,1,4229623,1.69857,15315,4214263,45,4229578,0,-45
I,+,4229889,0.0,0.0,163,163,0,0,1,gene,C43E11.6,1,4229915,1.69857,15626,4214263,26,4229889,0,-26
I,+,4231144,0.0,7.10543e-15,47,47,0,0,33,gene,C43E11.6,1,4231286,1.69857,16881,4214263,142,4231144,0,-142
I,+,4232497,0.0,0.125,3,3,0,0,0,gene,C43E11.6,1,4232513,1.69857,18234,4214263,16,4232497,0,-16
I,+,4237000,0.571429,0.140157,21,9,12,3,9,gene,C43E11.5,2,4237034,0.00300742,838,4236162,34,4237035,35,1
I,+,4247757,0.00631199,0.0,1109,1102,7,7,2,gene,C43E11.4,1,4247761,0.839525,9142,4238615,4,4247758,1,-3
I,+,4249494,0.948012,0.0,327,17,310,231,2,gene,C43E11.11,2,4249499,0.882853,9,4249485,5,4249494,0,-5
I,+,4253273,0.909091,0.0,352,32,320,247,1,gene,C43E11.12,3,4253293,0.920177,102,4253171,20,4253294,21,1
I,+,4253286,0.820513,2.79778e-05,39,7,32,24,1026,gene,C43E11.12,3,4253293,0.920177,115,4253171,7,4253294,8,1
I,+,4255396,0.00396301,0.0,757,754,3,2,3,gene,C43E11.3,1,4255402,0.721275,1478,4253918,6,4255403,7,1
I,+,4265110,0.79,1.88483e-17,200,42,158,108,3,gene,C43E11.2,2,4265267,0.680835,420,4264690,157,4265110,0,-157
I,+,4270699,0.00156986,0.0,637,636,1,0,11,gene,C43E11.1,0,4270735,1.14166,3494,4267205,36,4270647,-52,-88
I,+,4270721,0.0,0.25,2,2,0,0,685,gene,C43E11.1,0,4270735,1.14166,3516,4267205,14,4270647,-74,-88
I,+,4298479,0.0,0.000976562,10,10,0,0,62,gene,Y47D9A.2,0,4298626,1.05339,1842,4296637,147,4298627,148,1
I,+,4303931,0.0261122,0.0,1034,1007,27,19,16,gene,Y47D9A.1,0,4304004,1.76396,1687,4302244,73,4303931,0,-73
I,+,4368090,0.0189873,0.0,316,310,6,4,15,gene,ZK973.3,0,4368101,1.11145,4015,4364075,11,4368090,0,-11
I,+,4373657,0.0102041,3.09233e-28,98,97,1,1,2,gene,ZK973.2,0,4373664,0.765744,3151,4370506,7,4373664,7,0
I,+,4373664,0.0218978,2.4062e-36,137,134,3,1,113,gene,ZK973.2,0,4373664,0.765744,3158,4370506,0,4373664,0,0
I,+,4382016,0.0,0.5,1,1,0,0,2,gene,ZK973.1,0,4382135,0.846556,2665,4379351,119,4382566,550,431
I,+,4382566,0.00544662,0.0,918,913,5,4,2,gene,ZK973.1,0,4382594,0.846556,3215,4379351,28,4382566,0,-28
I,+,4386788,0.403846,0.0426307,52,31,21,19,1,gene,T21E12.4,0,4386790,1.1202,1572,4385216,2,4386788,0,-2
I,+,4409692,0.0,1.45519e-11,36,36,0,0,0,gene,T21E12.2,0,4409740,0.12304,5106,4404586,48,4409693,1,-47
I,+,4411757,0.0,0.000488281,11,11,0,0,5,gene,T21E12.2,0,4411802,0.12304,7171,4404586,45,4411757,0,-45
I,+,4422033,0.0,4.76837e-07,21,21,0,0,3,gene,C11D9.1,0,4422119,0.187179,17447,4404586,86,4422033,0,-86
I,+,4444720,0.00948767,0.0,527,522,5,5,0,gene,C41D11.2,0,4444730,2.06315,16675,4428045,10,4444720,0,-10
I,+,4457384,0.0,1.19209e-07,23,23,0,0,5,gene,C41D11.1,0,4457391,0.173844,10796,4446588,7,4457384,0,-7
I,+,4481205,0.0119048,4.3427e-24,84,83,1,1,70,gene,T01A4.1,0,4481214,1.11861,11746,4469459,9,4481239,34,25
I,+,4491703,0.0,0.0,525,525,0,0,4,gene,T01A4.1,0,4491716,1.11861,7283,4484420,13,4491702,-1,-14
I,+,4502571,0.0,0.5,1,1,0,0,20,gene,T01A4.1,0,4502609,1.11861,18151,4484420,38,4502610,39,1
I,+,4557656,0.0,2.71051e-20,65,65,0,0,6,gene,D1007.15,0,4557660,0.178244,2387,4555269,4,4557665,9,5
I,+,4564131,0.0,0.000488281,11,11,0,0,261,gene,D1007.14,0,4564140,0.859358,373,4563758,9,4564042,-89,-98
I,+,4585116,0.00218705,0.0,71329,71173,156,130,2,gene,D1007.12,1,4585141,95.8262,4740,4580376,25,4585116,0,-25
I,+,4586274,0.990991,4.27556e-32,111,1,110,75,5,gene,D1007.10,2,4586274,0.274934,97,4586177,0,4586274,0,0
I,+,4603218,0.0108696,0.0,736,728,8,6,5,gene,D1007.16,1,4603223,1.44249,13824,4589394,5,4603224,6,1
I,+,4604404,0.856115,1.01736e-18,139,20,119,92,2,gene,D1007.8,2,4604431,0.343669,207,4604197,27,4604404,0,-27
I,+,4605656,0.907216,9.01917e-18,97,9,88,60,0,gene,C44E4.5,3,4605689,0.326157,272,4605384,33,4605656,0,-33
I,+,4634104,0.00532198,0.0,1879,1869,10,10,4,gene,C44E4.4,0,4634110,4.60648,23895,4610209,6,4634104,0,-6
I,+,4643892,0.0,2.91038e-11,35,35,0,0,2,gene,B0041.3,0,4644075,0.58369,8273,4635619,183,4644438,546,363
I,+,4644649,0.0140187,0.0,214,211,3,3,0,gene,B0041.3,0,4644673,0.58369,421,4644228,24,4644438,-211,-235
I,+,4647425,0.00622407,0.0,482,479,3,3,237,gene,B0041.8,0,4647478,1.48056,1799,4645626,53,4647425,0,-53
I,+,4655143,0.0,0.5,1,1,0,0,3,gene,B0041.2,0,4655284,3.35403,6867,4648276,141,4655348,205,64
I,+,4655350,0.00631579,0.0,475,472,3,2,1,gene,B0041.2,0,4655370,3.35403,7074,4648276,20,4655350,0,-20
I,+,4675136,0.00859599,0.0,349,346,3,2,2,gene,T04D1.3,1,4675139,1.68388,9790,4665346,3,4675136,0,-3
I,+,4677677,0.0,0.015625,6,6,0,0,21,gene,T04D1.3,1,4677695,1.68388,12331,4665346,18,4677696,19,1
I,+,4704611,0.00555556,0.0,180,179,1,1,2,gene,W09C3.4,0,4704622,0.498914,21755,4682856,11,4704623,12,1
I,+,4724145,0.0,0.0625,4,4,0,0,25,gene,C10H11.5,0,4724170,0.120089,359,4723786,25,4724066,-79,-104
I,+,4727417,0.0,0.0625,4,4,0,0,9,gene,C10H11.4,0,4727473,0.126951,636,4726781,56,4727302,-115,-171
I,+,4747744,0.0,2.11758e-22,72,72,0,0,1,gene,C10H11.1,0,4747844,0.614171,12467,4735277,100,4747744,0,-100
I,+,4753742,0.0128205,2.5808e-22,78,77,1,0,880,gene,C10H11.1,0,4753749,0.614171,5782,4747960,7,4753742,0,-7
I,+,4766134,0.0,4.44089e-16,51,51,0,0,2,gene,M04F3.2,0,4766307,0.121542,6532,4759602,173,4765755,-379,-552
I,+,4770293,0.00391684,0.0,3319,3306,13,12,5,gene,M04F3.1,0,4770304,5.57416,2408,4767885,11,4770293,0,-11
I,+,4789229,0.00497457,0.0,9046,9001,45,35,25,gene,F54D7.6,0,4789266,None,17839,4771390,37,4789234,5,-32
I,+,4790293,0.0703448,0.0,725,674,51,32,15,gene,F54D7.7,0,4790330,None,706,4789587,37,4790291,-2,-39
I,+,4799984,0.0,5.55112e-17,54,54,0,0,3,gene,F54D7.3,0,4800098,0.0420423,9315,4790669,114,4800099,115,1
I,+,4805608,0.00503778,0.0,397,395,2,2,1,gene,F54D7.2,0,4805624,1.57915,1366,4804242,16,4805608,0,-16
I,+,4821936,0.0,5.96046e-08,24,24,0,0,1,gene,F57C9.6,0,4821937,0.0693073,12261,4809675,1,4821977,41,40
I,+,4827073,0.00234742,0.0,426,425,1,1,3,gene,F57C9.5,1,4827079,0.466402,2143,4824930,6,4827073,0,-6
I,+,4830136,0.583333,0.00488625,180,75,105,79,7,gene,F57C9.4,2,4830140,0.435051,341,4829795,4,4830136,0,-4
I,+,4836188,0.855856,3.1419e-15,111,16,95,76,0,gene,F57C9.3,3,4836291,0.208342,569,4835619,103,4836188,0,-103
I,+,4844909,0.0,3.38813e-21,68,68,0,0,11,gene,F57C9.2,4,4845123,0.326874,4877,4840032,214,4844909,0,-214
I,+,4884904,0.00943396,1.30655e-30,106,105,1,1,0,gene,F25F8.1,0,4884905,0.268131,34194,4850710,1,4884904,0,-1
I,+,4906847,0.0,0.25,2,2,0,0,303,gene,F21F3.1,0,4906847,3.03299,1685,4905162,0,4906848,1,1
I,+,4918395,0.000999001,0.0,1001,1000,1,1,18,gene,F21F3.7,0,4918396,0.713739,6565,4911830,1,4918397,2,1
I,+,4926712,0.0,0.03125,5,5,0,0,36,gene,F28B3.5,1,4926733,0.569886,5954,4920758,21,4926734,22,1
I,+,4929100,0.85,1.99849e-13,100,15,85,57,2,gene,F28B3.9,2,4929127,0.277553,123,4928977,27,4929100,0,-27
I,+,4934260,0.150334,0.0,898,763,135,115,5,gene,F28B3.4,0,4934262,0.920301,2078,4932182,2,4934038,-222,-224
I,+,4943631,0.0,0.125,3,3,0,0,9,gene,F28B3.1,0,4943664,1.08209,2630,4941001,33,4943631,0,-33
I,+,4962452,0.00662252,0.0,755,750,5,5,11,gene,W03G9.2,2,4962452,0.350328,937,4961515,0,4962453,1,1
I,+,4980308,0.00163399,0.0,612,611,1,0,580,gene,W03G9.1,0,4980330,1.14006,8066,4972242,22,4980308,0,-22
I,+,4996842,0.00401606,0.0,249,248,1,0,0,gene,F54C1.3,1,4996844,0.707746,12091,4984751,2,4996845,3,1
I,+,5003451,0.788779,2.40523e-25,303,64,239,172,5,gene,F54C1.2,2,5003464,0.366536,290,5003161,13,5003451,0,-13
I,+,5027155,0.0,1.14794e-41,136,136,0,0,0,gene,C46H11.4,0,5027210,0.907221,3956,5023199,55,5027155,0,-55
I,+,5041489,0.0,0.00195312,9,9,0,0,2,gene,C46H11.3,0,5041491,0.0298285,335,5041154,2,5041492,3,1
I,+,5050131,0.0,2.91038e-11,35,35,0,0,98,gene,C46H11.2,0,5050236,0.355071,7991,5042140,105,5050052,-79,-184
I,+,5086320,0.0,4.70198e-38,124,124,0,0,4,gene,C30F8.4,0,5086349,0.386206,33794,5052526,29,5086320,0,-29
I,+,5087993,0.0,0.25,2,2,0,0,1,gene,C30F8.4,0,5088002,0.386206,35467,5052526,9,5087993,0,-9
I,+,5096603,0.0,0.0,173,173,0,0,2,gene,C30F8.3,0,5096603,0.169289,2793,5093810,0,5096604,1,1
I,+,5107839,0.746835,4.38652e-06,79,20,59,40,109,gene,Y110A7A.10,2,5107846,0.682728,212,5107627,7,5107846,7,0
I,+,5107846,0.872054,5.83641e-42,297,38,259,172,252,gene,Y110A7A.10,2,5107846,0.682728,219,5107627,0,5107846,0,0
I,+,5119226,0.0138249,0.0,217,214,3,3,1,gene,Y110A7A.9,0,5119251,0.6681,9070,5110156,25,5119226,0,-25
I,+,5127831,0.00426439,0.0,938,934,4,3,10,gene,Y110A7A.8,1,5127852,1.65491,3842,5123989,21,5127831,0,-21
I,+,5129748,0.837209,3.66346e-06,43,7,36,25,8,gene,Y110A7A.7,2,5129781,0.551082,137,5129611,33,5129724,-24,-57
I,+,5131523,0.437288,0.00456801,295,166,129,105,72,gene,Y110A7A.6,3,5131524,2.11524,455,5131068,1,5131523,0,-1
I,+,5131534,0.259962,1.26796e-29,527,390,137,92,647,gene,Y110A7A.6,3,5131542,2.11524,466,5131068,8,5131534,0,-8
I,+,5134744,0.141176,3.64338e-44,340,292,48,31,19,gene,Y110A7A.5,4,5134757,0.612495,642,5134102,13,5134770,26,13
I,+,5138264,0.013986,0.0,286,282,4,4,1,gene,Y110A7A.4,0,5138272,1.23532,290,5137974,8,5138264,0,-8
I,+,5141678,0.0,2.11758e-22,72,72,0,0,0,gene,Y110A7A.3,0,5141681,0.182272,2293,5139385,3,5141678,0,-3
I,+,5154519,0.0,2.91038e-11,35,35,0,0,9,gene,Y110A7A.2,0,5154531,0.0476403,5288,5149231,12,5154532,13,1
I,+,5165155,0.013245,3.96708e-42,151,149,2,1,9,gene,Y110A7A.1,0,5165159,0.727174,6653,5158502,4,5165160,5,1
I,+,5182739,0.923513,0.0,353,27,326,257,2,gene,F56A3.2,2,5182769,0.479579,89,5182650,30,5182739,0,-30
I,+,5190147,0.00512821,0.0,195,194,1,1,0,gene,F56A3.1,0,5190150,0.162256,1048,5189099,3,5190151,4,1
I,+,5196073,0.0,0.00012207,13,13,0,0,2,gene,C32E12.2,0,5196080,0.0369109,825,5195248,7,5196081,8,1
I,+,5244434,0.003663,0.0,273,272,1,0,2,gene,B0261.4,1,5244449,1.30917,9156,5235278,15,5244450,16,1
I,+,5245746,0.827795,1.43539e-35,331,57,274,194,14,gene,B0261.2,2,5245751,0.72863,343,5245403,5,5245746,0,-5
I,+,5263697,0.911215,2.59934e-38,214,19,195,128,6,gene,B0261.1,3,5263710,0.741693,271,5263426,13,5263697,0,-13
I,+,5319725,0.0,2.98023e-08,25,25,0,0,4,gene,F48C1.2,0,5319733,0.0501043,50301,5269424,8,5319734,9,1
I,+,5345919,0.0,9.09495e-13,40,40,0,0,0,gene,F55A12.5,0,5345930,0.628108,3869,5342050,11,5345931,12,1
I,+,5345930,0.00934579,0.0,321,318,3,2,38,gene,F55A12.5,0,5345930,0.628108,3880,5342050,0,5345931,1,1
I,+,5354354,0.0,3.63798e-12,38,38,0,0,3,gene,F55A12.4,0,5354370,0.306341,4707,5349647,16,5354371,17,1
I,+,5358525,0.00706714,0.0,283,281,2,2,0,gene,F55A12.3,1,5358527,1.0569,1496,5357029,2,5358523,-2,-4
I,+,5365268,0.97449,0.0,196,5,191,119,1,gene,F55A12.2,2,5365280,0.415118,21,5365247,12,5365268,0,-12
I,+,5368457,0.0,6.10352e-05,14,14,0,0,2,gene,F55A12.1,0,5368480,0.537198,1578,5366879,23,5368481,24,1
I,+,5422772,0.00374065,0.0,802,799,3,2,4,gene,F27C1.4,0,5422788,0.737585,19881,5402891,16,5422786,14,-2
I,+,5430167,0.00655738,0.0,915,909,6,6,1,gene,F27C1.2,0,5430169,4.05211,2932,5427235,2,5430167,0,-2
I,+,5498853,0.0,1.49012e-08,26,26,0,0,1,gene,C09D4.1,0,5498911,0.290938,5450,5493403,58,5498853,0,-58
I,+,5512051,0.031746,2.11745e-16,63,61,2,2,0,gene,F59A3.2,1,5512065,0.310645,5393,5506658,14,5512051,0,-14
I,+,5514654,0.91,1.5006e-18,100,9,91,72,0,gene,F59A3.12,2,5514671,None,94,5514560,17,5514672,18,1
I,+,5514663,1.0,0.00012207,13,0,13,10,117,gene,F59A3.12,2,5514671,None,103,5514560,8,5514672,9,1
I,+,5520392,0.0135135,3.91753e-21,74,73,1,1,1,gene,F59A3.1,0,5520393,0.388037,3015,5517377,1,5520392,0,-1
I,+,5546123,0.0,0.0,230,230,0,0,1,gene,M01A10.2,0,5546166,0.578902,16360,5529763,43,5546230,107,64
I,+,5563903,0.0,0.5,1,1,0,0,335,gene,M01A10.1,0,5563917,0.326359,2259,5561644,14,5563833,-70,-84
I,+,5573217,0.0,2.84217e-14,45,45,0,0,0,gene,M01E11.3,0,5573245,0.144043,6951,5566266,28,5573246,29,1
I,+,5579669,0.0132275,0.0,378,373,5,5,3,gene,M01E11.2,1,5579681,0.784586,2923,5576746,12,5579669,0,-12
I,+,5582099,0.80292,1.66371e-13,137,27,110,77,3,gene,M01E11.1,2,5582104,0.381143,186,5581913,5,5582105,6,1
I,+,5619572,0.00274446,0.0,9838,9811,27,26,3,gene,F46F11.2,1,5619604,15.81,36098,5583474,32,5619572,0,-32
I,+,5627822,0.018018,0.0,222,218,4,4,1,gene,F46F11.1,0,5627828,0.609549,4774,5623048,6,5627822,0,-6
I,+,5644732,0.0,0.00012207,13,13,0,0,2,gene,M01A12.3,0,5644739,0.0492063,636,5644096,7,5644740,8,1
I,+,5662287,0.0,0.015625,6,6,0,0,2,gene,F55F8.1,0,5662288,0.178384,15862,5646425,1,5662287,0,-1
I,+,5674309,0.010101,0.0,594,588,6,5,1,gene,T19B4.5,1,5674321,1.01493,7165,5667144,12,5674412,103,91
I,+,5676830,0.902397,0.0,584,57,527,361,9,gene,T19B4.4,2,5676838,1.60052,493,5676337,8,5676830,0,-8
I,+,5678641,0.140389,0.0,2778,2388,390,291,6,gene,T19B4.3,3,5678647,3.4778,930,5677711,6,5678641,0,-6
I,+,5692267,0.0,0.0,343,343,0,0,2,gene,T19B4.2,0,5692268,2.04982,12406,5679861,1,5692267,0,-1
I,+,5702159,0.0,1.79366e-43,142,142,0,0,0,gene,T19B4.1,0,5702160,0.575338,4646,5697513,1,5702159,0,-1
I,+,5716731,0.0,0.00390625,8,8,0,0,21,gene,C04F1.3,0,5716840,0.439973,9867,5706864,109,5716679,-52,-161
I,+,5744183,0.01,0.0,200,198,2,1,122,gene,F56H1.6,0,5744186,0.765903,2560,5741623,3,5744187,4,1
I,+,5783814,0.0,3.72529e-09,28,28,0,0,1,gene,B0414.2,0,5783843,0.106285,8201,5775613,29,5783814,0,-29
I,+,5807712,0.00290698,0.0,1032,1029,3,3,7,gene,C32F10.2,0,5807732,0.610923,4443,5803269,20,5807712,0,-20
I,+,5829394,0.0013947,0.0,717,716,1,0,13,gene,C32F10.1,0,5829402,1.11297,13757,5815637,8,5829394,0,-8
I,+,5832104,0.0,1.05879e-22,73,73,0,0,19,gene,C32F10.1,0,5832218,1.11297,16467,5815637,114,5832104,0,-114
I,+,5840291,0.0,0.015625,6,6,0,0,0,gene,F33D11.4,0,5840291,0.0210993,1449,5838842,0,5840292,1,1
I,+,5842703,0.0,9.53674e-07,20,20,0,0,2,gene,F33D11.3,0,5842716,0.818637,769,5841934,13,5842717,14,1
I,+,5842712,0.0,6.61744e-24,77,77,0,0,37,gene,F33D11.3,0,5842716,0.818637,778,5841934,4,5842717,5,1
I,+,5842960,0.0,0.125,3,3,0,0,81,gene,F33D11.3,0,5842986,0.818637,1026,5841934,26,5842717,-243,-269
I,+,5872177,0.00537634,0.0,372,370,2,2,2,gene,C34G6.5,0,5872187,0.535759,19211,5852966,10,5872177,0,-10
I,+,5886616,0.0,1.69407e-21,69,69,0,0,0,gene,C34G6.4,0,5886627,0.441826,12270,5874346,11,5886628,12,1
I,+,5898306,0.00183824,0.0,544,543,1,1,0,gene,C34G6.2,0,5898323,0.967393,898,5897408,17,5898306,0,-17
I,+,5906667,0.00314465,0.0,318,317,1,1,2,gene,C34G6.1,0,5906680,0.558177,4547,5902120,13,5906714,47,34
I,+,5937479,0.0,0.0,322,322,0,0,8,gene,B0207.4,0,5937485,1.31301,2042,5935437,6,5937479,0,-6
I,+,5942398,0.0769231,0.00158691,13,12,1,1,6,gene,B0207.3,0,5942420,0.0504435,3511,5938887,22,5942421,23,1
I,+,5955033,0.0,0.0078125,7,7,0,0,1,gene,B0207.2,0,5955043,0.0903847,9436,5945597,10,5955033,0,-10
I,+,5986494,0.00522193,0.0,383,381,2,1,15,gene,C06A5.3,1,5986501,0.651613,6306,5980188,7,5986494,0,-7
I,+,5990743,0.941935,2.45928e-33,155,9,146,86,0,gene,C06A5.11,2,5990746,0.317278,162,5990581,3,5991073,330,327
I,+,6012047,0.0135593,0.0,295,291,4,4,23,gene,C06A5.1,1,6012059,0.285884,4721,6007326,12,6012060,13,1
I,+,6022662,0.873239,3.15409e-11,71,9,62,52,6,gene,B0025.2,2,6022684,1.88496,132,6022530,22,6022662,0,-22
I,+,6022669,0.704082,1.09867e-16,392,116,276,197,126,gene,B0025.2,2,6022684,1.88496,139,6022530,15,6022669,0,-15
I,+,6027196,0.826271,1.31313e-25,236,41,195,131,4,gene,B0025.4,3,6027201,1.00691,320,6026876,5,6027196,0,-5
I,+,6028488,0.881579,1.80019e-23,152,18,134,81,0,gene,B0025.1,4,6028489,0.923794,116,6028372,1,6028488,0,-1
I,+,6028500,0.843137,2.8278e-07,51,8,43,18,236,gene,B0025.1,4,6028501,0.923794,128,6028372,1,6028500,0,-1
I,+,6036202,0.0,0.5,1,1,0,0,0,gene,C27A12.4,0,6036215,0.0452098,2745,6033457,13,6036599,397,384
I,+,6038407,0.00403769,0.0,743,740,3,3,1,gene,C27A12.3,1,6038432,0.606373,603,6037804,25,6038408,1,-24
I,+,6041674,0.911661,0.0,283,25,258,189,2,gene,C27A12.2,2,6041675,0.661983,403,6041271,1,6041672,-2,-3
I,+,6064090,0.00771208,0.0,1167,1158,9,6,0,gene,C27A12.10,0,6064093,1.36025,18070,6046020,3,6064090,0,-3
I,+,6081814,0.0,0.0,274,274,0,0,4,gene,ZK484.2,0,6081817,1.28332,16522,6065292,3,6081814,0,-3
I,+,6093310,0.0,0.5,1,1,0,0,4,gene,ZK484.1,0,6093347,19.7819,7348,6085962,37,6093310,0,-37
I,+,6104807,0.0,1.16415e-10,33,33,0,0,0,gene,T27A3.8,0,6104873,0.0662289,2409,6102398,66,6104807,0,-66
I,+,6110136,0.00652529,0.0,613,609,4,4,0,gene,T27A3.2,0,6110140,1.54476,4488,6105648,4,6110136,0,-4
I,+,6123124,0.00970874,0.0,309,306,3,3,5,gene,T27A3.1,0,6123131,1.61123,8584,6114540,7,6123124,0,-7
I,+,6133247,0.0,4.44089e-16,51,51,0,0,1,gene,F56F4.5,0,6133286,0.320862,6396,6126851,39,6133287,40,1
I,+,6154077,0.00322284,0.0,2172,2165,7,4,3,gene,T09B4.5,0,6154142,8.98187,3587,6150490,65,6154077,0,-65
I,+,6154087,0.0,0.0078125,7,7,0,0,2096,gene,T09B4.5,0,6154142,8.98187,3597,6150490,55,6154077,-10,-65
I,+,6167950,0.0,0.0,170,170,0,0,10,gene,T09B4.4,0,6168018,0.58169,10493,6157457,68,6167950,0,-68
I,+,6176162,0.0,0.0625,4,4,0,0,8,gene,T09B4.3,0,6176239,0.142168,7520,6168642,77,6176188,26,-51
I,+,6184081,0.00485437,0.0,412,410,2,2,9,gene,T09B4.2,1,6184088,0.723992,6023,6178058,7,6184081,0,-7
I,+,6185464,0.618421,1.48856e-12,836,319,517,429,0,gene,T09B4.1,2,6185464,1.26145,92,6185372,0,6185464,0,0
I,+,6188161,0.978022,1.65396e-24,91,2,89,62,1,gene,T05E7.3,3,6188173,0.519886,2,6188159,12,6188161,0,-12
I,+,6204005,0.0212766,3.33955e-13,47,46,1,0,74,gene,T05E7.1,0,6204015,0.399767,3810,6200195,10,6203899,-106,-116
I,+,6215777,0.000952381,0.0,1050,1049,1,1,7,gene,T08B2.5,0,6215792,0.890086,46,6215731,15,6215777,0,-15
I,+,6215921,1.0,0.25,2,0,2,2,7,gene,T08B2.5,0,6215927,0.890086,190,6215731,6,6215921,0,-6
I,+,6225360,0.0,0.25,2,2,0,0,6,gene,T08B2.4,0,6225401,0.0572013,5453,6219907,41,6225560,200,159
I,+,6225364,0.0,9.09495e-13,40,40,0,0,12,gene,T08B2.4,0,6225401,0.0572013,5457,6219907,37,6225560,196,159
I,+,6253084,0.0,7.52316e-37,120,120,0,0,802,gene,C48E7.11,1,6253085,1.48868,227,6252857,1,6253021,-63,-64
I,+,6253703,0.927273,0.0,275,20,255,185,0,gene,C48E7.3,2,6253801,0.768408,117,6253586,98,6253703,0,-98
I,+,6255037,0.973094,0.0,223,6,217,155,2,gene,C48E7.2,3,6255043,0.642704,75,6254962,6,6255037,0,-6
I,+,6260251,0.000401606,0.0,2490,2489,1,1,1,gene,C48E7.1,0,6260264,5.09952,1152,6259099,13,6260251,0,-13
I,+,6284975,0.00229358,0.0,10900,10875,25,23,2,gene,C10G11.7,1,6285009,7.97775,20402,6264573,34,6284975,0,-34
I,+,6284981,0.0,1.35525e-20,66,66,0,0,1040,gene,C10G11.7,1,6285009,7.97775,20408,6264573,28,6284975,-6,-34
I,+,6290318,0.0416667,1.43051e-06,24,23,1,1,1,gene,C10G11.6,2,6290324,0.271155,921,6289397,6,6290325,7,1
I,+,6295071,0.00117509,0.0,851,850,1,1,29,gene,C10G11.5,3,6295080,1.8591,76,6294995,9,6295071,0,-9
I,+,6295110,0.826923,8.16919e-07,52,9,43,34,206,gene,C10G11.5,3,6295245,1.8591,115,6294995,135,6295260,150,15
I,+,6295219,1.0,0.25,2,0,2,1,2,gene,C10G11.5,3,6295245,1.8591,224,6294995,26,6295260,41,15
I,+,6295260,0.81457,4.48416e-44,453,84,369,268,3,gene,C10G11.5,3,6295286,1.8591,265,6294995,26,6295260,0,-26
I,+,6315235,0.00438212,0.0,3423,3408,15,12,12,gene,F26B1.3,0,6315248,2.82311,614,6314621,13,6315235,0,-13
I,+,6315242,0.0,0.03125,5,5,0,0,371,gene,F26B1.3,0,6315248,2.82311,621,6314621,6,6315235,-7,-13
I,+,6317703,0.00574713,0.0,1218,1211,7,6,2,gene,F26B1.2,0,6317718,2.94238,441,6317262,15,6317703,0,-15
I,+,6318021,0.0,0.125,3,3,0,0,3,gene,F26B1.2,0,6318048,2.94238,759,6317262,27,6318022,1,-26
I,+,6318046,0.0202578,0.0,543,532,11,9,42,gene,F26B1.2,0,6318048,2.94238,784,6317262,2,6318046,0,-2
I,+,6342233,0.0019861,0.0,1007,1005,2,2,3,gene,K04F10.4,0,6342249,2.60745,12052,6330181,16,6342233,0,-16
I,+,6360842,0.0,0.015625,6,6,0,0,8,gene,K04F10.2,0,6360845,0.0479932,383,6360459,3,6360846,4,1
I,+,6368139,0.625,0.21875,8,3,5,4,2,gene,ZC308.4,2,6368145,0.63393,60,6368079,6,6368273,134,128
I,+,6369967,0.0,1.49012e-08,26,26,0,0,59,gene,ZC308.1,0,6370030,1.41942,370,6369597,63,6369967,0,-63
I,+,6376664,0.0,1.46937e-39,129,129,0,0,2,gene,ZC308.1,0,6376698,1.41942,7067,6369597,34,6376699,35,1
I,+,6381383,0.0138889,1.52466e-20,72,71,1,0,4,gene,ZC308.1,0,6381406,1.41942,11786,6369597,23,6381436,53,30
I,+,6381386,0.0,0.015625,6,6,0,0,21,gene,ZC308.1,0,6381406,1.41942,11789,6369597,20,6381436,50,30
I,+,6404589,0.0,0.0,1670,1670,0,0,0,gene,ZC328.1,0,6404594,0.744864,18709,6385880,5,6404589,0,-5
I,+,6407534,0.00647249,0.0,618,614,4,1,137,gene,ZC328.4,0,6407535,0.671201,1829,6405705,1,6407520,-14,-15
I,+,6436074,0.0,0.000976562,10,10,0,0,168,gene,T23H2.2,0,6436152,3.0967,10278,6425796,78,6436121,47,-31
I,+,6436127,0.0,0.0625,4,4,0,0,873,gene,T23H2.2,0,6436152,3.0967,10331,6425796,25,6436121,-6,-31
I,+,6447313,0.00465658,0.0,859,855,4,3,2,gene,T23H2.1,0,6447333,1.07331,6123,6441190,20,6447334,21,1
I,+,6460888,0.0,0.5,1,1,0,0,0,gene,K06A5.4,0,6460985,1.07705,6936,6453952,97,6460888,0,-97
I,+,6474019,0.0,2.64698e-23,75,75,0,0,34,gene,K06A5.1,0,6474085,0.597686,4636,6469383,66,6474061,42,-24
I,+,6482448,0.0,0.000976562,10,10,0,0,0,gene,C55B7.6,0,6482452,0.0428018,5691,6476757,4,6482453,5,1
I,+,6494292,0.0,0.0,182,182,0,0,187,gene,C55B7.5,0,6494294,0.66657,8365,6485927,2,6494292,0,-2
I,+,6497336,0.0,0.25,2,2,0,0,2,gene,C55B7.4,0,6497366,10.3731,1225,6496111,30,6497440,104,74
I,+,6497514,0.0,0.5,1,1,0,0,3196,gene,C55B7.4,0,6497605,10.3731,1403,6496111,91,6497471,-43,-134
I,+,6500031,1.0,0.5,1,0,1,1,10,gene,C55B7.3,0,6500031,0.227826,201,6499830,0,6499843,-188,-188
I,+,6507895,0.0,5.82077e-11,34,34,0,0,0,gene,C55B7.2,0,6507898,0.182019,4462,6503433,3,6507895,0,-3
I,+,6558686,1.0,0.5,1,0,1,1,0,gene,F57B10.6,2,6558700,0.391058,92,6558594,14,6558701,15,1
I,+,6558699,0.923664,1.05948e-25,131,10,121,100,3,gene,F57B10.6,2,6558700,0.391058,105,6558594,1,6558701,2,1
I,+,6558732,1.0,0.5,1,0,1,1,118,gene,F57B10.6,2,6558759,0.391058,138,6558594,27,6558701,-31,-58
I,+,6562700,0.12993,0.0,1724,1500,224,169,17,gene,F57B10.5,3,6562707,3.14916,353,6562347,7,6562700,0,-7
I,+,6566162,0.0120482,8.582e-24,83,82,1,1,9,gene,F57B10.4,0,6566173,0.558128,966,6565196,11,6566174,12,1
I,+,6566171,0.0,1.03398e-25,83,83,0,0,41,gene,F57B10.4,0,6566173,0.558128,975,6565196,2,6566174,3,1
I,+,6569009,1.0,0.5,1,0,1,0,0,gene,F57B10.3,0,6569038,2.83048,111,6568898,29,6569495,486,457
I,+,6570088,0.238034,0.0,773,589,184,153,1,gene,F57B10.3,0,6570089,2.83048,1190,6568898,1,6570089,1,0
I,+,6574005,0.304348,4.8518e-13,322,224,98,81,5,gene,F57B10.1,0,6574094,2.84756,1408,6572597,89,6574005,0,-89
I,+,6580187,0.00248139,0.0,403,402,1,1,55,gene,F57B10.1,0,6580238,2.84756,7590,6572597,51,6580187,0,-51
I,+,6620855,0.0,0.0625,4,4,0,0,45,gene,D2092.8,0,6620876,0.939317,2245,6618610,21,6620666,-189,-210
I,+,6651221,0.0,1.03398e-25,83,83,0,0,0,gene,ZC581.3,0,6651221,0.307262,29929,6621292,0,6651221,0,0
I,+,6715968,0.00314762,0.0,3177,3167,10,6,2,gene,T23B3.2,0,6715996,5.3003,3591,6712377,28,6715875,-93,-121
I,+,6717793,0.0,3.8147e-06,18,18,0,0,1,gene,T23B3.1,0,6717829,0.7671,802,6716991,36,6717830,37,1
I,+,6717822,0.00464576,0.0,861,857,4,3,24,gene,T23B3.1,0,6717829,0.7671,831,6716991,7,6717830,8,1
I,+,6725165,0.0,9.31323e-10,30,30,0,0,2,gene,W02D3.3,0,6725167,0.222368,5732,6719433,2,6725165,0,-2
I,+,6736681,0.0454545,5.37739e-11,44,42,2,2,0,gene,W02D3.2,1,6736691,0.980619,5654,6731027,10,6736687,6,-4
I,+,6736687,0.03125,7.45058e-09,32,31,1,1,12,gene,W02D3.2,1,6736691,0.980619,5660,6731027,4,6736687,0,-4
I,+,6737262,0.0,3.72529e-09,28,28,0,0,5,gene,W02D3.2,1,6737533,0.980619,6235,6731027,271,6737262,0,-271
I,+,6737481,0.0,0.5,1,1,0,0,2,gene,W02D3.2,1,6737533,0.980619,6454,6731027,52,6737481,0,-52
I,+,6741277,0.980952,0.0,1995,38,1957,1064,54,gene,W02D3.1,2,6741288,7.25137,102,6741175,11,6741277,0,-11
I,+,6741985,0.916372,0.0,849,71,778,502,3,gene,W02D3.12,3,6741989,1.82343,112,6741873,4,6741985,0,-4
I,+,6757764,0.00832362,0.0,6007,5957,50,37,37,gene,F08B6.2,0,6757768,18.5478,15373,6742391,4,6757461,-303,-307
I,+,6760417,0.00628931,0.0,318,316,2,1,58,gene,F08B6.1,0,6760432,0.774757,2239,6758178,15,6760433,16,1
I,+,6780807,0.00515464,0.0,194,193,1,1,2,gene,C37A2.4,0,6780821,0.632454,19365,6761442,14,6780807,0,-14
I,+,6790981,0.0,0.0,586,586,0,0,7,gene,C37A2.2,0,6791009,2.29046,3841,6787140,28,6791026,45,17
I,+,6790991,0.0235294,9.22823e-23,85,83,2,1,794,gene,C37A2.2,0,6791009,2.29046,3851,6787140,18,6791026,35,17
I,+,6799860,0.0,0.25,2,2,0,0,6,gene,E02D9.1,0,6799949,2.83053,1609,6798251,89,6800385,525,436
I,+,6800387,0.0043057,0.0,2787,2775,12,11,26,gene,E02D9.1,0,6800424,2.83053,2136,6798251,37,6800387,0,-37
I,+,6812665,0.0,6.31089e-30,97,97,0,0,2,gene,K02F2.4,1,6812700,0.145853,7813,6804852,35,6812701,36,1
I,+,6814517,0.302158,1.13815e-16,417,291,126,106,1,gene,K02F2.3,2,6814528,1.13205,270,6814247,11,6814529,12,1
I,+,6836468,0.00609685,0.0,8529,8477,52,49,4,gene,K02F2.2,3,6836483,34.6814,1772,6834696,15,6836468,0,-15
I,+,6838420,0.408467,1.10171e-08,874,517,357,277,14,gene,K02F2.1,4,6838445,1.59059,285,6838135,25,6838353,-67,-92
I,+,6847585,0.00322581,0.0,310,309,1,1,37,gene,H27M09.3,1,6847592,0.563902,2450,6845135,7,6847510,-75,-82
I,+,6850408,0.198276,0.0,1856,1488,368,312,8,gene,H27M09.2,2,6850422,3.55028,486,6849922,14,6850419,11,-3
I,+,6851371,0.954955,0.0,333,15,318,221,14,gene,H27M09.1,3,6851379,0.603124,47,6851324,8,6851371,0,-8
I,+,6854687,0.222222,0.0703125,9,7,2,2,26,gene,T21G5.3,0,6854810,1.76922,480,6854207,123,6854687,0,-123
I,+,6862941,0.0,0.125,3,3,0,0,6,gene,T21G5.6,0,6863015,0.435815,5410,6857531,74,6863075,134,60
I,+,6863075,0.0,0.5,1,1,0,0,2,gene,T21G5.6,0,6863104,0.435815,5544,6857531,29,6863075,0,-29
I,+,6868689,0.0,0.0,150,150,0,0,2,gene,T21G5.6,0,6868819,0.435815,11158,6857531,130,6868689,0,-130
I,+,6915048,0.00305499,0.0,982,979,3,3,1,gene,C48B6.3,1,6915057,1.32613,23527,6891521,9,6915048,0,-9
I,+,6916438,1.0,0.5,1,0,1,1,125,gene,C48B6.2,2,6916517,1.13194,472,6915966,79,6916765,327,248
I,+,6916749,1.0,0.25,2,0,2,2,0,gene,C48B6.2,2,6916753,1.13194,158,6916591,4,6916765,16,12
I,+,6916765,0.916905,0.0,349,29,320,207,3,gene,C48B6.2,2,6916782,1.13194,174,6916591,17,6916765,0,-17
I,+,6926250,0.0,0.25,2,2,0,0,0,gene,T10B11.3,1,6926300,1.31562,8693,6917557,50,6926284,34,-16
I,+,6926263,0.00112233,0.0,1782,1780,2,0,34,gene,T10B11.3,1,6926300,1.31562,8706,6917557,37,6926284,21,-16
I,+,6931137,0.594286,8.29166e-05,350,142,208,157,90,gene,T10B11.2,2,6931158,1.10716,1479,6929658,21,6931137,0,-21
I,+,6931148,1.0,0.25,2,0,2,2,620,gene,T10B11.2,2,6931158,1.10716,1490,6929658,10,6931137,-11,-21
I,+,6951192,0.00263158,0.0,380,379,1,1,6,gene,T10B11.1,0,6951240,5.82022,14265,6936927,48,6951134,-58,-106
I,+,6974760,0.00277778,0.0,720,718,2,2,22,gene,C30F12.7,0,6974760,1.18013,22804,6951956,0,6974557,-203,-203
I,+,6989066,0.0,0.0,162,162,0,0,0,gene,C30F12.6,0,6989096,0.215057,11997,6977069,30,6989066,0,-30
I,+,7005442,0.0,0.000976562,10,10,0,0,9,gene,H06O01.3,0,7005541,1.35466,13329,6992113,99,7005442,0,-99
I,+,7021981,0.000984252,0.0,1016,1015,1,0,32,gene,F15C11.2,0,7022035,4.15774,12712,7009269,54,7021981,0,-54
I,+,7038899,0.0229885,2.41756e-23,87,85,2,2,3,gene,F15C11.1,0,7038906,1.07659,9826,7029073,7,7038899,0,-7
I,+,7057199,0.00259109,0.0,6175,6159,16,15,15,gene,W01A8.1,0,7057206,4.43823,8368,7048831,7,7057199,0,-7
I,+,7065253,0.0,3.05176e-05,15,15,0,0,0,gene,W01A8.3,0,7065261,0.0524424,5908,7059345,8,7065262,9,1
I,+,7069439,0.00461894,0.0,433,431,2,2,2,gene,W01A8.5,0,7069440,0.890528,1541,7067898,1,7069441,2,1
I,+,7090739,0.00230833,0.0,6065,6051,14,13,7,gene,F22D6.4,0,7090740,2.66352,2155,7088584,1,7090739,0,-1
I,+,7095172,0.0,1.49012e-08,26,26,0,0,0,gene,F22D6.6,0,7095299,0.775768,3762,7091410,127,7095487,315,188
I,+,7095485,0.0152381,0.0,525,517,8,7,33,gene,F22D6.6,0,7095486,0.775768,4075,7091410,1,7095487,2,1
I,+,7098574,0.2,0.15625,5,4,1,1,0,gene,F22D6.14,0,7098601,None,169,7098405,27,7098648,74,47
I,+,7105317,0.0,0.5,1,1,0,0,5,gene,F22D6.10,0,7105317,1.83285,3546,7101771,0,7105318,1,1
I,+,7110239,0.0,0.000976562,10,10,0,0,0,gene,F22D6.11,0,7110278,0.0408071,3319,7106920,39,7110239,0,-39
I,+,7113016,0.0454545,5.24521e-06,22,21,1,1,6,gene,F22D6.12,0,7113118,0.168579,579,7112437,102,7113016,0,-102
I,+,7159719,0.00847458,3.55093e-34,118,117,1,1,2,gene,K07G5.2,0,7159722,0.610523,25390,7134329,3,7159723,4,1
I,+,7161013,1.0,0.5,1,0,1,1,157,gene,K07G5.3,0,7161013,0.0385617,98,7160915,0,7161014,1,1
I,+,7170023,0.0,9.31323e-10,30,30,0,0,65,gene,K07G5.5,0,7170023,0.237017,3507,7166516,0,7170024,1,1
I,+,7183051,0.0,7.62939e-06,17,17,0,0,11,gene,M05B5.6,0,7183059,0.160168,10864,7172187,8,7183051,0,-8
I,+,7210588,0.0,1.19209e-07,23,23,0,0,137,gene,C01H6.4,0,7210590,0.225597,20020,7190568,2,7210541,-47,-49
I,+,7218784,0.00294118,0.0,340,339,1,1,2,gene,C01H6.5,1,7218820,0.946845,6086,7212698,36,7218784,0,-36
I,+,7219316,0.0,0.015625,6,6,0,0,4,gene,C01H6.5,1,7219340,0.946845,6618,7212698,24,7219316,0,-24
I,+,7222296,0.817073,2.06119e-09,82,15,67,58,1,gene,C01H6.6,2,7222299,0.094487,472,7221824,3,7222305,9,6
I,+,7224656,1.0,0.0625,4,0,4,2,6,gene,C01H6.7,0,7224680,1.3291,481,7224175,24,7224732,76,52
I,+,7224806,0.75,0.027771,16,4,12,9,567,gene,C01H6.7,0,7224831,1.3291,631,7224175,25,7224832,26,1
I,+,7224818,0.235294,0.00105683,34,26,8,7,920,gene,C01H6.7,0,7224831,1.3291,643,7224175,13,7224832,14,1
I,+,7235382,0.0,7.10543e-15,47,47,0,0,10,gene,R06C7.1,0,7235405,2.06241,5950,7229432,23,7235382,0,-23
I,+,7244888,0.0,0.000976562,10,10,0,0,0,gene,R06C7.4,0,7244905,4.65513,6098,7238790,17,7244935,47,30
I,+,7251929,0.0,3.8147e-06,18,18,0,0,5,gene,R06C7.8,0,7251944,1.51589,5829,7246100,15,7251939,10,-5
I,+,7251939,0.00692042,0.0,289,287,2,2,33,gene,R06C7.8,0,7251944,1.51589,5839,7246100,5,7251939,0,-5
I,+,7255509,0.00454545,0.0,220,219,1,1,8,gene,R06C7.9,0,7255524,0.373922,288,7255221,15,7255509,0,-15
I,+,7291270,0.0,6.93889e-18,57,57,0,0,0,gene,F13G3.1,0,7291396,0.177533,32572,7258698,126,7291270,0,-126
I,+,7305001,0.0119048,0.0,168,166,2,1,8,gene,F13G3.7,1,7305052,0.850246,8176,7296825,51,7305001,0,-51
I,+,7305050,0.0,0.0078125,7,7,0,0,46,gene,F13G3.7,1,7305052,0.850246,8225,7296825,2,7305001,-49,-51
I,+,7306785,0.0,0.5,1,1,0,0,241,gene,F13G3.11,2,7306786,1.2388,33,7306752,1,7307114,329,328
I,+,7307114,0.930973,0.0,1130,78,1052,722,7,gene,F13G3.11,2,7307157,1.2388,107,7307007,43,7307114,0,-43
I,+,7317643,0.00433227,0.0,5309,5286,23,18,8,gene,F52A8.1,0,7317644,7.25409,9004,7308639,1,7317643,0,-1
I,+,7339201,0.0,0.00195312,9,9,0,0,2,gene,F52A8.4,0,7339210,0.993309,8726,7330475,9,7339229,28,19
I,+,7347209,0.0,0.5,1,1,0,0,5,gene,F52A8.6,0,7347317,1.05988,1229,7345980,108,7347219,10,-98
I,+,7348058,0.0,0.03125,5,5,0,0,28,gene,F52A8.6,0,7348180,1.05988,2078,7345980,122,7348056,-2,-124
I,+,7354488,0.0,1.50463e-36,119,119,0,0,6,gene,F07A5.3,0,7354490,0.321564,790,7353698,2,7354488,0,-2
I,+,7422663,0.0,7.10543e-15,47,47,0,0,3,gene,ZK524.2,0,7422753,0.451254,14261,7408402,90,7422780,117,27
I,+,7422820,0.0,1.49012e-08,26,26,0,0,10,gene,ZK524.2,0,7422824,0.451254,14418,7408402,4,7422780,-40,-44
I,+,7492310,0.0,0.5,1,1,0,0,62,gene,T28F4.5,0,7492358,38.6652,2001,7490309,48,7492331,21,-27
I,+,7492331,0.00162679,0.0,25203,25162,41,28,102,gene,T28F4.5,0,7492358,38.6652,2022,7490309,27,7492331,0,-27
I,+,7495432,0.00728155,0.0,412,409,3,3,14,gene,C26C6.1,0,7495436,3.47389,2167,7493265,4,7495432,0,-4
I,+,7501312,0.0,0.0,262,262,0,0,3,gene,C26C6.1,0,7501339,3.47389,8047,7493265,27,7501312,0,-27
I,+,7509570,0.0,0.03125,5,5,0,0,1,gene,C26C6.7,0,7509577,0.0902881,2884,7506686,7,7509578,8,1
I,+,7522111,0.00578778,0.0,1555,1546,9,6,1,gene,C26C6.2,0,7522204,4.82185,9269,7512842,93,7522111,0,-93
I,+,7553844,0.00328947,0.0,304,303,1,1,3,gene,T25G3.1,0,7553852,0.803445,17852,7535992,8,7553844,0,-8
I,+,7554886,0.00398406,0.0,251,250,1,1,165,gene,T25G3.2,1,7554994,1.01222,339,7554547,108,7554886,0,-108
I,+,7559833,0.370807,1.66705e-18,1103,694,409,339,3,gene,T25G3.3,2,7559837,2.29499,244,7559589,4,7559833,0,-4
I,+,7564578,0.386364,1.24275e-07,484,297,187,145,6,gene,T25G3.4,3,7564579,2.04354,2220,7562358,1,7564578,0,-1
I,+,7574234,0.0,0.0078125,7,7,0,0,49,gene,D2030.2,0,7574256,2.09123,6521,7567713,22,7574234,0,-22
I,+,7574270,0.0010989,0.0,910,909,1,0,349,gene,D2030.2,0,7574272,2.09123,6557,7567713,2,7574270,0,-2
I,+,7575945,0.0,0.125,3,3,0,0,0,gene,D2030.2,0,7575950,2.09123,8232,7567713,5,7575945,0,-5
I,+,7576569,0.0,0.25,2,2,0,0,7,gene,D2030.2,0,7576648,2.09123,8856,7567713,79,7576569,0,-79
I,+,7582100,0.00346706,0.0,4038,4024,14,13,12,gene,D2030.5,0,7582114,1.80913,3543,7578557,14,7582100,0,-14
I,+,7590656,0.848485,5.55402e-21,165,25,140,117,129,gene,D2030.11,2,7590661,0.828788,97,7590559,5,7590662,6,1
I,+,7590662,0.875,0.00183105,16,2,14,9,215,gene,D2030.11,2,7590682,0.828788,4,7590658,20,7590662,0,-20
I,+,7590692,1.0,0.03125,5,0,5,4,198,gene,D2030.11,2,7590753,0.828788,34,7590658,61,7590662,-30,-91
I,+,7590714,0.666667,0.12085,12,4,8,4,105,gene,D2030.11,2,7590753,0.828788,56,7590658,39,7590662,-52,-91
I,+,7591282,1.0,0.03125,5,0,5,5,5,gene,D2030.8,3,7591292,0.42965,84,7591198,10,7591293,11,1
I,+,7591293,0.987013,0.0,231,3,228,184,19,gene,D2030.8,3,7591296,0.42965,95,7591198,3,7591293,0,-3
I,+,7596451,1.0,0.5,1,0,1,1,16,gene,D2030.9,4,7596511,1.53619,1088,7595363,60,7596501,50,-10
I,+,7596501,0.1691,0.0,822,683,139,118,10,gene,D2030.9,4,7596511,1.53619,1138,7595363,10,7596501,0,-10
I,+,7614170,0.0,1.50463e-36,119,119,0,0,0,gene,F29D11.1,0,7614242,1.13409,5974,7608196,72,7614170,0,-72
I,+,7676662,0.0,0.0,453,453,0,0,0,gene,T24B1.1,1,7676675,0.784256,6768,7669894,13,7676662,0,-13
I,+,7679448,0.605455,1.54426e-07,550,217,333,223,1,gene,T23G11.7,2,7679449,1.56518,366,7679082,1,7679448,0,-1
I,+,7683335,0.944882,5.2519e-28,127,7,120,65,6,gene,T23G11.5,3,7683343,0.489161,305,7683030,8,7683334,-1,-9
I,+,7694322,0.660305,5.79773e-08,262,89,173,104,0,gene,T23G11.4,4,7694335,0.894521,118,7694204,13,7694336,14,1
I,+,7695675,0.00574518,0.0,2959,2942,17,16,17,gene,T23G11.3,0,7695689,5.46996,445,7695230,14,7695675,0,-14
I,+,7699539,0.00460829,0.0,217,216,1,1,2,gene,T23G11.2,1,7699540,0.703093,727,7698812,1,7699539,0,-1
I,+,7699640,0.0,0.25,2,2,0,0,39,gene,T23G11.2,1,7699679,0.703093,828,7698812,39,7699539,-101,-140
I,+,7701172,0.285354,1.87481e-18,396,283,113,89,369,gene,T23G11.11,2,7701174,None,217,7700955,2,7701146,-26,-28
I,+,7702423,0.169216,0.0,2092,1738,354,278,13,gene,F27D4.1,0,7702427,5.06039,1040,7701383,4,7702423,0,-4
I,+,7722049,1.0,0.5,1,0,1,1,0,gene,F27D4.3,0,7722077,None,17435,7704614,28,7722078,29,1
I,+,7725013,0.00486486,0.0,1850,1841,9,9,1,gene,F27D4.4,1,7725022,2.1521,1914,7723099,9,7725013,0,-9
I,+,7726791,0.0102041,3.09233e-28,98,97,1,0,9,gene,F27D4.4,1,7726792,2.1521,318,7726473,1,7726793,2,1
I,+,7727261,0.734435,2.65658e-41,787,209,578,354,3,gene,F27D4.5,2,7727292,2.34957,155,7727106,31,7727261,0,-31
I,+,7729178,0.963415,0.0,410,15,395,330,3,gene,F27D4.8,3,7729195,None,99,7729079,17,7729196,18,1
I,+,7731169,0.0,9.31323e-10,30,30,0,0,7,gene,F27D4.6,0,7731183,0.227529,1298,7729871,14,7731184,15,1
I,+,7755759,0.0,8.47033e-22,70,70,0,0,228,gene,F58H10.1,0,7755775,0.70075,17770,7737989,16,7755776,17,1
I,+,7773411,0.00271739,0.0,1472,1468,4,4,30,gene,H15N14.1,0,7773430,1.69834,16844,7756567,19,7773411,0,-19
I,+,7815241,0.0,0.25,2,2,0,0,6,gene,D2005.4,1,7815260,0.373947,28490,7786751,19,7815241,0,-19
I,+,7819531,0.916667,6.91287e-10,48,4,44,39,3,gene,D2005.7,2,7819550,None,128,7819403,19,7819572,41,22
I,+,7819572,0.73444,6.24186e-14,241,64,177,147,52,gene,D2005.7,2,7819640,None,169,7819403,68,7819572,0,-68
I,+,7819635,1.0,0.5,1,0,1,0,22,gene,D2005.7,2,7819640,None,232,7819403,5,7819572,-63,-68
I,+,7820824,0.48503,0.0572287,167,86,81,70,9,gene,D2005.5,3,7820835,0.569279,350,7820474,11,7820836,12,1
I,+,7835807,0.00646831,0.0,773,768,5,5,2,gene,F30F8.3,1,7835819,1.17478,8958,7826849,12,7835807,0,-12
I,+,7837057,0.954895,0.0,909,41,868,577,9,gene,F30F8.9,2,7837204,0.73569,99,7836958,147,7837057,0,-147
I,+,7837074,1.0,0.125,3,0,3,1,2172,gene,F30F8.9,2,7837204,0.73569,116,7836958,130,7837057,-17,-147
I,+,7840435,0.768,2.9147e-43,625,145,480,335,5,gene,F30F8.10,3,7840457,0.9427,422,7840013,22,7840474,39,17
I,+,7842169,0.0,0.00390625,8,8,0,0,3,gene,F30F8.10,3,7842183,0.9427,2156,7840013,14,7842169,0,-14
I,+,7849806,0.606557,5.2155e-12,976,384,592,462,1,gene,F30F8.8,1,7849808,0.967871,2952,7846854,2,7849806,0,-2
I,+,7853743,0.965517,0.0,348,12,336,236,32,gene,R11A5.1,2,7853778,1.06452,117,7853626,35,7853743,0,-35
I,+,7866129,0.00262697,0.0,2284,2278,6,5,10,gene,R11A5.4,0,7866393,18.2074,8286,7857843,264,7866394,265,1
I,+,7866477,0.0,0.25,2,2,0,0,6,gene,R11A5.4,0,7866519,18.2074,8634,7857843,42,7866477,0,-42
I,+,7869960,0.0,0.03125,5,5,0,0,15,gene,R11A5.4,0,7870019,18.2074,2911,7867049,59,7869962,2,-57
I,+,7884312,0.0,2.06795e-25,82,82,0,0,5,gene,F55D12.1,0,7884344,0.53973,12248,7872064,32,7884136,-176,-208
I,+,7884335,0.0,4.70198e-38,124,124,0,0,234,gene,F55D12.1,0,7884344,0.53973,12271,7872064,9,7884136,-199,-208
I,+,7889514,0.0,0.125,3,3,0,0,184,gene,F55D12.2,0,7889549,0.427846,3756,7885758,35,7889349,-165,-200
I,+,7891436,0.0,0.25,2,2,0,0,5,gene,F55D12.2,0,7891493,0.427846,5678,7885758,57,7891436,0,-57
I,+,7936257,0.0137694,0.0,581,573,8,7,12,gene,T22C1.1,1,7936258,1.40266,2497,7933760,1,7936257,0,-1
I,+,7938553,0.959064,2.50259e-40,171,7,164,101,1,gene,T22C1.3,2,7938564,0.759759,182,7938371,11,7938553,0,-11
I,+,7940910,0.440789,0.0223564,152,85,67,54,10,gene,T22C1.5,3,7940911,0.714525,803,7940107,1,7940912,2,1
I,+,7942635,0.0,0.0625,4,4,0,0,11,gene,T22C1.6,4,7942933,1.10492,76,7942559,298,7942712,77,-221
I,+,7942712,0.776042,6.20338e-29,384,86,298,214,56,gene,T22C1.6,4,7942933,1.10492,153,7942559,221,7942712,0,-221
I,+,7942915,0.0,0.25,2,2,0,0,242,gene,T22C1.6,4,7942933,1.10492,356,7942559,18,7942712,-203,-221
I,+,7962047,0.0,0.0,262,262,0,0,0,gene,T22C1.10,0,7962052,0.481563,2040,7960007,5,7962045,-2,-7
I,+,7995733,0.0,3.63798e-12,38,38,0,0,6,gene,C54G4.5,0,7995768,0.186059,2581,7993152,35,7995750,17,-18
I,+,8014405,0.0155039,1.21311e-35,129,127,2,1,4,gene,C54G4.1,1,8014460,2.25434,5295,8009110,55,8014436,31,-24
I,+,8019494,0.0,3.8147e-06,18,18,0,0,44,gene,C54G4.7,2,8019503,0.92034,201,8019293,9,8019494,0,-9
I,+,8019594,0.0,0.015625,6,6,0,0,40,gene,C54G4.7,2,8019648,0.92034,301,8019293,54,8019705,111,57
I,+,8019692,1.0,0.125,3,0,3,0,57,gene,C54G4.7,2,8019806,0.92034,399,8019293,114,8019705,13,-101
I,+,8019705,0.928177,7.54213e-36,181,13,168,125,50,gene,C54G4.7,2,8019806,0.92034,412,8019293,101,8019705,0,-101
I,+,8020779,0.00917431,1.67941e-31,109,108,1,1,0,gene,C54G4.7,2,8020846,0.92034,1486,8019293,67,8020779,0,-67
I,+,8030952,0.00597015,0.0,670,666,4,4,1,gene,K04G2.2,0,8030973,1.15058,8316,8022636,21,8030952,0,-21
I,+,8040792,0.0,0.0,161,161,0,0,1,gene,K04G2.6,0,8040792,0.790241,3659,8037133,0,8040792,0,0
I,+,8050036,0.015873,0.0,189,186,3,3,3,gene,K04G2.8,0,8050054,1.12309,5874,8044162,18,8050036,0,-18
I,+,8083576,0.010101,0.0,297,294,3,3,5,gene,F18C12.2,1,8083595,0.754886,23025,8060551,19,8083576,0,-19
I,+,8095733,0.817734,4.08024e-21,203,37,166,121,4,gene,F18C12.3,2,8095790,0.372097,135,8095598,57,8095733,0,-57
I,+,8103348,0.0,0.125,3,3,0,0,22,gene,C09H6.1,0,8103426,0.801686,4914,8098434,78,8103594,246,168
I,+,8103594,0.448276,0.0305687,145,80,65,59,19,gene,C09H6.1,0,8103598,0.801686,5160,8098434,4,8103594,0,-4
I,+,8125794,0.00657895,2.66247e-44,152,151,1,0,0,gene,C09H6.3,0,8125799,0.657539,16577,8109217,5,8125794,0,-5
I,+,8134108,0.00851536,0.0,5402,5356,46,36,28,gene,T28B8.1,0,8134136,7.5841,4026,8130082,28,8134108,0,-28
I,+,8147420,0.0,4.1359e-25,81,81,0,0,18,gene,T28B8.2,0,8147497,1.15439,12376,8135044,77,8147420,0,-77
I,+,8174871,0.0,0.00012207,13,13,0,0,0,gene,H31B20.1,0,8174879,0.0503903,1390,8173481,8,8174880,9,1
I,+,8196051,0.0,2.32831e-10,32,32,0,0,1,gene,F08A10.1,0,8196051,0.205822,11313,8184738,0,8196051,0,0
I,+,8205453,0.0,7.27596e-12,37,37,0,0,2,gene,F08A10.1,0,8205585,0.205822,4813,8200640,132,8205453,0,-132
I,+,8214374,0.0030581,0.0,327,326,1,1,13,gene,T02E1.3,0,8214401,0.821598,1978,8212396,27,8214402,28,1
I,+,8235730,0.0,0.25,2,2,0,0,1,gene,T02E1.8,0,8235738,0.38655,17745,8217985,8,8235739,9,1
I,+,8235739,0.0,0.0,185,185,0,0,2,gene,T02E1.8,0,8235858,0.38655,17754,8217985,119,8235739,0,-119
I,+,8255340,0.0115207,0.0,434,429,5,5,5,gene,ZK265.6,0,8255344,1.80631,10471,8244869,4,8255345,5,1
I,+,8262031,0.0111111,7.27014e-26,90,89,1,0,51,gene,ZK265.7,0,8262076,0.366004,5727,8256304,45,8262031,0,-45
I,+,8274050,0.0,0.000244141,12,12,0,0,2,gene,T01G9.1,0,8274064,0.109199,5064,8268986,14,8274004,-46,-60
I,+,8294872,0.0119332,0.0,419,414,5,4,10,gene,T01G9.5,0,8294872,1.27757,10411,8284461,0,8294872,0,0
I,+,8323920,0.0,0.5,1,1,0,0,38,gene,F52B5.5,0,8323975,0.552142,27019,8296901,55,8324111,191,136
I,+,8324003,0.0,0.125,3,3,0,0,2,gene,F52B5.5,0,8324055,0.552142,27102,8296901,52,8324111,108,56
I,+,8324286,0.0,0.0,247,247,0,0,2,gene,F52B5.5,0,8324291,0.552142,214,8324072,5,8324286,0,-5
I,+,8324928,0.0,0.5,1,1,0,0,1,gene,F52B5.5,0,8324967,0.552142,856,8324072,39,8324928,0,-39
I,+,8325451,0.0,0.5,1,1,0,0,0,gene,F52B5.5,0,8325484,0.552142,1379,8324072,33,8325451,0,-33
I,+,8327454,0.00740741,3.09945e-39,135,134,1,1,15,gene,F52B5.5,0,8327637,0.552142,3382,8324072,183,8327454,0,-183
I,+,8336957,0.946429,4.60761e-25,112,6,106,71,10,gene,C34B7.2,2,8336972,0.543225,194,8336763,15,8336973,16,1
I,+,8353380,0.0,1.90735e-06,19,19,0,0,4,gene,F16D3.1,0,8353383,0.0973373,11524,8341856,3,8353402,22,19
I,+,8384923,0.0,0.000244141,12,12,0,0,1,gene,F16D3.7,0,8384971,0.0716772,6481,8378442,48,8384972,49,1
I,+,8394720,0.00123609,0.0,1618,1616,2,2,3,gene,T19A6.2,1,8394740,3.07001,7748,8386972,20,8394720,0,-20
I,+,8398910,0.930979,0.0,623,43,580,375,0,gene,T19A6.3,2,8398997,1.57765,292,8398618,87,8398910,0,-87
I,+,8401379,0.0714286,1.40816e-06,28,26,2,1,12,gene,T19A6.4,0,8401405,0.306701,878,8400501,26,8401379,0,-26
I,+,8406868,0.00236967,0.0,422,421,1,1,115,gene,F02E9.1,0,8406869,0.771232,2936,8403932,1,8406835,-33,-34
I,+,8412833,0.0,0.0078125,7,7,0,0,0,gene,F02E9.7,1,8413079,0.589957,5218,8407615,246,8413252,419,173
I,+,8413247,0.020202,7.65353e-27,99,97,2,0,1,gene,F02E9.7,1,8413283,0.589957,5632,8407615,36,8413252,5,-31
I,+,8416823,0.151815,4.26415e-37,303,257,46,41,63,gene,F02E9.4,2,8416823,0.767438,636,8416187,0,8416824,1,1
I,+,8434542,0.002644,0.0,5295,5281,14,14,44,gene,F10D11.1,0,8434547,4.19779,9511,8425031,5,8434542,0,-5
I,+,8460217,0.0132013,0.0,303,299,4,2,1,gene,D1081.2,0,8460219,1.14628,24414,8435803,2,8460217,0,-2
I,+,8487605,0.0,0.0,207,207,0,0,3,gene,D1081.7,1,8487634,1.02501,5076,8482529,29,8487635,30,1
I,+,8487610,0.00492611,0.0,203,202,1,1,3,gene,D1081.7,1,8487634,1.02501,5081,8482529,24,8487635,25,1
I,+,8491283,0.308989,5.01941e-37,1068,738,330,263,13,gene,D1081.8,2,8491297,2.37026,353,8490930,14,8491283,0,-14
I,+,8513894,0.0,0.015625,6,6,0,0,4,gene,K02B12.4,0,8513894,0.081245,4243,8509651,0,8513893,-1,-1
I,+,8591207,0.00571931,0.0,2273,2260,13,9,9,gene,R05D11.3,1,8591208,5.01052,69250,8521957,1,8591207,0,-1
I,+,8592084,0.890852,0.0,962,105,857,519,3,gene,R05D11.5,2,8592120,1.54154,119,8591965,36,8592084,0,-36
I,+,8593019,0.966942,0.0,242,8,234,172,3,gene,R05D11.9,3,8593020,0.84385,101,8592918,1,8593019,0,-1
I,+,8593030,1.0,0.125,3,0,3,2,741,gene,R05D11.9,3,8593059,0.84385,112,8592918,29,8593019,-11,-40
I,+,8596325,0.978799,0.0,283,6,277,195,5,gene,R05D11.6,4,8596329,1.01389,108,8596217,4,8596325,0,-4
I,+,8598650,0.936508,1.47632e-26,126,8,118,79,4,gene,R05D11.4,5,8598710,0.65634,106,8598544,60,8598650,0,-60
I,+,8598756,1.0,0.5,1,0,1,0,64,gene,R05D11.4,5,8598773,0.65634,212,8598544,17,8598650,-106,-123
I,+,8601352,0.358191,9.49388e-17,818,525,293,219,10,gene,R05D11.7,6,8601361,1.91069,141,8601211,9,8601350,-2,-11
I,+,8602117,0.893333,2.37471e-36,225,24,201,149,1,gene,R05D11.8,7,8602145,1.10399,93,8602024,28,8602117,0,-28
I,+,8605255,0.95625,3.19022e-37,160,7,153,93,1,gene,F43G9.13,8,8605271,0.80341,97,8605158,16,8605255,0,-16
I,+,8609919,0.0165975,0.0,241,237,4,4,11,gene,F43G9.2,0,8609922,0.689332,2686,8607233,3,8609923,4,1
I,+,8615380,0.00674157,0.0,445,442,3,3,0,gene,F43G9.5,0,8615384,1.49124,4612,8610768,4,8615380,0,-4
I,+,8640518,0.0247525,0.0,202,197,5,5,4,gene,F43G9.12,1,8640518,0.409455,4482,8636036,0,8640501,-17,-17
I,+,8644425,1.0,0.0625,4,0,4,1,0,gene,VF39H2L.1,2,8644451,0.538007,98,8644327,26,8644467,42,16
I,+,8644452,0.794574,1.05674e-22,258,53,205,143,7,gene,VF39H2L.1,2,8644490,0.538007,125,8644327,38,8644467,15,-23
I,+,8646443,0.956522,3.6948e-27,115,5,110,76,39,gene,F39H2.2,3,8646510,0.806234,147,8646296,67,8646443,0,-67
I,+,8649753,0.333333,0.375,3,2,1,0,1,gene,F39H2.2,3,8649756,0.806234,3457,8646296,3,8649753,0,-3
I,+,8658891,0.00221729,0.0,1353,1350,3,2,1,gene,F39H2.1,0,8658903,3.16435,7117,8651774,12,8658891,0,-12
I,+,8660823,0.0034965,0.0,286,285,1,1,8,gene,F39H2.5,0,8660828,0.269083,865,8659958,5,8660823,0,-5
I,+,8664968,0.00331126,0.0,604,602,2,2,36,gene,F39H2.3,1,8665019,0.751736,1874,8663094,51,8664968,0,-51
I,+,8666587,0.896607,0.0,619,64,555,387,6,gene,K07A12.1,2,8666674,1.07692,98,8666489,87,8666587,0,-87
I,+,8692938,0.00757156,0.0,5415,5374,41,35,16,gene,K07A12.3,0,8692939,8.91172,23160,8669778,1,8692938,0,-1
I,+,8696595,0.0228137,0.0,263,257,6,6,19,gene,F39H11.1,0,8696598,1.29722,3136,8693459,3,8696595,0,-3
I,+,8702323,0.0,0.125,3,3,0,0,3,gene,F39H11.3,0,8702411,0.981705,4696,8697627,88,8702470,147,59
I,+,8728759,0.00249626,0.0,2003,1998,5,5,78,gene,C36B1.3,1,8728760,2.17168,22961,8705798,1,8728761,2,1
I,+,8730148,0.96493,0.0,998,35,963,750,2,gene,C36B1.14,2,8730150,1.34861,96,8730052,2,8730151,3,1
I,+,8736205,0.000874126,0.0,1144,1143,1,1,1,gene,C36B1.7,1,8736213,1.46083,2779,8733426,8,8736059,-146,-154
I,+,8737128,0.909605,0.0,354,32,322,242,3,gene,C36B1.8,2,8737186,0.99525,104,8737024,58,8737128,0,-58
I,+,8752228,0.00613497,0.0,1304,1296,8,8,1,gene,C36B1.12,0,8752240,1.78646,9684,8742544,12,8752228,0,-12
I,+,8763033,0.00330275,0.0,2725,2716,9,7,15,gene,DY3.2,0,8763047,4.80266,7365,8755668,14,8763033,0,-14
I,+,8768513,0.895652,1.48454e-19,115,12,103,82,0,gene,DY3.4,0,8768549,0.20814,2894,8765619,36,8768513,0,-36
I,+,8792957,0.00140845,0.0,710,709,1,1,3,gene,DY3.7,0,8793089,1.62628,21723,8771234,132,8792957,0,-132
I,+,8793078,0.0,0.5,1,1,0,0,0,gene,DY3.7,0,8793089,1.62628,21844,8771234,11,8793078,0,-11
I,+,8798777,0.0101138,0.0,791,783,8,8,5,gene,F36A2.3,0,8798807,1.50196,1494,8797283,30,8798777,0,-30
I,+,8808767,0.00310559,0.0,322,321,1,1,8,gene,F36A2.8,0,8808821,1.88278,7117,8801650,54,8808767,0,-54
I,+,8808854,0.00514403,0.0,972,967,5,5,54,gene,F36A2.8,0,8808867,1.88278,7204,8801650,13,8808854,0,-13
I,+,8813753,0.00604452,0.0,24485,24337,148,123,5,gene,F36A2.7,0,8813753,17.6421,468,8813285,0,8813753,0,0
I,+,8816972,0.00358423,0.0,558,556,2,2,1,gene,F36A2.9,0,8816972,0.884197,1997,8814975,0,8816973,1,1
I,+,8840690,0.0,0.5,1,1,0,0,1,gene,F29D10.1,0,8840865,0.0676714,17062,8823628,175,8840625,-65,-240
I,+,8867938,0.00124224,0.0,805,804,1,1,6,gene,F55H12.2,0,8867967,1.38618,1322,8866616,29,8867789,-149,-178
I,+,8870095,0.0,0.00195312,9,9,0,0,0,gene,F55H12.5,0,8870097,0.201772,1733,8868362,2,8870095,0,-2
I,+,8876332,0.0,3.8147e-06,18,18,0,0,7,gene,F55H12.3,0,8876351,0.174998,1082,8875250,19,8876363,31,12
I,+,8928741,0.00985222,0.0,203,201,2,2,2,gene,F53B6.1,0,8928746,0.523146,3452,8925289,5,8928747,6,1
I,+,8950359,0.0,0.125,3,3,0,0,0,gene,F53B6.5,0,8950402,0.000848895,1270,8949089,43,8950439,80,37
I,+,8962313,0.0,0.0,237,237,0,0,1,gene,F32H2.1,1,8962340,0.800776,7936,8954377,27,8962313,0,-27
I,+,8966119,0.111111,0.0175781,9,8,1,1,7,gene,F32H2.2,2,8966120,0.907876,39,8966080,1,8966288,169,168
I,+,8966288,0.819328,1.02531e-24,238,43,195,113,5,gene,F32H2.2,2,8966298,0.907876,140,8966148,10,8966288,0,-10
I,+,8970284,0.00660066,0.0,303,301,2,1,5,gene,F32H2.10,1,8970305,1.01585,2315,8967969,21,8970306,22,1
I,+,8971130,0.901053,0.0,475,47,428,350,29,gene,F32H2.4,2,8971155,0.727218,119,8971011,25,8971130,0,-25
I,+,9016757,0.000628141,0.0,1592,1591,1,0,2,gene,F36F2.2,0,9016763,1.01557,14255,9002502,6,9016788,31,25
I,+,9019482,0.0,6.61744e-24,77,77,0,0,18,gene,F36F2.1,0,9019507,0.597896,1497,9017985,25,9019482,0,-25
I,+,9041378,0.0,9.09495e-13,40,40,0,0,24,gene,C31H5.7,0,9041394,0.128979,10155,9031223,16,9041365,-13,-29
I,+,9056044,0.0,0.03125,5,5,0,0,419,gene,W06D4.2,0,9056167,0.479312,14050,9041994,123,9056288,244,121
I,+,9056359,0.0,0.5,1,1,0,0,19,gene,W06D4.2,0,9056409,0.479312,14365,9041994,50,9056359,0,-50
I,+,9065076,0.0333333,2.79397e-08,30,29,1,1,6,gene,W06D4.6,0,9065077,0.175395,4593,9060483,1,9065078,2,1
I,+,9095948,0.00943396,0.0,212,210,2,0,2,gene,W10D5.1,0,9096002,0.916173,25696,9070252,54,9095948,0,-54
I,+,9118106,0.0084246,0.0,1187,1177,10,9,0,gene,ZK858.1,0,9118109,1.53115,17534,9100572,3,9118106,0,-3
I,+,9132529,0.00775194,0.0,1548,1536,12,11,0,gene,ZK858.4,0,9132533,1.84717,6426,9126103,4,9132529,0,-4
I,+,9149742,0.0,0.0,254,254,0,0,13,gene,H32K16.1,0,9149752,0.135577,13696,9136046,10,9149708,-34,-44
I,+,9155527,0.0,0.5,1,1,0,0,26,gene,F25H5.7,0,9155552,0.0452986,2284,9153243,25,9155530,3,-22
I,+,9158792,0.000797448,0.0,1254,1253,1,1,5,gene,F25H5.10,0,9158825,None,1368,9157424,33,9158792,0,-33
I,+,9158798,0.0,0.00390625,8,8,0,0,260,gene,F25H5.10,0,9158825,None,1374,9157424,27,9158792,-6,-33
I,+,9168423,0.238152,0.0,1667,1270,397,326,3,gene,F25H5.3,2,9168453,6.38729,1603,9166820,30,9168423,0,-30
I,+,9173850,0.00137363,0.0,728,727,1,1,4,gene,F25H5.3,2,9174280,6.38729,7030,9166820,430,9173850,0,-430
I,+,9174210,0.0,1.35525e-20,66,66,0,0,77,gene,F25H5.3,2,9174280,6.38729,7390,9166820,70,9174210,0,-70
I,+,9228154,0.0116959,0.0,171,169,2,2,12,gene,C45G3.5,2,9228156,0.613254,110,9228044,2,9228154,0,-2
I,+,9287429,0.00773196,0.0,388,385,3,3,4,gene,F26H9.1,0,9287436,0.363471,35618,9251811,7,9287437,8,1
I,+,9308432,0.00455063,0.0,1758,1750,8,4,0,gene,F26H9.6,1,9308434,4.63857,7693,9300739,2,9308432,0,-2
I,+,9310312,0.911854,0.0,658,58,600,419,6,gene,F26H9.7,2,9310318,0.327356,78,9310234,6,9310319,7,1
I,+,9359065,0.0,3.72529e-09,28,28,0,0,0,gene,M04C9.5,0,9359142,0.0770118,28144,9330921,77,9359065,0,-77
I,+,9410603,0.0,7.27596e-12,37,37,0,0,1,gene,C17E4.2,0,9410604,0.509058,27858,9382745,1,9410605,2,1
I,+,9419451,0.0,3.05176e-05,15,15,0,0,208,gene,C17E4.4,0,9419478,0.308718,2754,9416697,27,9419414,-37,-64
I,+,9422547,0.00251256,0.0,398,397,1,1,0,gene,C17E4.6,1,9422556,1.01645,2558,9419989,9,9422547,0,-9
I,+,9431240,0.754808,0.0,832,204,628,341,4,gene,C17E4.9,2,9431345,3.52815,129,9431111,105,9431240,0,-105
I,+,9435393,0.657767,3.59488e-11,412,141,271,194,10,gene,C17E4.10,3,9435455,1.18127,1548,9433845,62,9435393,0,-62
I,+,9438493,0.0,0.0625,4,4,0,0,1,gene,C17E4.10,3,9438516,1.18127,4648,9433845,23,9438490,-3,-26
I,+,9463751,0.2,0.0439453,10,8,2,0,15,gene,F46A9.3,0,9463770,0.131165,3214,9460537,19,9463751,0,-19
I,+,9469577,0.0,1.69407e-21,69,69,0,0,0,gene,F46A9.4,0,9469693,3.20348,689,9468888,116,9469694,117,1
I,+,9469680,0.00489779,0.0,4696,4673,23,21,37,gene,F46A9.4,0,9469693,3.20348,792,9468888,13,9469694,14,1
I,+,9471404,0.0,0.125,3,3,0,0,100,gene,F46A9.5,0,9471444,12.8959,784,9470620,40,9471540,136,96
I,+,9471541,0.05,0.0,300,285,15,12,509,gene,F46A9.5,0,9471553,12.8959,921,9470620,12,9471541,0,-12
I,+,9488478,0.00515464,0.0,776,772,4,4,13,gene,F30A10.6,0,9488486,1.48392,1948,9486530,8,9488478,0,-8
I,+,9501258,0.0102041,3.09233e-28,98,97,1,0,2,gene,F30A10.8,0,9501311,0.577471,7924,9493334,53,9501258,0,-53
I,+,9506543,0.0173913,1.57806e-31,115,113,2,2,1,gene,F30A10.10,0,9506545,0.669858,1389,9505154,2,9506543,0,-2
I,+,9512442,0.0,4.65661e-10,31,31,0,0,1,gene,C41G7.2,0,9512468,0.575866,1268,9511174,26,9512442,0,-26
I,+,9519234,0.0,1.57772e-30,99,99,0,0,10,gene,C41G7.4,0,9519247,0.153602,4607,9514627,13,9519248,14,1
I,+,9522542,0.0,0.00195312,9,9,0,0,8,gene,C41G7.5,0,9522567,0.106255,1277,9521265,25,9522568,26,1
I,+,9524652,0.0,0.000976562,10,10,0,0,13,gene,C41G7.5,0,9524787,0.106255,3387,9521265,135,9524652,0,-135
I,+,9544723,0.0027933,0.0,358,357,1,1,1,gene,C36F7.2,0,9544759,0.315318,10266,9534457,36,9544738,15,-21
I,+,9576308,0.0,0.5,1,1,0,0,6,gene,F42H11.1,0,9576346,0.000632316,18222,9558086,38,9576347,39,1
I,+,9585407,0.106557,2.06573e-20,122,109,13,11,147,gene,K07A1.2,0,9585410,2.67197,7510,9577897,3,9585407,0,-3
I,+,9585411,0.0,6.10352e-05,14,14,0,0,839,gene,K07A1.2,0,9585464,2.67197,7514,9577897,53,9585411,0,-53
I,+,9606243,0.0,3.55271e-15,48,48,0,0,106,gene,K07A1.16,0,9606251,1.05655,14431,9591812,8,9606243,0,-8
I,+,9620222,0.00784314,0.0,765,759,6,6,0,gene,T05F1.1,0,9620228,2.49119,11187,9609035,6,9620222,0,-6
I,+,9626230,0.00201207,0.0,497,496,1,1,7,gene,T05F1.6,1,9626263,1.85256,1517,9624713,33,9626251,21,-12
I,+,9631377,0.848,7.21716e-31,250,38,212,166,6,gene,T05F1.4,2,9631384,1.1048,541,9630836,7,9631385,8,1
I,+,9642334,0.0,0.125,3,3,0,0,5,gene,T05F1.8,0,9642345,0.216819,9944,9632390,11,9642359,25,14
I,+,9645663,0.0,0.125,3,3,0,0,0,gene,T05F1.9,0,9645686,0.0480652,1842,9643821,23,9645687,24,1
I,+,9650604,0.0,0.0625,4,4,0,0,29,gene,T05F1.13,0,9650619,0.274046,3011,9647593,15,9650511,-93,-108
I,+,9658262,0.019685,0.0,254,249,5,4,9,gene,C03D6.5,0,9658312,0.682714,2167,9656095,50,9658262,0,-50
I,+,9669403,0.00585366,0.0,2050,2038,12,11,2,gene,C03D6.8,0,9669408,4.60372,724,9668679,5,9669403,0,-5
I,+,9689185,0.00590669,0.0,31659,31472,187,167,8,gene,C04F12.4,0,9689189,80.5942,550,9688635,4,9689185,0,-4
I,+,9722709,0.0,0.0,186,186,0,0,17,gene,C16C2.2,0,9722791,0.999713,4242,9718467,82,9722709,0,-82
I,+,9727287,0.0,0.03125,5,5,0,0,32,gene,C16C2.1,0,9727334,0.128086,1012,9726275,47,9727192,-95,-142
I,+,9737811,0.0208333,2.18533e-38,144,141,3,3,0,gene,K02A11.1,0,9738018,2.25485,9796,9728015,207,9737811,0,-207
I,+,9740527,0.0,2.84217e-14,45,45,0,0,4,gene,K02A11.1,0,9740543,2.25485,12512,9728015,16,9740527,0,-16
I,+,9754110,0.00286738,0.0,1395,1391,4,4,0,gene,F26E4.1,0,9754225,2.32373,8114,9745996,115,9754110,0,-115
I,+,9773160,0.0057524,0.0,20687,20568,119,106,26,gene,F26E4.6,0,9773163,48.6294,15272,9757888,3,9773164,4,1
I,+,9773163,0.00220403,0.0,3176,3169,7,6,489,gene,F26E4.6,0,9773163,48.6294,15275,9757888,0,9773164,1,1
I,+,9780337,0.0277778,0.0,288,280,8,5,45,gene,F26E4.12,0,9780367,1.15817,809,9779528,30,9780337,0,-30
I,+,9788997,0.00626454,0.0,5587,5552,35,33,2,gene,F26E4.9,1,9789152,22.375,7591,9781406,155,9788997,0,-155
I,+,9793744,0.32767,5.92899e-13,412,277,135,116,6,gene,F26E4.11,2,9793788,1.92013,3787,9789957,44,9793744,0,-44
I,+,9808892,0.00689655,3.25101e-42,145,144,1,0,3,gene,F35C12.2,0,9808996,0.254756,12200,9796692,104,9808892,0,-104
I,+,9812171,0.0,0.5,1,1,0,0,6,gene,F35C12.2,0,9812239,0.254756,15479,9796692,68,9812171,0,-68
I,+,9839586,0.00347222,0.0,288,287,1,1,0,gene,Y67A6A.2,0,9839596,0.315689,26491,9813095,10,9839586,0,-10
I,+,9840985,0.0,0.5,1,1,0,0,1,gene,Y67A6A.2,0,9840987,0.315689,27890,9813095,2,9840985,0,-2
I,+,9847394,0.00298954,0.0,669,667,2,1,1,gene,K10C3.3,0,9847394,1.2654,2598,9844796,0,9847395,1,1
I,+,9860485,0.0,0.0625,4,4,0,0,4,gene,K10C3.4,1,9860490,2.73045,10415,9850070,5,9860491,6,1
I,+,9863578,0.86,3.72754e-33,250,35,215,160,6,gene,K10C3.5,2,9863586,0.487845,117,9863461,8,9863587,9,1
I,+,9871216,0.391667,4.3596e-07,480,292,188,148,3,gene,K10C3.6,3,9871217,2.56005,2169,9869047,1,9871216,0,-1
I,+,9886183,0.0,2.01948e-28,92,92,0,0,5,gene,T23H4.3,0,9886187,0.126831,1104,9885079,4,9886188,5,1
I,+,9901062,0.0,0.0625,4,4,0,0,11,gene,F52F12.4,0,9901099,0.900133,12853,9888209,37,9901267,205,168
I,+,9901267,0.00384025,0.0,1302,1297,5,5,0,gene,F52F12.4,0,9901279,0.900133,13058,9888209,12,9901267,0,-12
I,+,9947800,0.00246103,0.0,1219,1216,3,2,8,gene,T24D1.1,0,9947860,1.14241,12391,9935409,60,9947827,27,-33
I,+,9965567,0.00606061,0.0,330,328,2,2,0,gene,T23D8.1,0,9965578,1.22878,12164,9953403,11,9965575,8,-3
I,+,9989789,0.920398,5.71839e-38,201,16,185,163,1,gene,T23D8.7,2,9989790,0.449573,287,9989502,1,9989789,0,-1
I,+,10016759,0.0,1.52588e-05,16,16,0,0,1,gene,C03C11.2,0,10016764,0.115764,1277,10015482,5,10016765,6,1
I,+,10026630,0.00733676,0.0,1363,1353,10,10,12,gene,F10G8.3,1,10026630,1.59231,1,10026629,0,10026630,0,0
I,+,10030146,1.0,1.0842e-19,63,0,63,49,1,gene,F10G8.7,2,10030171,0.628433,101,10030045,25,10030172,26,1
I,+,10046428,0.34023,6.1622e-12,435,287,148,115,7,gene,F10G8.6,3,10046435,1.94652,65,10046363,7,10046431,3,-4
I,+,10048073,0.988281,0.0,256,3,253,184,28,gene,F10G8.9,4,10048096,0.236429,110,10047963,23,10048073,0,-23
I,+,10049041,0.0,0.5,1,1,0,0,4,gene,F10G8.9,4,10049047,0.236429,1078,10047963,6,10049041,0,-6
I,+,10074962,0.0,0.25,2,2,0,0,17,gene,B0379.1,0,10074994,1.31478,24260,10050702,32,10074955,-7,-39
I,+,10080145,0.00384615,0.0,1300,1295,5,5,0,gene,B0379.3,0,10080147,1.21502,2410,10077735,2,10080145,0,-2
I,+,10110968,0.0,8.27181e-25,80,80,0,0,4,gene,Y106G6D.2,0,10110990,0.19269,20174,10090794,22,10110841,-127,-149
I,+,10114736,0.0,0.03125,5,5,0,0,5,gene,Y106G6D.4,0,10114778,0.0557608,204,10114532,42,10114779,43,1
I,+,10117146,0.0192308,1.15463e-14,52,51,1,1,68,gene,Y106G6D.8,0,10117153,1.00235,570,10116576,7,10117146,0,-7
I,+,10122448,0.0,2.8026e-45,148,148,0,0,0,gene,Y106G6D.7,0,10122505,0.548758,4383,10118065,57,10122458,10,-47
I,+,10147312,0.0,0.000976562,10,10,0,0,10,gene,F16C3.1,0,10147318,0.179469,5701,10141611,6,10147364,52,46
I,+,10154895,0.0,0.015625,6,6,0,0,9,gene,F16C3.3,0,10154910,0.0470773,4794,10150101,15,10155271,376,361
I,+,10162368,0.015625,0.0,320,315,5,4,3,gene,C25A1.1,0,10162375,1.0667,2359,10160009,7,10162376,8,1
I,+,10177168,0.018648,0.0,429,421,8,7,490,gene,C25A1.5,1,10177175,1.60358,13599,10163569,7,10177168,0,-7
I,+,10178986,0.5,0.375,4,2,2,2,9,gene,C25A1.6,2,10179028,9.74148,80,10178906,42,10178991,5,-37
I,+,10179005,0.400993,9.73111e-20,2015,1207,808,618,313,gene,C25A1.16,3,10179028,None,99,10178906,23,10179005,0,-23
I,+,10179819,0.944056,3.18651e-31,143,8,135,116,6,gene,C25A1.7,4,10179831,0.472121,83,10179736,12,10179827,8,-4
I,+,10179827,0.956522,0.0,253,11,242,184,120,gene,C25A1.7,4,10179831,0.472121,91,10179736,4,10179827,0,-4
I,+,10193229,0.00974026,0.0,308,305,3,2,1,gene,C25A1.13,0,10193296,2.00398,3105,10190124,67,10193229,0,-67
I,+,10248193,0.0,0.03125,5,5,0,0,8,gene,ZC247.3,0,10248326,0.275469,26987,10221206,133,10248276,83,-50
I,+,10299263,0.0,1.52588e-05,16,16,0,0,3,gene,T20F10.2,0,10299293,1.02007,6909,10292354,30,10299262,-1,-31
I,+,10330867,0.00352972,0.0,100858,100502,356,305,24,gene,ZC434.2,0,10330876,147.78,474,10330393,9,10330867,0,-9
I,+,10336383,0.0111111,0.0,270,267,3,1,0,gene,ZC434.5,1,10336400,2.19988,4662,10331721,17,10336383,0,-17
I,+,10340988,0.905556,1.83873e-31,180,17,163,85,5,gene,ZC434.6,2,10340992,0.588597,109,10340879,4,10341003,15,11
I,+,10345726,0.983607,0.0,671,11,660,452,2,gene,ZC434.7,3,10345729,0.493851,90,10345636,3,10345726,0,-3
I,+,10356241,0.00392927,0.0,509,507,2,2,10,gene,ZC434.9,0,10356298,0.667382,8243,10347998,57,10356299,58,1
I,+,10374797,0.00510204,0.0,196,195,1,1,0,gene,F45H11.3,1,10374801,0.541795,3118,10371679,4,10374802,5,1
I,+,10380085,0.727928,3.86795e-28,555,151,404,288,2,gene,F45H11.8,2,10380205,None,468,10379617,120,10380085,0,-120
I,+,10381070,0.91954,0.0,1044,84,960,673,1,gene,F45H11.5,3,10381165,1.87999,93,10380977,95,10381070,0,-95
I,+,10401055,0.00563154,0.0,1243,1236,7,6,3,gene,F25D7.2,0,10401058,2.05727,19039,10382016,3,10401055,0,-3
I,+,10409290,0.00358423,0.0,279,278,1,1,6,gene,F25D7.3,0,10409346,0.798556,6540,10402750,56,10409347,57,1
I,+,10436242,0.00613278,0.0,53157,52831,326,301,1,gene,Y106G6H.3,0,10436251,112.512,3921,10432321,9,10436252,10,1
I,+,10446652,0.0,1.32349e-23,76,76,0,0,5,gene,Y106G6H.7,1,10446665,0.54047,9785,10436867,13,10446666,14,1
I,+,10452155,1.0,0.015625,6,0,6,4,1,gene,Y106G6H.8,2,10452170,1.34467,97,10452058,15,10452167,12,-3
I,+,10452167,0.875725,0.0,2068,257,1811,1351,44,gene,Y106G6H.8,2,10452170,1.34467,109,10452058,3,10452167,0,-3
I,+,10471490,0.0,0.25,2,2,0,0,12,gene,Y106G6H.13,0,10471499,0.798619,18610,10452880,9,10471490,0,-9
I,+,10486690,0.00724638,3.96041e-40,138,137,1,1,1,gene,F37D6.3,0,10486702,0.196641,11204,10475486,12,10486703,13,1
I,+,10488609,0.333333,0.375,3,2,1,0,17,gene,F37D6.4,0,10488636,0.0153543,1284,10487325,27,10488637,28,1
I,+,10501574,0.00657895,2.66247e-44,152,151,1,0,2,gene,F37D6.6,0,10501717,0.243852,12009,10489565,143,10501587,13,-130
I,+,10509020,0.0,0.5,1,1,0,0,18,gene,F59C6.8,0,10509078,0.0753046,3120,10505900,58,10508953,-67,-125
I,+,10518366,0.00277778,0.0,360,359,1,1,3,gene,F59C6.4,1,10518367,0.987514,4015,10514351,1,10518366,0,-1
I,+,10519347,0.94584,0.0,7681,416,7265,3930,97,gene,F59C6.5,2,10519347,7.22791,73,10519274,0,10519347,0,0
I,+,10520850,0.931818,7.52834e-10,44,3,41,29,6,gene,F59C6.12,3,10520857,0.21188,78,10520772,7,10520858,8,1
I,+,10526591,0.0105263,2.39814e-27,95,94,1,1,59,gene,F59C6.14,0,10526596,0.353567,1095,10525496,5,10526596,5,0
I,+,10532775,0.0,1.05879e-22,73,73,0,0,74,gene,F59C6.11,0,10532785,0.546858,2695,10530080,10,10532642,-133,-143
I,+,10543000,0.0,0.00195312,9,9,0,0,246,gene,F25H2.2,0,10543012,0.526851,8530,10534470,12,10543011,11,-1
I,+,10543011,0.0,5.04871e-29,94,94,0,0,29,gene,F25H2.2,0,10543012,0.526851,8541,10534470,1,10543011,0,-1
I,+,10551956,0.0,1.19209e-07,23,23,0,0,3,gene,F25H2.4,0,10551965,1.71067,2176,10549780,9,10551966,10,1
I,+,10551966,0.0222989,0.0,4350,4253,97,73,20,gene,F25H2.4,0,10552116,1.71067,2186,10549780,150,10551966,0,-150
I,+,10554353,0.0171821,0.0,291,286,5,5,0,gene,F25H2.6,1,10554422,0.867867,1331,10553022,69,10554353,0,-69
I,+,10554379,0.0,1.42109e-14,46,46,0,0,828,gene,F25H2.6,1,10554422,0.867867,1357,10553022,43,10554353,-26,-69
I,+,10554525,0.0,0.00012207,13,13,0,0,34,gene,F25H2.6,1,10554623,0.867867,1503,10553022,98,10554525,0,-98
I,+,10558310,0.932432,8.52791e-16,74,5,69,41,1,gene,F25H2.7,2,10558310,0.212774,485,10557825,0,10558354,44,44
I,+,10562957,0.0251572,0.0,318,310,8,8,4,gene,F25H2.8,0,10562976,3.82089,2964,10559993,19,10562957,0,-19
I,+,10566337,0.0126488,0.0,2688,2654,34,28,2,gene,F25H2.9,0,10566342,6.32792,1449,10564888,5,10566337,0,-5
I,+,10567881,0.00732665,0.0,22657,22491,166,123,3,gene,F25H2.10,1,10567920,102.767,598,10567283,39,10567881,0,-39
I,+,10569099,0.967361,0.0,16514,539,15975,9558,18,gene,F25H2.11,2,10569120,73.4241,82,10569017,21,10569099,0,-21
I,+,10570066,0.95,2.74802e-27,120,6,114,77,13,gene,F25H2.12,3,10570069,0.23368,2,10570064,3,10570066,0,-3
I,+,10572016,0.974026,1.93626e-20,77,2,75,57,1,gene,F25H2.13,4,10572016,0.263145,113,10571903,0,10572016,0,0
I,+,10579400,0.00300075,0.0,1333,1329,4,4,9,gene,F29C6.1,0,10579405,0.875594,2271,10577129,5,10579400,0,-5
I,+,10579892,0.0,0.125,3,3,0,0,81,gene,F29C6.1,0,10579900,0.875594,2763,10577129,8,10579892,0,-8
I,+,10588666,0.0,0.0,551,551,0,0,4,gene,T22A3.3,0,10589103,2.30066,7856,10580810,437,10588666,0,-437
I,+,10588921,0.0,0.125,3,3,0,0,3,gene,T22A3.3,0,10589103,2.30066,8111,10580810,182,10588921,0,-182
I,+,10598693,0.0,0.0,196,196,0,0,50,gene,T22A3.5,0,10598696,0.328358,216,10598477,3,10598695,2,-1
I,+,10608462,0.00694444,6.45718e-42,144,143,1,1,0,gene,T22A3.8,0,10608479,0.661155,1858,10606604,17,10608453,-9,-26
I,+,10623160,0.0,0.0,526,526,0,0,16,gene,C43H8.2,1,10623164,1.01633,1746,10621414,4,10622939,-221,-225
I,+,10624435,0.5,0.5,2,1,1,1,7,gene,C43H8.1,2,10624457,1.69609,93,10624342,22,10624451,16,-6
I,+,10624451,0.855978,0.0,368,53,315,187,15,gene,C43H8.1,2,10624457,1.69609,109,10624342,6,10624451,0,-6
I,+,10625375,0.0219436,0.0,319,312,7,6,58,gene,B0511.6,3,10625381,4.01987,1,10625374,6,10625375,0,-6
I,+,10687350,0.0114464,0.0,961,950,11,8,9,gene,C34B2.2,0,10687356,1.86383,12501,10674849,6,10687352,2,-4
I,+,10720802,0.0101266,0.0,395,391,4,3,2,gene,B0205.9,0,10720812,0.48148,10438,10710364,10,10720813,11,1
I,+,10726902,0.0,0.000488281,11,11,0,0,7,gene,B0205.14,0,10726904,0.154007,3422,10723480,2,10726905,3,1
I,+,10730456,0.0102916,0.0,1166,1154,12,12,0,gene,B0205.12,0,10730461,3.08414,3085,10727371,5,10730462,6,1
I,+,10734009,0.00665927,0.0,2703,2685,18,14,12,gene,B0205.7,1,10734025,6.97892,2145,10731864,16,10734009,0,-16
I,+,10736676,1.0,0.015625,6,0,6,3,39,gene,B0205.6,2,10736690,0.976958,74,10736602,14,10736684,8,-6
I,+,10736684,0.973422,0.0,301,8,293,195,39,gene,B0205.6,2,10736690,0.976958,82,10736602,6,10736684,0,-6
I,+,10740205,0.8,0.15625,5,1,4,3,3,gene,B0205.5,3,10740233,0.0190789,307,10739898,28,10740205,0,-28
I,+,10750559,0.0,0.0,349,349,0,0,0,gene,R13H8.1,0,10750618,3.29055,10661,10739898,59,10750619,60,1
I,+,10750881,0.00436681,0.0,229,228,1,1,4,gene,R13H8.1,0,10750946,3.29055,10983,10739898,65,10750881,0,-65
I,+,10762757,0.0011655,0.0,858,857,1,1,6,gene,R13H8.1,0,10763089,3.29055,22859,10739898,332,10762757,0,-332
I,+,10770629,0.0,0.5,1,1,0,0,1,gene,R13H8.1,0,10770971,3.29055,30731,10739898,342,10771444,815,473
I,+,10771429,0.00401606,0.0,498,496,2,1,6,gene,R13H8.1,0,10771494,3.29055,31531,10739898,65,10771444,15,-50
I,+,10772947,0.0,0.015625,6,6,0,0,4,gene,R13H8.1,0,10772985,3.29055,33049,10739898,38,10772947,0,-38
I,+,10789117,0.0172144,0.0,639,628,11,10,10,gene,F55A3.3,1,10789123,1.98911,7983,10781134,6,10789117,0,-6
I,+,10793388,0.945205,1.15242e-16,73,4,69,51,6,gene,F55A3.2,2,10793417,0.235821,260,10793128,29,10793388,0,-29
I,+,10799610,0.504975,0.0389884,402,199,203,153,0,gene,F55A3.1,3,10799623,0.708131,1568,10798042,13,10799610,0,-13
I,+,10808577,0.00621118,0.0,322,320,2,2,5,gene,C35E7.8,0,10808593,0.160405,354,10808223,16,10808594,17,1
I,+,10817341,0.00591716,0.0,169,168,1,0,3,gene,C35E7.6,0,10817346,0.582237,2412,10814929,5,10817347,6,1
I,+,10817429,0.0,0.25,2,2,0,0,67,gene,C35E7.6,0,10817482,0.582237,2500,10814929,53,10817347,-82,-135
I,+,10823350,0.00113122,0.0,884,883,1,1,18,gene,C35E7.5,0,10823367,1.61813,4083,10819267,17,10823368,18,1
I,+,10831868,0.0,8.27181e-25,80,80,0,0,10,gene,C35E7.4,0,10831896,0.476074,1611,10830257,28,10831888,20,-8
I,+,10836972,0.0078125,3.76158e-37,128,127,1,1,8,gene,C35E7.3,0,10836972,0.058246,2173,10834799,0,10836973,1,1
I,+,10841101,0.0,2.32831e-10,32,32,0,0,18,gene,C35E7.2,1,10841107,0.271149,2100,10839001,6,10841101,0,-6
I,+,10844759,0.962264,6.12315e-26,106,4,102,28,11,gene,C35E7.11,2,10844774,0.319641,112,10844647,15,10844759,0,-15
I,+,10844800,1.0,0.5,1,0,1,0,51,gene,C35E7.11,2,10844906,0.319641,153,10844647,106,10844759,-41,-147
I,+,10846766,0.00485437,0.0,412,410,2,1,1,gene,C35E7.1,0,10846786,0.490079,809,10845957,20,10846765,-1,-21
I,+,10904348,0.0,0.00390625,8,8,0,0,0,gene,T27C10.1,0,10904350,0.00270226,2353,10901995,2,10904361,13,11
I,+,10912906,0.0,0.015625,6,6,0,0,8,gene,F49D11.4,0,10912943,0.00582232,6388,10906518,37,10913188,282,245
I,+,10921406,0.0,7.62939e-06,17,17,0,0,132,gene,F49D11.2,0,10921406,0.0168585,2306,10919100,0,10921407,1,1
I,+,10936812,0.0,9.31323e-10,30,30,0,0,7,gene,F49D11.1,1,10936830,0.849554,13301,10923511,18,10936812,0,-18
I,+,10940676,0.930023,0.0,443,31,412,344,1,gene,Y95D11A.3,2,10940699,None,168,10940508,23,10940676,0,-23
I,+,10944201,0.858491,0.0,530,75,455,289,48,gene,Y95D11A.1,3,10944411,0.950819,120,10944081,210,10944201,0,-210
I,+,10970484,0.0,1.46937e-39,129,129,0,0,0,gene,Y52B11A.3,0,10970488,0.356011,24809,10945675,4,10970484,0,-4
I,+,11015526,0.0,0.25,2,2,0,0,49,gene,Y52B11A.5,0,11015628,0.355223,790,11014736,102,11015477,-49,-151
I,+,11032332,0.00534283,0.0,1123,1117,6,6,11,gene,Y52B11A.8,0,11032332,1.76487,14806,11017526,0,11032332,0,0
I,+,11039047,0.0,0.0,208,208,0,0,0,gene,Y52B11A.10,0,11039052,0.364591,5008,11034039,5,11039047,0,-5
I,+,11123733,0.0,0.0,431,431,0,0,0,gene,Y52B11B.1,0,11123751,0.41557,58066,11065667,18,11123752,19,1
I,+,11206912,0.00240288,0.0,2497,2491,6,6,2,gene,W06H12.1,0,11206975,2.6337,20783,11186129,63,11206912,0,-63
I,+,11222316,0.0,0.0,158,158,0,0,7,gene,Y53H1A.2,1,11222377,0.417918,7735,11214581,61,11222356,40,-21
I,+,11222499,0.0,1.17549e-38,126,126,0,0,0,gene,Y53H1A.2,1,11222537,0.417918,7918,11214581,38,11222499,0,-38
I,+,11224826,0.721707,5.63002e-26,539,150,389,290,4,gene,Y53H1A.5,2,11224875,0.49049,674,11224152,49,11224826,0,-49
I,+,11245730,0.0,0.25,2,2,0,0,0,gene,F46A8.2,0,11245739,None,12408,11233322,9,11245813,83,74
I,+,11248146,0.0,0.00390625,8,8,0,0,20,gene,F46A8.11,0,11248155,None,1485,11246661,9,11248088,-58,-67
I,+,11249635,0.0,0.25,2,2,0,0,2,gene,F46A8.1,0,11249638,None,2974,11246661,3,11250129,494,491
I,+,11267984,0.0,0.0625,4,4,0,0,13,gene,F36D1.10,0,11268019,0.0606085,1519,11266465,35,11268020,36,1
I,+,11268039,0.0,0.03125,5,5,0,0,38,gene,F36D1.10,0,11268103,0.0606085,1574,11266465,64,11268020,-19,-83
I,+,11323517,0.00319489,0.0,313,312,1,0,2,gene,H25P06.2,0,11323521,0.796138,18309,11305208,4,11323517,0,-4
I,+,11333940,0.0,0.5,1,1,0,0,3,gene,M04D5.1,0,11333968,None,798,11333142,28,11334357,417,389
I,+,11374612,0.0045977,0.0,435,433,2,2,37,gene,F56G4.4,1,11374613,0.485728,18204,11356408,1,11374614,2,1
I,+,11380221,0.945055,1.39377e-39,182,10,172,109,0,gene,F56G4.5,2,11380227,0.404287,104,11380117,6,11380227,6,0
I,+,11422162,0.0,0.125,3,3,0,0,0,gene,C27C7.7,0,11422178,0.00844816,900,11421262,16,11421922,-240,-256
I,+,11464964,0.0,0.5,1,1,0,0,15,gene,ZK1025.7,0,11465024,0.167465,9526,11455438,60,11465130,166,106
I,+,11501613,0.0,0.015625,6,6,0,0,0,gene,F32B4.8,0,11501625,0.0308969,17054,11484559,12,11501613,0,-12
I,+,11517547,0.0114943,0.0,174,172,2,1,0,gene,F32B4.4,0,11517554,0.752363,417,11517130,7,11517661,114,107
I,+,11521821,0.0,0.000488281,11,11,0,0,2,gene,F32B4.4,0,11521830,0.752363,4032,11517789,9,11521821,0,-9
I,+,11578629,0.0041841,0.0,1673,1666,7,7,8,gene,F15D3.7,0,11578632,3.98711,7782,11570847,3,11578629,0,-3
I,+,11592236,0.0,5.73972e-42,137,137,0,0,7,gene,C17D12.2,0,11592289,0.717911,4917,11587319,53,11592290,54,1
I,+,11611660,0.00967352,0.0,827,819,8,6,6,gene,C17D12.1,0,11611661,1.45994,7639,11604021,1,11611660,0,-1
I,+,11611991,0.0,0.5,1,1,0,0,2,gene,C17D12.1,0,11612063,1.45994,7970,11604021,72,11611991,0,-72
I,+,11623083,0.0,0.5,1,1,0,0,8,gene,Y47H9A.1,0,11623102,0,6472,11616611,19,11623103,20,1
I,+,11629397,0.0,0.25,2,2,0,0,0,gene,W04G5.3,0,11629407,0,2822,11626575,10,11629629,232,222
I,+,11675933,0.00291545,0.0,343,342,1,1,4,gene,F11A6.1,0,11675978,1.13364,1359,11674574,45,11675937,4,-41
I,+,11877791,0.00441176,0.0,680,677,3,2,83,gene,Y47H9C.5,0,11877793,0.815081,28552,11849239,2,11877791,0,-2
I,+,11893950,0.0,5.68434e-14,44,44,0,0,68,gene,Y47H9C.8,0,11893986,0.523587,6684,11887266,36,11893873,-77,-113
I,+,11893959,0.0,0.00195312,9,9,0,0,330,gene,Y47H9C.8,0,11893986,0.523587,6693,11887266,27,11893873,-86,-113
I,+,11893972,0.0,0.125,3,3,0,0,354,gene,Y47H9C.8,0,11893986,0.523587,6706,11887266,14,11893873,-99,-113
I,+,11897642,0.0,0.00390625,8,8,0,0,17,gene,Y47H9C.14,0,11897789,0.118656,672,11896970,147,11897395,-247,-394
I,+,11903707,0.0666667,4.03304e-10,45,42,3,1,7,gene,Y47H9C.11,0,11903721,0.0553252,410,11903297,14,11903722,15,1
I,+,11905871,0.0,0.015625,6,6,0,0,12,gene,R09B3.6,0,11905872,None,713,11905158,1,11905944,73,72
I,+,11905884,0.0,0.000244141,12,12,0,0,31,gene,R09B3.6,0,11905943,None,726,11905158,59,11905944,60,1
I,+,11905917,0.666667,0.12085,12,4,8,5,11,gene,R09B3.6,0,11905943,None,759,11905158,26,11905944,27,1
I,+,11911314,0.00412371,0.0,2425,2415,10,9,2,gene,R09B3.4,0,11911314,3.77589,3771,11907543,0,11911312,-2,-2
I,+,11930744,0.0,0.015625,6,6,0,0,761,gene,R06C1.4,0,11930794,14.5061,18707,11912037,50,11930713,-31,-81
I,+,11946989,0.0,0.0,179,179,0,0,0,gene,R06C1.6,0,11947002,0.60068,15247,11931742,13,11946989,0,-13
I,+,11966256,0.0,7.27596e-12,37,37,0,0,0,gene,Y53C10A.1,0,11966258,None,13120,11953136,2,11966259,3,1
I,+,11979411,0.0,2.1684e-19,62,62,0,0,14,gene,Y53C10A.4,0,11979475,0.550638,11623,11967788,64,11979428,17,-47
I,+,11998769,0.00096432,0.0,1037,1036,1,1,1,gene,Y53C10A.5,0,11998769,0.6616,13166,11985603,0,11998769,0,0
I,+,12005126,0.0,2.11758e-22,72,72,0,0,0,gene,Y53C10A.7,0,12005136,None,2435,12002691,10,12005165,39,29
I,+,12006888,0.0,0.5,1,1,0,0,0,gene,Y53C10A.13,1,12006898,None,433,12006455,10,12006899,11,1
I,+,12008468,0.0,0.5,1,1,0,0,0,gene,Y53C10A.14,2,12008478,None,361,12008107,10,12008479,11,1
I,+,12008567,0.476923,0.0920861,65,34,31,25,0,gene,Y53C10A.14,2,12008595,None,460,12008107,28,12008613,46,18
I,+,12041023,0.00373483,0.0,1071,1067,4,4,4,gene,F58D5.5,0,12041145,5.59956,4016,12037007,122,12041023,0,-122
I,+,12078039,0.166667,0.09375,6,5,1,1,13,gene,Y47H10A.6,0,12078096,None,5154,12072885,57,12077852,-187,-244
I,+,12202220,0.00294985,0.0,339,338,1,0,6,gene,C15C6.1,0,12202226,1.15074,13223,12188997,6,12202220,0,-6
I,+,12207085,0.0176991,6.09364e-31,113,111,2,0,16,gene,C15C6.3,1,12207086,0.979993,1293,12205792,1,12207087,2,1
I,+,12213099,0.820961,4.33593e-24,229,41,188,151,0,gene,C15C6.4,2,12213117,0.604521,422,12212677,18,12213118,19,1
I,+,12307715,0.0,0.5,1,1,0,0,0,gene,F56H6.11,0,12307718,3.23684e-05,1059,12306656,3,12307719,4,1
I,+,12344029,0.0,0.0078125,7,7,0,0,25,gene,T09E11.11,0,12344154,0.153534,1215,12342814,125,12344155,126,1
I,+,12344139,0.0,0.00195312,9,9,0,0,22,gene,T09E11.11,0,12344154,0.153534,1325,12342814,15,12344155,16,1
I,+,12344172,0.0,0.03125,5,5,0,0,33,gene,T09E11.11,0,12344445,0.153534,1358,12342814,273,12344155,-17,-290
I,+,12356925,0.0,0.5,1,1,0,0,3,gene,T09E11.5,0,12356929,0.000357368,600,12356325,4,12356930,5,1
I,+,12458208,0.0,0.000976562,10,10,0,0,7,gene,C54C8.8,0,12458330,None,1047,12457161,122,12458015,-193,-315
I,+,12484168,0.0,0.03125,5,5,0,0,0,gene,T27F6.4,1,12484203,1.93137,18350,12465818,35,12484168,0,-35
I,+,12487004,0.44898,0.0882848,49,27,22,20,57,gene,T27F6.5,2,12487009,0.433759,555,12486449,5,12487004,0,-5
I,+,12490963,0.912329,0.0,365,32,333,218,5,gene,T27F6.6,3,12490966,0.519261,87,12490876,3,12490963,0,-3
I,+,12494798,1.0,0.5,1,0,1,0,2,gene,T27F6.7,4,12494819,0.699134,280,12494518,21,12494813,15,-6
I,+,12494813,0.8327,0.0,526,88,438,283,26,gene,T27F6.7,4,12494819,0.699134,295,12494518,6,12494813,0,-6
I,+,12503977,0.0,0.125,3,3,0,0,0,gene,K11D2.1,0,12504034,0.0660642,6636,12497341,57,12504115,138,81
I,+,12508311,0.0,0.0625,4,4,0,0,7,gene,K11D2.3,2,12508541,0.660285,733,12507578,230,12508475,164,-66
I,+,12508475,0.00628931,0.0,159,158,1,1,53,gene,K11D2.3,2,12508541,0.660285,897,12507578,66,12508475,0,-66
I,+,12508485,0.0,3.72529e-09,28,28,0,0,328,gene,K11D2.3,2,12508541,0.660285,907,12507578,56,12508475,-10,-66
I,+,12513297,0.0,0.25,2,2,0,0,75,gene,K11D2.5,3,12513342,0.229825,5719,12507578,45,12513343,46,1
I,+,12513503,0.976,7.47027e-33,125,3,122,83,5,gene,K11D2.5,3,12513505,0.229825,99,12513404,2,12513343,-160,-162
I,+,12518765,0.727273,0.0805664,11,3,8,4,0,gene,K11D2.4,4,12518812,0.823387,84,12518681,47,12519181,416,369
I,+,12518774,0.952381,1.00136e-05,21,1,20,12,10,gene,K11D2.4,4,12518812,0.823387,93,12518681,38,12519181,407,369
I,+,12518783,1.0,6.93889e-18,57,0,57,37,45,gene,K11D2.4,4,12518812,0.823387,102,12518681,29,12519181,398,369
I,+,12525433,0.00238663,0.0,419,418,1,1,8,gene,K11D2.4,4,12525494,0.823387,6752,12518681,61,12525495,62,1
I,+,12532658,0.00692042,0.0,578,574,4,4,0,gene,W02D9.2,0,12532728,1.47177,4353,12528305,70,12532656,-2,-72
I,+,12532666,0.0,0.03125,5,5,0,0,386,gene,W02D9.2,0,12532728,1.47177,4361,12528305,62,12532656,-10,-72
I,+,12535301,0.00862069,0.0,232,230,2,2,3,gene,W02D9.3,0,12535313,0.291851,966,12534335,12,12535309,8,-4
I,+,12551526,0.0014171,0.0,2117,2114,3,1,11,gene,W02D9.10,0,12551540,2.65393,13868,12537658,14,12551525,-1,-15
I,+,12564503,0.0,0.03125,5,5,0,0,3,gene,C49G9.1,0,12564508,0.08463,64,12564439,5,12564509,6,1
I,+,12621233,0.0,0.0078125,7,7,0,0,2,gene,T07D10.2,0,12621315,0.108479,31340,12589893,82,12621158,-75,-157
I,+,12652605,1.0,0.125,3,0,3,0,0,gene,H28O16.1,0,12652611,40.1313,12133,12640472,6,12652611,6,0
I,+,12659608,0.0,0.0625,4,4,0,0,11,gene,T26E3.11,0,12659715,None,4982,12654626,107,12659716,108,1
I,+,12669367,0.775811,1.03146e-25,339,76,263,177,2,gene,T26E3.3,2,12669488,1.07174,487,12668880,121,12669367,0,-121
I,+,12669613,0.0,0.5,1,1,0,0,7,gene,T26E3.3,2,12669683,1.07174,733,12668880,70,12669613,0,-70
I,+,12679194,0.00213675,0.0,468,467,1,1,21,gene,T26E3.2,0,12679197,0.410627,4760,12674434,3,12679198,4,1
I,+,12738074,0.00323363,0.0,1237,1233,4,0,17,gene,W02A11.3,0,12738089,1.93604,8146,12729928,15,12738074,0,-15
I,+,12741575,0.00618557,0.0,485,482,3,2,1,gene,W02A11.4,0,12741591,1.06354,439,12741136,16,12741592,17,1
I,+,12749879,0.7,0.117188,10,3,7,6,3,gene,W02A11.5,0,12749904,0.0509687,1175,12748704,25,12750023,144,119
I,+,12750023,0.0714286,0.000854492,14,13,1,1,3,gene,W02A11.5,0,12750193,0.0509687,1319,12748704,170,12750023,0,-170
I,+,12773646,0.0,1.61559e-27,89,89,0,0,0,gene,B0019.2,0,12773647,0.403437,14087,12759559,1,12773646,0,-1
I,+,12819203,0.00252313,0.0,1189,1186,3,2,0,gene,Y18D10A.5,0,12819348,3.17293,36961,12782242,145,12819203,0,-145
I,+,12828389,0.0,0.0,236,236,0,0,8,gene,Y18D10A.6,0,12828401,0.419589,3597,12824792,12,12828389,0,-12
I,+,12835102,0.0,3.8147e-06,18,18,0,0,0,gene,Y18D10A.7,0,12835118,0.0340758,954,12834148,16,12835102,0,-16
I,+,12878626,0.0,0.0,329,329,0,0,0,gene,Y18D10A.13,0,12878638,0.60795,17347,12861279,12,12878582,-44,-56
I,+,12904457,0.003003,0.0,10656,10624,32,31,0,gene,Y18D10A.17,0,12904462,13.5567,1663,12902794,5,12904457,0,-5
I,+,12916428,0.0,0.0,304,304,0,0,3,gene,Y18D10A.25,0,12916491,0.63926,10217,12906211,63,12916428,0,-63
I,+,12918708,0.00798152,0.0,9522,9446,76,65,4,gene,Y18D10A.19,0,12918712,39.1016,592,12918116,4,12918708,0,-4
I,+,12921990,0.20202,6.76506e-10,99,79,20,18,1,gene,Y18D10A.20,0,12922025,8.64829,2706,12919284,35,12921990,0,-35
I,+,12932023,0.0,2.98023e-08,25,25,0,0,0,gene,Y18D10A.22,0,12932151,0.0281507,924,12931099,128,12932023,0,-128
I,+,12938541,0.0,9.31323e-10,30,30,0,0,0,gene,F08A8.1,0,12938547,1.06903,4804,12933737,6,12938547,6,0
I,+,12938547,0.0157895,0.0,190,187,3,3,5,gene,F08A8.1,0,12938547,1.06903,4810,12933737,0,12938547,0,0
I,+,12938575,0.0,9.09495e-13,40,40,0,0,361,gene,F08A8.1,0,12938629,1.06903,4838,12933737,54,12938547,-28,-82
I,+,12946925,0.0,2.98023e-08,25,25,0,0,0,gene,F08A8.3,0,12946932,0.0734253,383,12946542,7,12946933,8,1
I,+,12951120,0.0,0.000976562,10,10,0,0,144,gene,F08A8.4,0,12951125,0.324539,143,12950977,5,12951120,0,-5
I,+,12968932,0.00784314,0.0,1275,1265,10,7,1,gene,C47B2.5,1,12968945,3.12761,14944,12953988,13,12968932,0,-13
I,+,12971588,0.000917431,0.0,1090,1089,1,1,15,gene,C47B2.8,2,12971600,0.424929,1330,12970258,12,12971601,13,1
I,+,12975171,0.0,0.0,1152,1152,0,0,10,gene,C47B2.6,1,12975191,2.36134,2037,12973134,20,12975171,0,-20
I,+,12978793,1.0,0.125,3,0,3,3,10,gene,C47B2.7,2,12978824,0.186035,20,12978773,31,12978825,32,1
I,+,12978825,0.944954,0.0,218,12,206,162,1,gene,C47B2.7,2,12978978,0.186035,2,12978823,153,12978825,0,-153
I,+,12982990,0.893617,1.08993e-08,47,5,42,28,1,gene,C47B2.9,3,12983010,0.57898,554,12982436,20,12983006,16,-4
I,+,12983006,0.818792,4.96376e-16,149,27,122,85,226,gene,C47B2.9,3,12983010,0.57898,570,12982436,4,12983006,0,-4
I,+,13004423,0.96577,0.0,409,14,395,296,0,gene,ZK256.1,2,13004726,0.770806,68,13004355,303,13004424,1,-302
I,+,13011416,0.0277778,5.41254e-19,72,70,2,2,2,gene,ZK256.1,2,13011447,0.770806,7061,13004355,31,13011448,32,1
I,+,13033471,0.00181488,0.0,551,550,1,1,36,gene,W05B5.4,0,13033610,0.551067,9881,13023590,139,13033611,140,1
I,+,13050431,0.0,7.62939e-06,17,17,0,0,1,gene,W05B5.2,0,13050432,0.0174899,4906,13045525,1,13050431,0,-1
I,+,13101338,0.0,2.98023e-08,25,25,0,0,3,gene,Y26D4A.21,0,13101341,None,1415,13099923,3,13101342,4,1
I,+,13104237,0.0,4.76837e-07,21,21,0,0,8,gene,C17H1.3,0,13104238,0.112334,2344,13101893,1,13104239,2,1
I,+,13107128,0.0,0.000244141,12,12,0,0,1,gene,C17H1.11,0,13107149,None,681,13106447,21,13107150,22,1
I,+,13113591,0.0,3.30872e-24,78,78,0,0,9,gene,C17H1.5,0,13113622,0.10954,6148,13107443,31,13113623,32,1
I,+,13121078,0.0,2.98023e-08,25,25,0,0,0,gene,C17H1.9,0,13121108,0.0789217,4171,13116907,30,13121078,0,-30
I,+,13133634,0.0,1.49012e-08,26,26,0,0,1,gene,C17H1.10,0,13133688,0.0372517,10135,13123499,54,13133634,0,-54
I,+,13139107,0.0,1.29247e-26,86,86,0,0,0,gene,F22G12.1,0,13139117,0.730794,2964,13136143,10,13139118,11,1
I,+,13143173,0.0,0.125,3,3,0,0,2,gene,F22G12.7,0,13143186,0.0461595,1290,13141883,13,13143187,14,1
I,+,13162480,0.0,0.0,351,351,0,0,9,gene,F22G12.5,0,13162484,0.55002,8788,13153692,4,13162485,5,1
I,+,13235343,0.0,0.015625,6,6,0,0,0,gene,ZK1053.5,0,13235352,0.0403364,675,13234668,9,13235353,10,1
I,+,13241647,0.0,0.0,392,392,0,0,17,gene,ZK1053.4,0,13241654,0.736301,834,13240813,7,13241650,3,-4
I,+,13246529,0.0,0.03125,5,5,0,0,1,gene,ZK1053.3,0,13246534,0.0209817,1817,13244712,5,13246839,310,305
I,+,13246833,0.0,0.03125,5,5,0,0,9,gene,ZK1053.3,0,13246838,0.0209817,2121,13244712,5,13246839,6,1
I,+,13269970,0.0,0.0,339,339,0,0,2,gene,F44F1.7,0,13269985,0.566703,12255,13257715,15,13269981,11,-4
I,+,13292500,0.00164002,0.0,2439,2435,4,3,2,gene,M01E5.5,0,13292611,2.13837,16049,13276451,111,13292500,0,-111
I,+,13309980,0.0,0.0,429,429,0,0,3,gene,T04D3.8,0,13309993,0.438159,1210,13308770,13,13309980,0,-13
I,+,13339293,0.0,0.5,1,1,0,0,1,gene,W08E3.1,1,13339416,6.66651,5971,13333322,123,13339383,90,-33
I,+,13339383,0.0055476,0.0,5588,5557,31,27,4,gene,W08E3.1,1,13339416,6.66651,6061,13333322,33,13339383,0,-33
I,+,13340320,0.923755,0.0,1928,147,1781,959,133,gene,W08E3.3,2,13340334,7.20136,110,13340210,14,13340319,-1,-15
I,+,13347058,0.961039,4.84066e-19,77,3,74,50,1,gene,Y40B1A.2,4,13347065,0.196962,111,13346947,7,13347066,8,1
I,+,13376831,0.0344828,5.40167e-08,29,28,1,1,13,gene,C01A2.9,0,13376861,None,17202,13359629,30,13376862,31,1
I,+,13387805,0.723949,7.65861e-27,547,151,396,260,1,gene,C01A2.3,2,13387817,0.761595,742,13387063,12,13387805,0,-12
I,+,13392104,0.519174,0.0337722,339,163,176,124,3,gene,C01A2.4,3,13392124,1.25178,855,13391249,20,13392104,0,-20
I,+,13397256,0.0012987,0.0,770,769,1,1,3,gene,C01A2.2,0,13397322,0.602848,3269,13393987,66,13397256,0,-66
I,+,13402435,0.00663717,0.0,452,449,3,2,0,gene,C01A2.7,0,13402473,0.831521,3920,13398515,38,13402435,0,-38
I,+,13418444,0.0,0.0,239,239,0,0,0,gene,W05H12.1,0,13418464,0.588134,5579,13412865,20,13418444,0,-20
I,+,13428899,0.0,0.0,552,552,0,0,2,gene,Y40B1B.8,0,13428905,0.631186,5534,13423365,6,13428899,0,-6
I,+,13435475,0.0365619,0.0,3118,3004,114,89,14,gene,Y40B1B.5,1,13435490,2.67467,778,13434697,15,13435475,0,-15
I,+,13435485,0.0,1.49012e-08,26,26,0,0,5249,gene,Y40B1B.5,1,13435490,2.67467,788,13434697,5,13435475,-10,-15
I,+,13438044,0.94186,7.99074e-37,172,10,162,128,13,gene,Y40B1B.6,2,13438053,0.597731,93,13437951,9,13438052,8,-1
I,+,13438052,0.961832,1.09322e-31,131,5,126,80,390,gene,Y40B1B.6,2,13438053,0.597731,101,13437951,1,13438052,0,-1
I,+,13489573,0.0145985,0.0,548,540,8,6,126,gene,Y48G10A.1,0,13489577,1.28614,36746,13452827,4,13489573,0,-4
I,+,13508800,0.0,1.52588e-05,16,16,0,0,19,gene,Y87G2A.19,0,13508933,1.24405,1758,13507042,133,13508800,0,-133
I,+,13514536,0.0,0.0,393,393,0,0,12,gene,Y87G2A.1,0,13514563,0.692043,2524,13512012,27,13514530,-6,-33
I,+,13534729,0.0,4.03897e-28,91,91,0,0,0,gene,Y87G2A.2,0,13534730,0.444573,8453,13526276,1,13534731,2,1
I,+,13572365,0.00446828,0.0,1119,1114,5,4,0,gene,Y87G2A.7,1,13572439,0.506301,5806,13566559,74,13572365,0,-74
I,+,13575750,1.0,0.5,1,0,1,0,2,gene,Y87G2A.8,2,13575774,2.8336,57,13575693,24,13576234,484,460
I,+,13576641,0.132918,0.0,963,835,128,66,6,gene,Y87G2A.8,2,13576642,2.8336,868,13575773,1,13576641,0,-1
I,+,13581684,0.952005,0.0,1521,73,1448,1004,6,gene,Y87G2A.9,3,13581695,1.68531,80,13581604,11,13581684,0,-11
I,+,13629213,0.00478469,0.0,627,624,3,2,2,gene,W09C5.2,0,13629218,1.16787,31797,13597416,5,13629213,0,-5
I,+,13652175,0.0,0.00390625,8,8,0,0,5,gene,W09C5.11,0,13652270,None,16890,13635285,95,13652376,201,106
I,+,13652344,0.00653595,1.4013e-44,153,152,1,1,18,gene,W09C5.11,0,13652416,None,17059,13635285,72,13652376,32,-40
I,+,13663516,0.0,9.62965e-35,113,113,0,0,235,gene,W04A4.5,0,13663521,0.329761,5371,13658145,5,13663470,-46,-51
I,+,13746653,0.0,3.8147e-06,18,18,0,0,17,gene,Y6B3B.7,0,13746840,0.138144,33991,13712662,187,13746846,193,6
I,+,13746660,0.0,1.45519e-11,36,36,0,0,22,gene,Y6B3B.7,0,13746840,0.138144,33998,13712662,180,13746846,186,6
I,+,13756717,0.00727273,0.0,275,273,2,2,2,gene,Y6B3B.4,1,13756721,0.34565,6247,13750470,4,13756722,5,1
I,+,13773043,0.6,0.3125,5,2,3,3,8,gene,Y37H9A.1,2,13773055,0.226453,1251,13771792,12,13773052,9,-3
I,+,13773052,0.901639,2.40803e-11,61,6,55,33,24,gene,Y37H9A.1,2,13773055,0.226453,1260,13771792,3,13773052,0,-3
I,+,13778884,0.894286,0.0,350,37,313,219,3,gene,Y37H9A.3,3,13778893,0.500845,124,13778760,9,13778884,0,-9
I,+,13829555,0.0,7.62939e-06,17,17,0,0,4,gene,W09G3.5,0,13829569,None,33502,13796053,14,13829647,92,78
I,+,13840689,0.00404858,0.0,247,246,1,1,2,gene,W04A8.2,0,13840690,0.407167,9025,13831664,1,13840691,2,1
I,+,13861459,0.846774,5.38352e-16,124,19,105,69,0,gene,W04A8.7,2,13861460,0.420515,1555,13859904,1,13861461,2,1
I,+,13952146,0.00182349,0.0,27420,27370,50,46,6,gene,Y71A12B.1,0,13952162,101.519,10146,13942000,16,13952146,0,-16
I,+,13957176,0.0,0.125,3,3,0,0,3,gene,Y71A12B.10,0,13957183,0.0119657,3945,13953231,7,13957184,8,1
I,+,13978414,0.00194553,0.0,514,513,1,1,3,gene,Y71A12B.11,0,13978431,0.46282,7464,13970950,17,13978415,1,-16
I,+,14004451,0.175,1.69562e-05,40,33,7,3,16,gene,Y71A12B.12,0,14004459,0.492535,1498,14002953,8,14004444,-7,-15
I,+,14009858,0.0434783,2.74181e-06,23,22,1,1,124,gene,ZC334.7,0,14009881,0.0623435,1393,14008465,23,14009882,24,1
I,+,14027221,0.00341964,0.0,2047,2040,7,7,0,gene,ZC334.11,0,14027239,2.80315,6063,14021158,18,14027221,0,-18
I,+,14084503,0.0833333,0.00292969,12,11,1,1,20,gene,Y63D3A.10,0,14084507,0.00963805,6306,14078197,4,14084508,5,1
I,+,14102032,0.000625391,0.0,3198,3196,2,2,0,gene,Y63D3A.5,0,14102149,4.05864,12242,14089790,117,14102032,0,-117
I,+,14113621,0.0150451,0.0,1994,1964,30,26,3,gene,Y63D3A.7,1,14113723,5.68732,8991,14104630,102,14113621,0,-102
I,+,14114168,1.0,0.03125,5,0,5,5,8,gene,Y63D3A.8,2,14114191,1.39953,97,14114071,23,14114179,11,-12
I,+,14114179,0.955128,0.0,468,21,447,335,10,gene,Y63D3A.8,2,14114191,1.39953,108,14114071,12,14114179,0,-12
I,+,14118725,1.0,0.25,2,0,2,2,5,gene,K03D10.3,3,14118742,0.745268,90,14118635,17,14118743,18,1
I,+,14118738,0.860153,0.0,522,73,449,327,24,gene,K03D10.3,3,14118742,0.745268,103,14118635,4,14118743,5,1
I,+,14155069,0.0,0.0625,4,4,0,0,1,gene,C37A5.2,0,14155133,0.463919,27885,14127184,64,14155482,413,349
I,+,14163515,0.00735294,1.5612e-39,136,135,1,1,0,gene,C37A5.7,0,14163542,0.172653,5456,14158059,27,14163515,0,-27
I,+,14171840,0.0111732,0.0,179,177,2,2,1,gene,C37A5.11,0,14171844,None,3543,14168297,4,14171849,9,5
I,+,14263288,0.0111111,0.0,180,178,2,2,0,gene,F09C3.1,0,14263298,0.434082,6293,14256995,10,14263286,-2,-12
I,+,14297272,0.0,9.31323e-10,30,30,0,0,1,gene,F49B2.2,0,14297273,0.0636395,25967,14271305,1,14297274,2,1
I,+,14322222,0.0045045,0.0,222,221,1,1,0,gene,F49B2.5,0,14322271,0.256843,2324,14319898,49,14322222,0,-49
I,+,14330998,0.0,0.000976562,10,10,0,0,2,gene,F49B2.6,0,14331002,0.0465483,2051,14328947,4,14331070,72,68
I,+,14390318,0.0,9.86076e-32,103,103,0,0,1,gene,Y105E8A.7,0,14390352,0.487725,22740,14367578,34,14390318,0,-34
I,+,14406013,0.00288184,0.0,347,346,1,1,1,gene,Y105E8A.9,1,14406027,1.34611,5785,14400228,14,14406013,0,-14
I,+,14418226,0.907975,5.12838e-29,163,15,148,109,1,gene,Y105E8A.10,2,14418519,0.660392,310,14417916,293,14418226,0,-293
I,+,14422398,0.215686,2.11502e-05,51,40,11,10,12,gene,Y105E8A.10,2,14422400,0.660392,4482,14417916,2,14422398,0,-2
I,+,14432778,0.873134,0.0,402,51,351,232,1,gene,Y105E8A.11,3,14432842,1.19632,987,14431791,64,14432778,0,-64
I,+,14441527,0.0,0.5,1,1,0,0,4,gene,Y105E8A.27,0,14441543,0.211961,7794,14433733,16,14441525,-2,-18
I,+,14469491,0.0178174,0.0,449,441,8,5,2,gene,Y105E8A.17,0,14469539,0.763178,25173,14444318,48,14469491,0,-48
I,+,14529516,0.0,0.0,213,213,0,0,0,gene,Y105E8A.26,0,14529516,0.873053,52614,14476902,0,14529516,0,0
I,+,14647767,0.00671141,0.0,1192,1184,8,8,6,gene,Y105E8B.4,1,14647777,2.19875,1178,14646589,10,14647767,0,-10
I,+,14652101,0.26875,2.79126e-25,480,351,129,110,0,gene,Y105E8B.3,2,14652109,1.00035,661,14651440,8,14652101,0,-8
I,+,14657357,0.518519,0.0237112,540,260,280,221,374,gene,Y105E8B.5,3,14657380,2.51072,34,14657323,23,14657340,-17,-40
I,+,14662511,0.920555,0.0,793,63,730,547,18,gene,Y105E8B.6,1,14662522,1.55969,1112,14661399,11,14662523,12,1
I,+,14664434,0.0695364,0.0,604,562,42,36,10,gene,Y105E8B.8,2,14664435,1.30784,949,14663485,1,14664434,0,-1
I,+,14665158,1.0,0.5,1,0,1,1,3,gene,Y105E8B.8,2,14665163,1.30784,1673,14663485,5,14665158,0,-5
I,+,14665389,1.0,0.000488281,11,0,11,9,93,gene,Y105E8B.8,2,14665416,1.30784,1904,14663485,27,14665389,0,-27
I,+,14735208,0.0,3.38813e-21,68,68,0,0,0,gene,K05C4.4,0,14735220,0.0518284,1620,14733588,12,14735221,13,1
I,+,14737687,0.0553047,0.0,886,837,49,42,5,gene,K05C4.7,1,14737687,1.10491,708,14736979,0,14737687,0,0
I,+,14739554,0.820475,0.0,674,121,553,406,20,gene,K05C4.6,2,14739575,1.51761,773,14738781,21,14739554,0,-21
I,+,14739557,0.909091,0.00537109,11,1,10,7,20,gene,K05C4.6,2,14739575,1.51761,776,14738781,18,14739554,-3,-21
I,+,14742750,0.903346,0.0,538,52,486,361,2,gene,K05C4.5,3,14742781,0.915093,110,14742640,31,14742750,0,-31
I,+,14757048,0.00233827,0.0,1283,1280,3,3,0,gene,F39B2.10,0,14757063,6.35558,9277,14747771,15,14757048,0,-15
I,+,14759915,0.00467666,0.0,63293,62997,296,271,5,gene,F39B2.6,0,14759920,38.6692,1143,14758772,5,14759915,0,-5
I,+,14790229,0.00648749,0.0,2158,2144,14,12,10,gene,F39B2.2,1,14790255,6.78208,29582,14760647,26,14790229,0,-26
I,+,14790237,0.0,2.91038e-11,35,35,0,0,961,gene,F39B2.2,1,14790255,6.78208,29590,14760647,18,14790256,19,1
I,+,14791025,0.947197,0.0,1534,81,1453,1097,37,gene,F39B2.1,2,14791042,1.82939,108,14790917,17,14791040,15,-2
I,+,14794884,0.837989,7.29656e-41,358,58,300,189,1,gene,K11B4.1,3,14795034,1.2467,466,14794418,150,14794884,0,-150
I,+,14794950,0.0,0.5,1,1,0,0,63,gene,K11B4.1,3,14795034,1.2467,532,14794418,84,14794884,-66,-150
I,+,14797647,0.870558,0.0,394,51,343,233,17,gene,K11B4.2,4,14797675,1.02684,496,14797151,28,14797648,1,-27
I,+,14807453,0.135135,4.32633e-40,296,256,40,36,1,gene,Y54E5B.1,0,14807455,0.943999,8753,14798700,2,14807453,0,-2
I,+,14820397,0.00952381,0.0,315,312,3,3,9,gene,Y54E5B.3,1,14820408,0.488273,4687,14815710,11,14820392,-5,-16
I,+,14822035,0.88601,0.0,386,44,342,198,7,gene,Y54E5B.4,2,14822053,1.55845,286,14821749,18,14822035,0,-18
I,+,14838939,0.0,0.00390625,8,8,0,0,4,gene,F32A7.8,0,14838994,0.0506648,9464,14829475,55,14838677,-262,-317
I,+,14846463,0.0,4.65661e-10,31,31,0,0,0,gene,F32A7.5,0,14846480,1.52492,3354,14843109,17,14846463,0,-17
I,+,14867899,0.0,2.64698e-23,75,75,0,0,1,gene,F11C3.1,0,14867908,0.0377451,13202,14854697,9,14867909,10,1
I,+,14909225,0.0166667,0.0,180,177,3,3,2,gene,ZK270.1,0,14909261,1.38889,33835,14875390,36,14909225,0,-36
I,+,14909227,0.0,0.25,2,2,0,0,3,gene,ZK270.1,0,14909261,1.38889,33837,14875390,34,14909225,-2,-36
I,+,14919257,0.0,0.5,1,1,0,0,0,gene,ZK909.2,1,14919328,2.99408,3960,14915297,71,14919516,259,188
I,+,14919518,0.0246914,1.34003e-21,81,79,2,0,0,gene,ZK909.2,1,14919519,2.99408,4221,14915297,1,14919518,0,-1
I,+,14933789,0.000892857,0.0,1120,1119,1,1,0,gene,ZK909.2,1,14933888,2.99408,18492,14915297,99,14933789,0,-99
I,+,14946062,0.0,3.46945e-18,58,58,0,0,16,gene,ZK909.2,1,14946085,2.99408,30765,14915297,23,14945992,-70,-93
I,+,14953475,0.021093,0.0,2086,2042,44,26,1,gene,ZK909.3,2,14953479,2.21285,1274,14952201,4,14953475,0,-4
I,+,14961488,0.0,0.0,281,281,0,0,8,gene,ZK909.4,0,14961511,0.829789,6011,14955477,23,14961507,19,-4
I,+,14967286,0.0153257,0.0,261,257,4,2,10,gene,ZK909.6,0,14967297,1.00399,1946,14965340,11,14967298,12,1
I,+,14967296,0.0,9.09495e-13,40,40,0,0,472,gene,ZK909.6,0,14967297,1.00399,1956,14965340,1,14967298,2,1
I,+,14975404,0.0125,8.40779e-45,160,158,2,0,1,gene,ZK337.2,0,14975408,0.363626,6879,14968525,4,14975404,0,-4
I,+,14993760,0.0,0.00195312,9,9,0,0,5,gene,ZK337.1,0,14993763,0.836615,6117,14987643,3,14993806,46,43
I,+,14993806,0.0,4.65661e-10,31,31,0,0,3,gene,ZK337.1,0,14993808,0.836615,6163,14987643,2,14993806,0,-2
I,+,14994619,0.0,3.63798e-12,38,38,0,0,22,gene,ZK337.1,0,14994757,0.836615,6976,14987643,138,14994756,137,-1
I,+,14994756,0.0,0.0,152,152,0,0,4,gene,ZK337.1,0,14994757,0.836615,7113,14987643,1,14994756,0,-1
I,+,15023119,0.0,0.25,2,2,0,0,4,gene,F33H2.2,0,15023204,0.540556,17523,15005596,85,15023125,6,-79
I,+,15034502,0.00417872,0.0,3111,3098,13,11,9,gene,F33H2.3,1,15034516,4.06735,5343,15029159,14,15034502,0,-14
I,+,15036194,0.142857,0.000634193,21,18,3,3,0,gene,F31C3.2,2,15036223,2.78824,744,15035450,29,15036358,164,135
I,+,15036360,0.110849,0.0,424,377,47,28,0,gene,F31C3.2,2,15036361,2.78824,910,15035450,1,15036362,2,1
I,+,15053002,0.0118203,0.0,846,836,10,8,6,gene,F31C3.5,0,15053009,0.907149,10993,15042009,7,15053010,8,1
II,+,1848,0.00884956,1.08815e-32,113,112,1,1,0,gene,2L52.1,0,1866,0.18117,0,0,18,1867,19,1
II,+,6663,0.0416667,1.43051e-06,24,23,1,0,0,gene,C01B12.4,0,6663,0.0972663,1137,5526,0,6664,1,1
II,+,12985,0.0,1.57772e-30,99,99,0,0,11,gene,C01B12.3,0,12985,0.268286,3499,9486,0,12985,0,0
II,+,19538,0.0144928,2.71288e-38,138,136,2,2,0,gene,C01B12.2,0,19556,0.661121,3531,16007,18,19538,0,-18
II,+,23330,0.00372856,0.0,1341,1336,5,3,4,gene,C01B12.1,0,23346,4.73157,1161,22169,16,23330,0,-16
II,+,23429,0.0,6.10352e-05,14,14,0,0,162,gene,C01B12.1,0,23445,4.73157,1260,22169,16,23330,-99,-115
II,+,23476,0.0,0.0625,4,4,0,0,357,gene,C01B12.1,0,23575,4.73157,1307,22169,99,23330,-146,-245
II,+,45040,0.95672,0.0,439,19,420,302,11,gene,F23F1.9,2,45044,0.898809,56,44984,4,45040,0,-4
II,+,47580,0.932886,0.0,298,20,278,211,3,gene,C23H3.5,3,47583,0.533156,102,47478,3,47580,0,-3
II,+,51652,0.28529,4.86763e-30,673,481,192,147,5,gene,C23H3.4,4,51658,2.03968,1547,50105,6,51652,0,-6
II,+,51675,0.0,0.25,2,2,0,0,2572,gene,C23H3.4,4,51722,2.03968,1570,50105,47,51675,0,-47
II,+,57672,0.891892,3.06209e-24,148,16,132,95,1,gene,C23H3.3,5,57714,0.476192,59,57613,42,57672,0,-42
II,+,61304,0.00224215,0.0,446,445,1,1,14,gene,C23H3.2,0,61314,1.79709,1264,60040,10,61313,9,-1
II,+,61313,0.0,0.0,462,462,0,0,256,gene,C23H3.2,0,61314,1.79709,1273,60040,1,61313,0,-1
II,+,61528,0.0,0.5,1,1,0,0,1,gene,C23H3.2,0,61689,1.79709,1488,60040,161,61528,0,-161
II,+,62895,0.0,6.77626e-21,67,67,0,0,33,gene,C23H3.2,0,62971,1.79709,2855,60040,76,63078,183,107
II,+,69654,0.0058309,0.0,343,341,2,2,0,gene,C23H3.1,0,69680,0.530922,5183,64471,26,69660,6,-20
II,+,84819,0.0,1.92593e-34,112,112,0,0,0,gene,C50D2.6,0,84834,0.20025,13519,71300,15,84434,-385,-400
II,+,98404,0.0189983,0.0,579,568,11,10,7,gene,C50D2.5,0,98410,2.12665,10606,87798,6,98151,-253,-259
II,+,99845,0.866667,0.00320435,15,2,13,5,31,gene,C50D2.10,0,99862,0.180341,835,99010,17,99823,-22,-39
II,+,99850,1.0,0.0625,4,0,4,4,25,gene,C50D2.10,0,99862,0.180341,840,99010,12,99823,-27,-39
II,+,99870,1.0,0.5,1,0,1,0,113,gene,C50D2.10,0,99915,0.180341,860,99010,45,99823,-47,-92
II,+,104536,0.00342466,0.0,292,291,1,1,3,gene,C50D2.4,0,104542,0.248044,3476,101060,6,104543,7,1
II,+,109165,0.0222222,1.27898e-12,45,44,1,0,0,gene,C50D2.2,0,109202,0.160545,1647,107518,37,109165,0,-37
II,+,109189,0.0,0.5,1,1,0,0,149,gene,C50D2.2,0,109202,0.160545,1671,107518,13,109165,-24,-37
II,+,147243,0.00385604,0.0,778,775,3,3,13,gene,T25D3.4,0,147267,0.650595,7266,139977,24,147273,30,6
II,+,152685,0.5,0.5,2,1,1,1,20,gene,T25D3.3,0,152701,0.403381,90,152595,16,152203,-482,-498
II,+,163086,0.000751315,0.0,1331,1330,1,1,1,gene,T01D1.2,0,163136,1.60243,8143,154943,50,163086,0,-50
II,+,164406,0.0,0.03125,5,5,0,0,0,gene,T01D1.2,0,164594,1.60243,9463,154943,188,164406,0,-188
II,+,166753,0.0,0.5,1,1,0,0,2,gene,T01D1.2,0,166754,1.60243,11810,154943,1,166753,0,-1
II,+,191086,0.0,0.5,1,1,0,0,2,gene,T01D1.8,0,191100,0.177927,20462,170624,14,191084,-2,-16
II,+,258415,0.0,0.000976562,10,10,0,0,1,gene,B0432.5,0,258479,0.0324861,46495,211920,64,258812,397,333
II,+,258647,0.0,0.5,1,1,0,0,2,gene,B0432.5,0,258811,0.0324861,46727,211920,164,258812,165,1
II,+,264352,0.00568182,0.0,352,350,2,2,2,gene,B0432.14,0,264428,0.757731,3318,261034,76,264352,0,-76
II,+,286626,0.00276243,0.0,362,361,1,1,8,gene,B0432.4,1,286631,2.20755,20506,266120,5,286632,6,1
II,+,288938,0.836879,0.0,423,69,354,232,0,gene,B0432.3,2,289002,1.7612,242,288696,64,288938,0,-64
II,+,290581,0.766944,0.0,841,196,645,450,4,gene,B0432.2,3,290607,1.67768,183,290398,26,290581,0,-26
II,+,297391,0.0,7.62939e-06,17,17,0,0,1,gene,B0432.1,0,297397,0.0177882,5537,291854,6,297398,7,1
II,+,302404,0.00163132,0.0,613,612,1,0,1,gene,K01A2.5,0,302413,1.51494,1450,300954,9,302404,0,-9
II,+,319806,0.0,0.0,419,419,0,0,289,gene,K01A2.2,0,319820,2.914,3993,315813,14,319792,-14,-28
II,+,337774,0.0,0.000244141,12,12,0,0,0,gene,D1069.2,0,337799,0.979141,9549,328225,25,337781,7,-18
II,+,337781,0.0,0.0,573,573,0,0,10,gene,D1069.2,0,337799,0.979141,9556,328225,18,337781,0,-18
II,+,340523,0.0,4.54747e-13,41,41,0,0,2,gene,D1069.1,0,340537,0.0493607,1270,339253,14,340538,15,1
II,+,386085,0.0,0.03125,5,5,0,0,0,gene,C03H5.3,1,386098,0.840929,3829,382256,13,386193,108,95
II,+,388832,0.348645,9.66953e-37,1698,1106,592,416,3,gene,C03H5.2,2,388840,1.58913,929,387903,8,388832,0,-8
II,+,411221,0.00110619,0.0,904,903,1,1,0,gene,C24H12.4,0,411230,1.31823,7006,404215,9,411221,0,-9
II,+,430139,0.0,0.25,2,2,0,0,0,gene,C24H12.3,0,430184,None,50,430089,45,430511,372,327
II,+,484865,0.00613497,0.0,978,972,6,6,0,gene,W07E6.4,0,484867,0.997491,7011,477854,2,484865,0,-2
II,+,522593,0.0,0.0,262,262,0,0,0,gene,T27A1.5,0,522610,0.554489,986,521607,17,522593,0,-17
II,+,522601,0.0,3.67342e-40,131,131,0,0,242,gene,T27A1.5,0,522610,0.554489,994,521607,9,522601,0,-9
II,+,523468,0.0,0.03125,5,5,0,0,0,gene,T27A1.5,0,523483,0.554489,1861,521607,15,523468,0,-15
II,+,553091,0.0,1.2326e-32,106,106,0,0,2,gene,C09E8.2,0,553099,0.24365,1065,552026,8,553093,2,-6
II,+,556483,0.0,0.0,192,192,0,0,0,gene,C09E8.1,0,556506,0.568536,1695,554788,23,556483,0,-23
II,+,580600,0.0089172,0.0,785,778,7,7,0,gene,W08F4.3,0,580618,2.75337,16427,564173,18,580600,0,-18
II,+,605577,0.0,2.29589e-41,135,135,0,0,0,gene,W04H10.2,0,605589,0.148389,11719,593858,12,605477,-100,-112
II,+,627519,0.00167785,0.0,596,595,1,1,7,gene,T04B8.3,0,627519,0.695458,12931,614588,0,627519,0,0
II,+,658675,0.0,0.0,874,874,0,0,9,gene,K07E8.3,0,658707,3.10589,1913,656762,32,658675,0,-32
II,+,658683,0.0,2.38419e-07,22,22,0,0,1208,gene,K07E8.3,0,658707,3.10589,1921,656762,24,658708,25,1
II,+,658764,0.5,0.5,2,1,1,1,162,gene,K07E8.3,0,658768,3.10589,2002,656762,4,658708,-56,-60
II,+,674428,0.0,0.5,1,1,0,0,0,gene,Y39F10C.1,0,674437,0.0186788,5964,668464,9,674438,10,1
II,+,677934,0.0,1.19209e-07,23,23,0,0,0,gene,Y39F10C.2,0,677973,None,2998,674936,39,678000,66,27
II,+,685046,0.0,0.015625,6,6,0,0,0,gene,T02H6.5,0,685239,0.0128552,924,684122,193,685240,194,1
II,+,702113,0.0,6.77626e-21,67,67,0,0,0,gene,T02H6.2,1,702120,0.363525,8657,693456,7,702121,8,1
II,+,709387,0.92029,1.6509e-26,138,11,127,77,0,gene,T02H6.1,2,709394,0.806337,101,709286,7,709387,0,-7
II,+,723901,0.69506,4.25757e-22,587,179,408,271,5,gene,Y39F10B.1,3,724001,1.1857,188,723713,100,723901,0,-100
II,+,770559,0.0,3.8147e-06,18,18,0,0,0,gene,C08G5.6,0,770598,0.0270796,35995,734564,39,770559,0,-39
II,+,775366,0.0222222,1.27898e-12,45,44,1,0,2,gene,Y39F10A.1,0,775372,0.129917,3244,772122,6,775373,7,1
II,+,868820,0.00265957,0.0,376,375,1,1,3,gene,Y46B2A.1,0,868836,1.44432,6544,862276,16,868820,0,-16
II,+,874166,0.0120968,0.0,248,245,3,2,1,gene,T07D3.7,0,874167,2.07605,2461,871705,1,874166,0,-1
II,+,888444,0.0,0.5,1,1,0,0,8,gene,T07D3.4,0,888457,0.231877,2229,886215,13,888311,-133,-146
II,+,888562,0.0,0.5,1,1,0,0,3,gene,T07D3.4,0,888630,0.231877,2347,886215,68,888311,-251,-319
II,+,904419,0.0,3.05176e-05,15,15,0,0,1,gene,T07D3.1,0,904430,0.0261168,888,903531,11,904452,33,22
II,+,913684,0.0,8.96831e-44,143,143,0,0,2,gene,R07C3.8,0,913690,0.154051,648,913036,6,913686,2,-4
II,+,923891,0.0,2.64698e-23,75,75,0,0,4,gene,R07C3.6,0,923893,0.263619,4468,919423,2,923894,3,1
II,+,1001709,0.0,3.05176e-05,15,15,0,0,0,gene,F45D11.5,0,1001731,0.0660445,3040,998669,22,1001741,32,10
II,+,1070618,0.0217391,6.53699e-13,46,45,1,1,11,gene,K02E7.12,0,1070669,0.0807514,3710,1066908,51,1070646,28,-23
II,+,1072340,0.0,0.5,1,1,0,0,1,gene,K02E7.4,0,1072411,0.00158747,844,1071496,71,1072412,72,1
II,+,1083165,0.0,3.46945e-18,58,58,0,0,0,gene,K02E7.1,0,1083176,0.108005,2052,1081113,11,1083177,12,1
II,+,1092012,0.00371747,0.0,269,268,1,0,0,gene,T13B5.1,0,1092015,1.11969,8000,1084012,3,1092012,0,-3
II,+,1123540,0.00328947,0.0,304,303,1,1,1,gene,W09B6.3,1,1123541,0.361191,25635,1097905,1,1123540,0,-1
II,+,1127982,0.777778,6.00539e-16,198,44,154,110,8,gene,W09B6.2,2,1127997,0.4236,189,1127793,15,1127982,0,-15
II,+,1143914,0.000853606,0.0,2343,2341,2,1,0,gene,W09B6.1,0,1143941,3.58602,11567,1132347,27,1143914,0,-27
II,+,1163598,0.00421941,0.0,474,472,2,0,1,gene,T23F4.2,0,1163612,0.49471,10871,1152727,14,1163613,15,1
II,+,1197380,0.0190476,1.34599e-28,105,103,2,1,1,gene,F53A10.2,0,1197386,0.786539,29623,1167757,6,1197380,0,-6
II,+,1224323,0.0,0.125,3,3,0,0,7,gene,F53A10.2,0,1224356,0.786539,56566,1167757,33,1224357,34,1
II,+,1224329,0.0,2.93874e-39,128,128,0,0,5,gene,F53A10.2,0,1224356,0.786539,56572,1167757,27,1224357,28,1
II,+,1262126,0.0,0.25,2,2,0,0,0,gene,F47F6.4,0,1262135,0.00322711,3745,1258381,9,1262136,10,1
II,+,1296059,0.0,0.03125,5,5,0,0,0,gene,Y57G7A.2,0,1296090,0.200064,652,1295407,31,1296084,25,-6
II,+,1296084,0.0,0.0,184,184,0,0,11,gene,Y57G7A.2,0,1296090,0.200064,677,1295407,6,1296084,0,-6
II,+,1298502,0.0,0.0,403,403,0,0,12,gene,Y57G7A.1,0,1298514,0.394015,1694,1296808,12,1298500,-2,-14
II,+,1310205,0.0,0.03125,5,5,0,0,1,gene,F56D12.6,0,1310267,0.708629,10485,1299720,62,1310541,336,274
II,+,1310523,0.0,0.0,330,330,0,0,0,gene,F56D12.6,0,1310585,0.708629,10803,1299720,62,1310541,18,-44
II,+,1321043,0.0354152,0.0,5732,5529,203,132,5,gene,F56D12.5,0,1321055,23.835,600,1320443,12,1321043,0,-12
II,+,1327001,0.0,1.16415e-10,33,33,0,0,2,gene,F56D12.4,0,1327006,0.289925,3786,1323215,5,1327001,0,-5
II,+,1337071,0.0,0.00195312,9,9,0,0,0,gene,F56D12.4,0,1337098,0.289925,13856,1323215,27,1337071,0,-27
II,+,1339692,0.0,9.31323e-10,30,30,0,0,0,gene,F56D12.4,0,1339704,0.289925,16477,1323215,12,1339692,0,-12
II,+,1386878,0.0,0.000488281,11,11,0,0,0,gene,F54D12.3,0,1386893,0.0239151,36743,1350135,15,1386894,16,1
II,+,1402577,0.00691776,0.0,1301,1292,9,9,1,gene,Y51H7C.7,1,1402604,0.750954,439,1402138,27,1402577,0,-27
II,+,1403327,0.94958,0.0,238,12,226,161,8,gene,Y51H7C.6,2,1403330,0.817967,2,1403325,3,1403327,0,-3
II,+,1412415,0.798077,4.63318e-19,208,42,166,101,2,gene,Y51H7C.5,0,1412436,0.748766,3288,1409127,21,1412415,0,-21
II,+,1438496,0.0171233,0.0,292,287,5,4,15,gene,Y51H7C.3,0,1438515,0.844469,18317,1420179,19,1438503,7,-12
II,+,1467733,0.0,1.92593e-34,112,112,0,0,0,gene,Y51H7C.1,0,1467752,0.726259,17357,1450376,19,1467733,0,-19
II,+,1504572,0.0016269,0.0,1844,1841,3,3,0,gene,H17B01.1,0,1504573,2.14772,32306,1472266,1,1504572,0,-1
II,+,1519227,0.0,0.0625,4,4,0,0,0,gene,Y51H7BR.8,0,1519243,0.0249814,9392,1509835,16,1519244,17,1
II,+,1529365,0.0,4.44089e-16,51,51,0,0,0,gene,Y51H7BR.5,0,1529391,0.0225081,9031,1520334,26,1529365,0,-26
II,+,1533519,0.0588235,0.0001297,17,16,1,1,0,gene,Y51H7BR.4,0,1533519,0.0932845,13185,1520334,0,1533520,1,1
II,+,1633804,0.0524017,0.0,229,217,12,12,0,gene,C08E3.1,0,1633808,0,1929,1631875,4,1633809,5,1
II,+,1710228,0.0,0.015625,6,6,0,0,0,gene,F45C12.8,0,1710240,0.00893532,1215,1709013,12,1710262,34,22
II,+,1713243,0.0,0.00012207,13,13,0,0,0,gene,F45C12.12,0,1713260,0.0262326,1523,1711720,17,1713261,18,1
II,+,1715306,0.00662252,5.32493e-44,151,150,1,1,30,gene,F45C12.7,0,1715322,0.420839,902,1714404,16,1715165,-141,-157
II,+,1722773,0.0,0.0,150,150,0,0,2,gene,F45C12.6,0,1722785,0.149874,6272,1716501,12,1722781,8,-4
II,+,1728518,0.0,0.5,1,1,0,0,2,gene,F45C12.4,0,1728538,0.172785,1407,1727111,20,1728576,58,38
II,+,1728562,0.0,0.125,3,3,0,0,118,gene,F45C12.4,0,1728575,0.172785,1451,1727111,13,1728576,14,1
II,+,1767807,0.028169,1.05244e-18,71,69,2,2,0,gene,F36H5.2,0,1767813,0.416277,1194,1766613,6,1767807,0,-6
II,+,1771650,0.0142857,5.92923e-20,70,69,1,1,0,gene,F36H5.1,0,1771656,0.223955,594,1771056,6,1771650,0,-6
II,+,1789045,0.0,3.72529e-09,28,28,0,0,6,gene,C08F1.3,0,1789183,0.0755659,10571,1778474,138,1789184,139,1
II,+,1824632,0.0166667,0.0,180,177,3,0,0,gene,T08E11.4,0,1824642,0.311512,1595,1823037,10,1824632,0,-10
II,+,1830642,0.0526316,3.62396e-05,19,18,1,0,2,gene,T08E11.3,0,1830649,0.0990739,541,1830101,7,1830650,8,1
II,+,1832348,0.0,2.77556e-17,55,55,0,0,0,gene,T08E11.2,0,1832355,0.12196,542,1831806,7,1832356,8,1
II,+,1836509,0.0,1.86265e-09,29,29,0,0,0,gene,T08E11.1,0,1836514,0.0515169,2988,1833521,5,1836515,6,1
II,+,1843586,0.0,0.000244141,12,12,0,0,0,gene,C52E2.4,0,1843591,0.093063,3292,1840294,5,1843586,0,-5
II,+,1864713,0.0,0.015625,6,6,0,0,8,gene,C16C4.17,0,1864716,0.408934,1084,1863629,3,1864734,21,18
II,+,1866390,0.0,4.65661e-10,31,31,0,0,1,gene,C16C4.5,0,1866393,0.0991495,1442,1864948,3,1866394,4,1
II,+,1869421,0.0,1.69407e-21,69,69,0,0,0,gene,C16C4.4,0,1869424,0.167513,1526,1867895,3,1869450,29,26
II,+,1869451,0.0,6.10352e-05,14,14,0,0,113,gene,C16C4.4,0,1869488,0.167513,1556,1867895,37,1869450,-1,-38
II,+,1900242,0.0,1.90735e-06,19,19,0,0,0,gene,C46F9.3,0,1900244,0.166676,2482,1897760,2,1900245,3,1
II,+,1905412,0.0,3.23117e-27,88,88,0,0,0,gene,C46F9.1,0,1905430,0.234656,964,1904448,18,1905431,19,1
II,+,1924761,0.5,0.209473,14,7,7,6,0,gene,F52C6.3,2,1924768,0.0494064,839,1923922,7,1924769,8,1
II,+,1926464,0.416667,0.193359,12,7,5,4,0,gene,F52C6.2,3,1926471,0.270378,746,1925718,7,1926472,8,1
II,+,1927866,0.0408163,2.089e-12,49,47,2,1,1,gene,F52C6.1,0,1927879,None,518,1927348,13,1927880,14,1
II,+,1994045,0.0,0.000244141,12,12,0,0,0,gene,C40D2.3,0,1994047,0.035549,1130,1992915,2,1994048,3,1
II,+,1996538,0.0,2.91038e-11,35,35,0,0,0,gene,C40D2.2,0,1996556,0.260777,866,1995672,18,1996538,0,-18
II,+,2017330,0.0,0.5,1,1,0,0,0,gene,F59H6.3,0,2017385,0.116194,3920,2013410,55,2017797,467,412
II,+,2104522,0.0,4.44089e-16,51,51,0,0,0,gene,R52.3,0,2104524,0.293743,364,2104158,2,2104525,3,1
II,+,2131071,0.0,0.0,384,384,0,0,2,gene,R52.1,0,2131085,0.333902,24129,2106942,14,2131081,10,-4
II,+,2146953,0.0,1.0842e-19,63,63,0,0,2,gene,C40A11.2,0,2146963,0.0796629,3999,2142954,10,2146964,11,1
II,+,2154009,0.0,1.42109e-14,46,46,0,0,0,gene,C40A11.1,0,2154012,0.149414,5220,2148789,3,2154013,4,1
II,+,2177738,0.0,0.5,1,1,0,0,0,gene,C33C12.3,0,2177758,0.600453,9583,2168155,20,2177738,0,-20
II,+,2208113,0.0,0.0,296,296,0,0,1,gene,Y59C2A.1,0,2208118,0.46619,26125,2181988,5,2208113,0,-5
II,+,2233541,0.00207996,0.0,4327,4318,9,8,1,gene,F54A3.3,1,2233546,2.40771,20732,2212809,5,2233541,0,-5
II,+,2243631,1.0,0.015625,6,0,6,6,0,gene,F54A3.2,2,2243655,0.282724,97,2243534,24,2243656,25,1
II,+,2243643,0.915254,8.6847e-12,59,5,54,40,9,gene,F54A3.2,2,2243655,0.282724,109,2243534,12,2243656,13,1
II,+,2243656,0.977778,1.27898e-12,45,1,44,38,131,gene,F54A3.2,2,2243663,0.282724,122,2243534,7,2243656,0,-7
II,+,2307042,0.0,1.97215e-31,102,102,0,0,0,gene,B0281.3,0,2307079,0.283839,16748,2290294,37,2307042,0,-37
II,+,2313286,0.0,0.25,2,2,0,0,0,gene,B0281.1,0,2313296,0.00634774,4903,2308383,10,2313068,-218,-228
II,+,2422208,0.0,0.000488281,11,11,0,0,1,gene,F42G2.2,0,2422213,0.173163,1413,2420795,5,2422208,0,-5
II,+,2443280,0.0,0.0,151,151,0,0,0,gene,T22D2.1,0,2443292,0.688414,17885,2425395,12,2443293,13,1
II,+,2481924,0.0,0.0078125,7,7,0,0,2,gene,F53G2.2,0,2481938,0.00593837,666,2481258,14,2481939,15,1
II,+,2504879,0.0,7.52316e-37,120,120,0,0,0,gene,F59H5.1,0,2504882,0.285036,8232,2496647,3,2504879,0,-3
II,+,2565276,0.00862069,0.0,232,230,2,2,7,gene,F09D1.1,0,2565276,0.620958,8962,2556314,0,2565276,0,0
II,+,2638395,0.0,0.0,300,300,0,0,1,gene,F22E5.9,0,2638402,0.440984,5324,2633071,7,2638323,-72,-79
II,+,2736680,0.0,3.38813e-21,68,68,0,0,0,gene,T05A8.8,0,2736686,0.0857144,2515,2734165,6,2736687,7,1
II,+,2787481,0.00383142,0.0,522,520,2,2,0,gene,F08D12.1,0,2787481,0.830634,4398,2783083,0,2787481,0,0
II,+,2808159,0.0,0.0078125,7,7,0,0,1,gene,K12H6.12,0,2808165,0.0932753,14215,2793944,6,2808166,7,1
II,+,2817064,0.0,7.70372e-34,110,110,0,0,0,gene,K12H6.11,0,2817067,0.0394291,4172,2812892,3,2816975,-89,-92
II,+,2839593,0.0,0.125,3,3,0,0,743,gene,Y110A2AL.4,0,2839622,4.28343,916,2838677,29,2839488,-105,-134
II,+,2919759,0.00761421,0.0,394,391,3,3,379,gene,Y110A2AR.1,0,2919776,1.09165,43026,2876733,17,2919712,-47,-64
II,+,2923914,0.0,0.0,167,167,0,0,2,gene,ZK355.2,0,2923932,0.673826,3089,2920825,18,2923914,0,-18
II,+,2927811,0.00134228,0.0,745,744,1,1,1,gene,ZK355.8,0,2927836,None,1282,2926529,25,2927837,26,1
II,+,2976634,0.0526316,3.62396e-05,19,18,1,1,1,gene,K08A2.5,0,2976861,1.42737,14756,2961878,227,2976634,0,-227
II,+,2978411,0.00517241,0.0,580,577,3,0,2,gene,K08A2.5,0,2978419,1.42737,16533,2961878,8,2978411,0,-8
II,+,2988302,0.0,1.57772e-30,99,99,0,0,1,gene,K08A2.4,0,2988306,0.436982,1284,2987018,4,2988302,0,-4
II,+,2997016,0.0052356,0.0,382,380,2,1,3,gene,K08A2.1,1,2997139,2.19552,2718,2994298,123,2997016,0,-123
II,+,2998681,0.0,0.0625,4,4,0,0,4,gene,K08A2.1,1,2998683,2.19552,4383,2994298,2,2998681,0,-2
II,+,3000842,0.234043,2.63584e-23,329,252,77,49,25,gene,C41H7.6,2,3000858,1.51453,194,3000648,16,3000820,-22,-38
II,+,3000848,0.653992,1.61045e-07,263,91,172,81,238,gene,C41H7.6,2,3000858,1.51453,200,3000648,10,3000820,-28,-38
II,+,3002508,0.870968,2.55522e-18,124,16,108,44,87,gene,C41H7.5,3,3002512,0.249924,105,3002403,4,3002513,5,1
II,+,3003964,0.871642,0.0,335,43,292,185,4,gene,C41H7.4,4,3003976,0.493693,106,3003858,12,3003977,13,1
II,+,3003972,0.903226,2.09315e-06,31,3,28,12,955,gene,C41H7.4,4,3003976,0.493693,114,3003858,4,3003977,5,1
II,+,3005841,0.24212,1.68156e-44,698,529,169,105,36,gene,C41H7.3,5,3005845,0.809039,256,3005585,4,3005841,0,-4
II,+,3014818,0.0,0.00012207,13,13,0,0,0,gene,C41H7.2,0,3014829,0,4877,3009941,11,3014830,12,1
II,+,3032775,0.0,2.64698e-23,75,75,0,0,1,gene,B0454.6,0,3032778,0.253897,15271,3017504,3,3032775,0,-3
II,+,3038854,0.00495049,0.0,202,201,1,1,0,gene,B0454.5,0,3038857,0.400761,2737,3036117,3,3038854,0,-3
II,+,3056819,0.00225734,0.0,886,884,2,2,2,gene,B0454.1,0,3056829,0.333017,4488,3052331,10,3056636,-183,-193
II,+,3061125,0.0,0.5,1,1,0,0,331,gene,Y25C1A.6,0,3061163,0.427613,884,3060241,38,3061106,-19,-57
II,+,3078791,0.000549451,0.0,1820,1819,1,1,0,gene,Y25C1A.5,0,3078800,2.10134,16684,3062107,9,3078791,0,-9
II,+,3112488,0.0,0.125,3,3,0,0,2,gene,Y25C1A.2,0,3112532,0.147844,9364,3103124,44,3112615,127,83
II,+,3119327,0.0,2.01948e-28,92,92,0,0,0,gene,T10D4.6,0,3119339,0.374164,877,3118450,12,3119326,-1,-13
II,+,3127119,0.0,0.25,2,2,0,0,837,gene,T10D4.4,0,3127209,2.15425,2004,3125115,90,3127036,-83,-173
II,+,3209626,0.0,6.10352e-05,14,14,0,0,18,gene,ZC239.6,0,3209658,0.246253,2243,3207383,32,3209626,0,-32
II,+,3209652,0.0,1.52588e-05,16,16,0,0,0,gene,ZC239.6,0,3209658,0.246253,2269,3207383,6,3209652,0,-6
II,+,3262802,0.0,0.0,1001,1001,0,0,2,gene,F02E11.2,0,3262824,0.0894703,11944,3250858,22,3262825,23,1
II,+,3350247,0.0,8.27181e-25,80,80,0,0,1,gene,F14D2.4,1,3350253,0.118815,8992,3341255,6,3350254,7,1
II,+,3359136,0.701754,0.000968992,57,17,40,33,0,gene,F14D2.2,2,3359140,0.0853431,162,3358974,4,3359141,5,1
II,+,3360202,0.0142857,6.98093e-39,140,138,2,2,1,gene,F14D2.1,3,3360215,0.0973051,391,3359811,13,3360216,14,1
II,+,3377093,0.0,1.2326e-32,106,106,0,0,0,gene,Y49F6C.3,0,3377111,0.476197,384,3376709,18,3377106,13,-5
II,+,3380276,0.0,0.5,1,1,0,0,0,gene,Y49F6C.1,0,3380282,None,729,3379547,6,3380283,7,1
II,+,3381831,0.00949367,0.0,316,313,3,3,6,gene,T06D4.1,0,3381866,0.327932,367,3381464,35,3381831,0,-35
II,+,3445757,0.0,1.54074e-33,109,109,0,0,1,gene,C16C8.16,1,3445764,0.204776,3264,3442493,7,3445760,3,-4
II,+,3449793,0.0,0.5,1,1,0,0,3,gene,C16C8.14,2,3449896,0.133843,983,3448810,103,3449793,0,-103
II,+,3450177,0.0,5.42101e-20,64,64,0,0,1,gene,C16C8.14,2,3450184,0.133843,1367,3448810,7,3450177,0,-7
II,+,3451408,0.416667,0.193359,12,7,5,4,0,gene,C16C8.13,3,3451415,0.0401461,353,3451055,7,3451416,8,1
II,+,3452521,1.0,0.000488281,11,0,11,11,0,gene,C16C8.12,4,3452675,0.12221,117,3452404,154,3452637,116,-38
II,+,3452718,0.0114943,5.62224e-25,87,86,1,1,2,gene,C16C8.12,4,3452725,0.12221,314,3452404,7,3452637,-81,-88
II,+,3453782,0.0,0.0625,4,4,0,0,2,gene,C16C8.11,5,3453859,0.245484,189,3453593,77,3453759,-23,-100
II,+,3453857,0.0,8.47033e-22,70,70,0,0,14,gene,C16C8.11,5,3453859,0.245484,264,3453593,2,3453759,-98,-100
II,+,3482480,0.0,3.05176e-05,15,15,0,0,692,gene,Y49F6B.4,0,3482507,0.845703,7756,3474724,27,3482431,-49,-76
II,+,3502963,0.00480192,0.0,833,829,4,4,40,gene,Y49F6B.2,1,3502968,0.546637,9894,3493069,5,3502963,0,-5
II,+,3505012,0.900262,0.0,381,38,343,257,3,gene,Y49F6B.1,2,3505013,0.375262,107,3504905,1,3505012,0,-1
II,+,3553690,0.0,0.000244141,12,12,0,0,0,gene,W10G11.20,0,3553736,1.32321,243,3553447,46,3553774,84,38
II,+,3603353,0.0,0.0625,4,4,0,0,4,gene,Y49F6A.1,0,3603380,0.00979747,5454,3597899,27,3603381,28,1
II,+,3610845,0.0,0.5,1,1,0,0,0,gene,F40E12.2,0,3610915,0.0259736,3467,3607378,70,3610403,-442,-512
II,+,3617805,0.0,3.05176e-05,15,15,0,0,0,gene,F40E12.1,0,3617805,0.0172999,2376,3615429,0,3617806,1,1
II,+,3622308,0.00392157,0.0,255,254,1,1,0,gene,M151.7,0,3622330,0.198906,3555,3618753,22,3622308,0,-22
II,+,3624169,1.0,0.0625,4,0,4,2,6,gene,M151.4,1,3624191,0.0104203,124,3624045,22,3624192,23,1
II,+,3627166,0.864865,3.17157e-06,37,5,32,21,0,gene,M151.3,2,3627191,0.0259092,204,3626962,25,3627192,26,1
II,+,3631106,1.0,0.0078125,7,0,7,7,1,gene,M151.2,0,3631128,0.00665916,252,3630854,22,3631438,332,310
II,+,3641491,0.0,0.015625,6,6,0,0,0,gene,M151.1,0,3641493,0.00473553,1242,3640249,2,3641494,3,1
II,+,3655672,0.0,4.33681e-19,61,61,0,0,1,gene,F19B10.5,0,3655691,0.043621,1402,3654270,19,3655692,20,1
II,+,3660069,0.0,1.81899e-12,39,39,0,0,0,gene,F19B10.4,0,3660077,0.0258729,1590,3658479,8,3660078,9,1
II,+,3662305,0.0,0.25,2,2,0,0,15,gene,F19B10.13,0,3662368,None,305,3662000,63,3662252,-53,-116
II,+,3664726,0.0,0.5,1,1,0,0,0,gene,F19B10.3,0,3664763,0.000117158,1748,3662978,37,3664764,38,1
II,+,3675720,0.0,1.90735e-06,19,19,0,0,142,gene,F19B10.2,0,3675788,0.28329,12742,3662978,68,3675618,-102,-170
II,+,3683175,0.0166667,0.0,180,177,3,3,0,gene,F19B10.1,0,3683183,0.556265,6448,3676727,8,3683171,-4,-12
II,+,3717255,0.00358423,0.0,279,278,1,0,160,gene,C46E10.4,0,3717260,0.531949,4213,3713042,5,3717132,-123,-128
II,+,3737301,0.0,0.015625,6,6,0,0,1,gene,F12E12.3,0,3737327,0.00304958,4117,3733184,26,3737328,27,1
II,+,3741878,0.00228484,0.0,1313,1310,3,3,0,gene,F12E12.1,0,3741900,1.03969,1047,3740831,22,3741878,0,-22
II,+,3753898,0.0,0.00195312,9,9,0,0,0,gene,T24E12.5,0,3753914,0.07698,11400,3742498,16,3753915,17,1
II,+,3785551,0.0,1.61559e-27,89,89,0,0,1,gene,T24E12.1,0,3785568,0.0566232,1401,3784150,17,3785569,18,1
II,+,3790506,0.0,0.125,3,3,0,0,5,gene,Y8A9A.4,0,3790720,0.000750684,1976,3788530,214,3790744,238,24
II,+,3795605,0.0,0.25,2,2,0,0,0,gene,Y8A9A.2,0,3795616,0.0178476,3509,3792096,11,3795617,12,1
II,+,3812279,0.0,6.93889e-18,57,57,0,0,0,gene,F54D10.3,0,3812289,0.271109,2622,3809657,10,3812299,20,10
II,+,3824141,0.0,0.0,826,826,0,0,0,gene,F54D10.1,0,3824147,0.680221,5911,3818230,6,3824140,-1,-7
II,+,3891386,0.0,5.96046e-08,24,24,0,0,0,gene,F53C3.8,0,3891416,0.00977721,1782,3889604,30,3891342,-44,-74
II,+,3898135,0.0,5.55112e-17,54,54,0,0,2,gene,F53C3.6,1,3898153,0.128726,1903,3896232,18,3898135,0,-18
II,+,3899814,0.871795,1.0473e-06,39,5,34,7,2,gene,F53C3.5,2,3899832,0.351147,112,3899702,18,3899856,42,24
II,+,3901392,1.0,0.25,2,0,2,0,5,gene,F53C3.4,3,3901419,0.142825,51,3901341,27,3901401,9,-18
II,+,3901401,0.869565,0.00021112,23,3,20,2,9,gene,F53C3.4,3,3901419,0.142825,60,3901341,18,3901401,0,-18
II,+,3902855,1.0,7.62939e-06,17,0,17,3,1,gene,F53C3.3,4,3902874,0.141484,92,3902763,19,3902860,5,-14
II,+,3934446,0.0,0.0,288,288,0,0,1,gene,Y14H12B.1,0,3934479,1.72501,21067,3913379,33,3934446,0,-33
II,+,3934455,0.01,0.0,400,396,4,4,410,gene,Y14H12B.1,0,3934479,1.72501,21076,3913379,24,3934480,25,1
II,+,3935286,0.0392157,0.0,204,196,8,6,0,gene,Y14H12B.1,0,3935324,1.72501,21907,3913379,38,3935325,39,1
II,+,3961307,0.0,0.5,1,1,0,0,1,gene,K10G6.3,0,3961361,1.11603,9953,3951354,54,3961683,376,322
II,+,3961683,0.0,0.0,423,423,0,0,0,gene,K10G6.3,0,3962136,1.11603,10329,3951354,453,3961683,0,-453
II,+,3982253,0.0,0.0625,4,4,0,0,1,gene,K10G6.1,0,3982272,0.0978416,4224,3978029,19,3982567,314,295
II,+,4004879,0.00520833,0.0,192,191,1,1,1,gene,K07D4.7,0,4004907,0.727057,11035,3993844,28,4004883,4,-24
II,+,4012444,0.0,0.00390625,8,8,0,0,4,gene,K07D4.7,0,4012514,0.727057,18600,3993844,70,4012444,0,-70
II,+,4028571,0.00153767,0.0,1951,1948,3,2,0,gene,K07D4.9,0,4028573,2.77723,12501,4016070,2,4028571,0,-2
II,+,4067552,0.0,1.26218e-29,96,96,0,0,0,gene,W06A11.1,0,4067617,0.284615,9796,4057756,65,4067552,0,-65
II,+,4083059,0.0,0.00012207,13,13,0,0,0,gene,R11F4.2,0,4083062,0.0793735,10124,4072935,3,4083059,0,-3
II,+,4091924,0.0,0.0,796,796,0,0,3,gene,R11F4.1,0,4092004,2.03043,5645,4086279,80,4091924,0,-80
II,+,4091990,0.0,0.03125,5,5,0,0,55,gene,R11F4.1,0,4092004,2.03043,5711,4086279,14,4091924,-66,-80
II,+,4109204,0.0,5.42101e-20,64,64,0,0,0,gene,T08H4.2,0,4109279,0.415487,14863,4094341,75,4109201,-3,-78
II,+,4120251,0.0,3.72529e-09,28,28,0,0,0,gene,T08H4.1,0,4120261,0.833151,25910,4094341,10,4120331,80,70
II,+,4146333,0.0,0.0,290,290,0,0,0,gene,F56D3.1,0,4146337,2.14117,18490,4127843,4,4146333,0,-4
II,+,4155744,0.0,0.25,2,2,0,0,0,gene,R03H10.2,0,4155768,1.05249,6072,4149672,24,4155766,22,-2
II,+,4155767,0.0,0.0,209,209,0,0,5,gene,R03H10.2,0,4155768,1.05249,6095,4149672,1,4155766,-1,-2
II,+,4180242,0.00434783,0.0,230,229,1,0,2,gene,R03H10.1,0,4180247,0.191048,12880,4167362,5,4180281,39,34
II,+,4186660,0.0,0.0,288,288,0,0,1,gene,F31D5.3,0,4186669,1.92703,3121,4183539,9,4186660,0,-9
II,+,4209670,0.0,3.72529e-09,28,28,0,0,5,gene,F31D5.6,0,4209679,0.0351779,1177,4208493,9,4209778,108,99
II,+,4209697,0.0,5.55112e-17,54,54,0,0,14,gene,F31D5.6,0,4209777,0.0351779,1204,4208493,80,4209778,81,1
II,+,4215612,0.0,8.27181e-25,80,80,0,0,1,gene,F31D5.2,0,4215639,0.226843,2169,4213443,27,4215612,0,-27
II,+,4219358,0.0,0.015625,6,6,0,0,2,gene,F31D5.1,0,4219372,0.0175668,1118,4218240,14,4219373,15,1
II,+,4223305,0.0,2.1684e-19,62,62,0,0,1,gene,C16A11.5,0,4223307,0.0820949,1548,4221757,2,4223308,3,1
II,+,4227040,0.017341,0.0,173,170,3,3,0,gene,C16A11.4,1,4227050,0.772037,717,4226323,10,4227040,0,-10
II,+,4229541,0.863636,1.26123e-18,132,18,114,87,0,gene,C16A11.3,2,4229544,0.142143,390,4229151,3,4229698,157,154
II,+,4231379,0.755556,4.30538e-07,90,22,68,64,3,gene,C16A11.10,3,4231454,None,577,4230802,75,4231379,0,-75
II,+,4238197,0.0047619,0.0,210,209,1,1,2,gene,C16A11.2,0,4238206,0.528398,3585,4234612,9,4238197,0,-9
II,+,4276197,0.0,1.19209e-07,23,23,0,0,3,gene,C01F1.4,0,4276206,0.112272,20913,4255284,9,4276207,10,1
II,+,4295094,0.00224215,0.0,446,445,1,1,0,gene,C01F1.3,0,4295094,1.05551,15825,4279269,0,4295094,0,0
II,+,4298306,0.0,0.015625,6,6,0,0,1,gene,C01F1.3,0,4298364,1.05551,19037,4279269,58,4298304,-2,-60
II,+,4299646,0.00803571,0.0,1120,1111,9,7,1,gene,C01F1.2,1,4299650,0.743732,488,4299158,4,4299651,5,1
II,+,4301600,0.766871,5.61361e-34,489,114,375,251,0,gene,C01F1.1,2,4301601,1.09397,506,4301094,1,4301600,0,-1
II,+,4320829,0.0264901,7.29081e-39,151,147,4,4,78,gene,Y52E8A.2,0,4320847,0.412008,15550,4305279,18,4320667,-162,-180
II,+,4323250,0.0030896,0.0,971,968,3,3,1,gene,H20J04.6,1,4323253,0.401904,640,4322610,3,4323254,4,1
II,+,4324355,0.885989,0.0,1456,166,1290,1015,3,gene,H20J04.8,2,4324360,1.75867,112,4324243,5,4324355,0,-5
II,+,4326714,0.844531,0.0,1280,199,1081,729,1,gene,H20J04.5,3,4326901,3.08141,572,4326142,187,4326714,0,-187
II,+,4329017,0.940171,2.98487e-25,117,7,110,78,0,gene,H20J04.4,4,4329025,0.216955,640,4328377,8,4329017,0,-8
II,+,4339762,0.0,0.125,3,3,0,0,0,gene,H20J04.2,6,4339779,0.438491,1059,4338703,17,4340146,384,367
II,+,4340177,0.708333,3.2927e-13,288,84,204,163,1,gene,H20J04.2,6,4340190,0.438491,1474,4338703,13,4340146,-31,-44
II,+,4351183,0.864078,6.78533e-15,103,14,89,68,0,gene,H20J04.9,7,4351192,0.271893,204,4350979,9,4351184,1,-8
II,+,4378652,0.00558659,0.0,179,178,1,1,0,gene,B0286.1,0,4378668,0.55541,9039,4369613,16,4378830,178,162
II,+,4405654,0.0,0.125,3,3,0,0,0,gene,ZK430.5,0,4405656,0.0549932,813,4404841,2,4405855,201,199
II,+,4405869,0.0,0.000244141,12,12,0,0,0,gene,ZK430.5,0,4405944,0.0549932,1028,4404841,75,4405855,-14,-89
II,+,4405899,0.0,0.000976562,10,10,0,0,17,gene,ZK430.5,0,4405944,0.0549932,1058,4404841,45,4405855,-44,-89
II,+,4420248,0.00151515,0.0,660,659,1,1,1,gene,ZK430.2,0,4420272,0.907685,1124,4419124,24,4420264,16,-8
II,+,4425160,0.00578035,0.0,346,344,2,2,0,gene,ZK430.1,0,4425201,0.880626,2850,4422310,41,4425202,42,1
II,+,4461121,0.00438596,0.0,228,227,1,1,2,gene,W06B4.3,1,4461121,0.311033,20260,4440861,0,4461122,1,1
II,+,4468160,0.829268,1.02236e-05,41,7,34,27,1,gene,W06B4.2,2,4468160,0.343475,274,4467886,0,4468161,1,1
II,+,4468220,0.666667,0.375,3,1,2,2,10,gene,W06B4.2,2,4468337,0.343475,334,4467886,117,4468161,-59,-176
II,+,4468235,1.0,0.125,3,0,3,1,17,gene,W06B4.2,2,4468337,0.343475,349,4467886,102,4468161,-74,-176
II,+,4478606,0.0,1.54074e-33,109,109,0,0,0,gene,T05C1.1,0,4478618,0.30509,5062,4473544,12,4478619,13,1
II,+,4512199,0.0,1.86265e-09,29,29,0,0,0,gene,B0304.3,0,4512207,0.127117,31261,4480938,8,4512199,0,-8
II,+,4519055,0.0,0.0,546,546,0,0,1,gene,B0304.1,0,4519056,0.440124,2934,4516121,1,4519057,2,1
II,+,4523610,0.00790514,0.0,253,251,2,1,2,gene,B0304.2,0,4523631,0.544935,1099,4522511,21,4523632,22,1
II,+,4551070,0.0,7.34684e-40,130,130,0,0,5,gene,K07E1.1,0,4551088,4.23188,26493,4524577,18,4550882,-188,-206
II,+,4551083,0.000973236,0.0,2055,2053,2,1,661,gene,K07E1.1,0,4551088,4.23188,26506,4524577,5,4550882,-201,-206
II,+,4557775,0.0,8.67362e-19,60,60,0,0,2,gene,M03A1.3,0,4557776,0.145822,5612,4552163,1,4557775,0,-1
II,+,4562938,0.00191239,0.0,10981,10960,21,15,40,gene,M03A1.7,0,4562938,15.3506,333,4562605,0,4562938,0,0
II,+,4571988,0.00283286,0.0,706,704,2,2,0,gene,M03A1.1,0,4572010,1.35339,8451,4563537,22,4571988,0,-22
II,+,4603415,0.00814332,0.0,614,609,5,3,175,gene,F35D11.4,0,4603421,0.805679,2637,4600778,6,4603415,0,-6
II,+,4608360,0.0,0.0,447,447,0,0,0,gene,F35D11.3,0,4608405,0.295453,4213,4604147,45,4608360,0,-45
II,+,4623813,0.0111111,7.27014e-26,90,89,1,0,2,gene,F35D11.2,0,4623830,1.00396,11774,4612039,17,4623813,0,-17
II,+,4649095,0.0,1.77636e-15,49,49,0,0,12,gene,Y74E4A.1,0,4649165,0.917077,21320,4627775,70,4649166,71,1
II,+,4673073,0.00246154,0.0,1625,1621,4,2,1,gene,T05A7.4,0,4673073,6.74648,1,4673072,0,4673073,0,0
II,+,4674580,0.0,0.5,1,1,0,0,6,gene,T05A7.2,0,4674623,0.0289667,846,4673734,43,4674461,-119,-162
II,+,4693530,0.0,0.0,215,215,0,0,17,gene,F10G7.5,0,4693536,0.643846,469,4693061,6,4693530,0,-6
II,+,4698709,0.00460829,0.0,434,432,2,2,0,gene,F10G7.4,0,4698715,0.76754,2321,4696388,6,4698709,0,-6
II,+,4702057,0.010352,0.0,483,478,5,3,1,gene,F10G7.3,0,4702107,1.708,1079,4700978,50,4702057,0,-50
II,+,4706809,0.00373289,0.0,2411,2402,9,7,0,gene,F10G7.2,1,4706831,4.3301,3581,4703228,22,4706809,0,-22
II,+,4710282,0.962415,0.0,878,33,845,459,16,gene,F10G7.1,2,4710538,2.17534,127,4710155,256,4710282,0,-256
II,+,4716034,0.0,2.86986e-42,138,138,0,0,8,gene,F41C3.8,0,4716034,0.248699,2357,4713677,0,4716035,1,1
II,+,4716692,0.0,1.35525e-20,66,66,0,0,3,gene,F41C3.8,0,4716709,0.248699,3015,4713677,17,4716692,0,-17
II,+,4737635,0.00654775,0.0,4429,4400,29,21,133,gene,F41C3.5,0,4737636,8.18744,797,4736838,1,4737635,0,-1
II,+,4740382,0.0,0.5,1,1,0,0,0,gene,F41C3.4,1,4740433,1.12425,475,4739907,51,4740434,52,1
II,+,4740399,0.00438596,0.0,456,454,2,1,2,gene,F41C3.4,1,4740433,1.12425,492,4739907,34,4740434,35,1
II,+,4741581,1.0,0.25,2,0,2,2,1,gene,F41C3.3,2,4741672,1.30512,15,4741566,91,4742115,534,443
II,+,4742115,0.69697,0.0107755,33,10,23,17,2,gene,F41C3.3,2,4742125,1.30512,549,4741566,10,4742115,0,-10
II,+,4742124,0.290625,2.53349e-27,640,454,186,134,71,gene,F41C3.3,2,4742125,1.30512,558,4741566,1,4742124,0,-1
II,+,4749955,0.0,0.0,187,187,0,0,0,gene,F41C3.2,0,4749964,0.718806,4689,4745266,9,4749955,0,-9
II,+,4752318,0.0,1.52588e-05,16,16,0,0,22,gene,F41C3.1,0,4752325,0.093522,509,4751809,7,4752375,57,50
II,+,4753432,0.0116618,0.0,343,339,4,4,136,gene,C27D9.1,0,4753442,0.381899,458,4752974,10,4753443,11,1
II,+,4763184,0.0,0.0,307,307,0,0,13,gene,F26G1.2,0,4763204,0.830153,3630,4759554,20,4763205,21,1
II,+,4774461,0.0,0.00390625,8,8,0,0,6,gene,F26G1.10,0,4774504,0.111791,10297,4764164,43,4774373,-88,-131
II,+,4774471,0.0,0.03125,5,5,0,0,26,gene,F26G1.10,0,4774504,0.111791,10307,4764164,33,4774373,-98,-131
II,+,4790287,0.0,1.45519e-11,36,36,0,0,2,gene,F26G1.1,1,4790303,0.4766,12193,4778094,16,4790304,17,1
II,+,4795749,0.925764,2.38221e-44,229,17,212,168,2,gene,C33F10.4,2,4795752,1.17648,96,4795653,3,4795749,0,-3
II,+,4797359,0.676471,2.45738e-14,442,143,299,217,0,gene,C33F10.14,3,4797362,None,155,4797204,3,4797362,3,0
II,+,4828547,0.0,2.27374e-13,42,42,0,0,0,gene,C33F10.2,0,4828547,0.15561,2762,4825785,0,4828548,1,1
II,+,4850179,0.0181818,1.52656e-15,55,54,1,0,2,gene,T23B7.3,0,4850199,0.269926,7135,4843044,20,4850200,21,1
II,+,4851536,0.0,0.125,3,3,0,0,3,gene,F11G11.7,1,4851547,0.682521,25,4851511,11,4852044,508,497
II,+,4852044,0.0,0.0,473,473,0,0,1,gene,F11G11.7,1,4852044,0.682521,451,4851593,0,4852044,0,0
II,+,4857911,0.545198,0.000318849,1062,483,579,387,6,gene,F11G11.5,2,4857920,2.759,121,4857790,9,4857911,0,-9
II,+,4857919,0.333333,0.375,3,2,1,1,1971,gene,F11G11.5,2,4857920,2.759,129,4857790,1,4857911,-8,-9
II,+,4861039,1.0,0.5,1,0,1,1,0,gene,F11G11.4,0,4861062,0.215369,1900,4859139,23,4861039,0,-23
II,+,4879887,0.0,0.00012207,13,13,0,0,121,gene,F11G11.3,0,4879902,1.11633,4818,4875069,15,4879872,-15,-30
II,+,4889424,0.00618375,0.0,1132,1125,7,6,10,gene,R05F9.6,0,4889429,2.59518,1226,4888198,5,4889424,0,-5
II,+,4904995,0.0,0.0,515,515,0,0,1,gene,R05F9.1,0,4905045,1.96928,5820,4899175,50,4905046,51,1
II,+,4908795,0.0,0.0,342,342,0,0,0,gene,R05F9.1,0,4909003,1.96928,2569,4906226,208,4908795,0,-208
II,+,4909319,0.0,0.5,1,1,0,0,0,gene,R05F9.1,0,4909530,1.96928,3093,4906226,211,4909319,0,-211
II,+,4946013,0.00489237,0.0,1022,1017,5,5,2,gene,ZK546.2,0,4946058,1.18326,3617,4942396,45,4946013,0,-45
II,+,4949888,0.51601,0.018469,812,393,419,302,1,gene,ZK546.1,1,4949896,1.00648,258,4949630,8,4949888,0,-8
II,+,4953575,0.867816,1.20314e-24,174,23,151,83,1,gene,Y38A8.1,2,4953580,0.4869,101,4953474,5,4953774,199,194
II,+,4969155,0.0208333,1.7053e-13,48,47,1,1,0,gene,T27F7.2,0,4969269,0.759069,14690,4954465,114,4969188,33,-81
II,+,4972841,0.0,0.5,1,1,0,0,2,gene,T27F7.2,0,4972841,0.759069,18376,4954465,0,4972841,0,0
II,+,4983465,0.0,2.22045e-16,52,52,0,0,0,gene,T27F7.2,0,4983590,0.759069,29000,4954465,125,4983465,0,-125
II,+,4994203,0.0127389,0.0,314,310,4,3,1,gene,T27F7.1,1,4994205,2.08418,3383,4990820,2,4994203,0,-2
II,+,4995640,0.0,0.0,208,208,0,0,12,gene,F59A6.6,2,4995649,0.716785,48,4995592,9,4995650,10,1
II,+,4995649,0.0,1.45519e-11,36,36,0,0,196,gene,F59A6.6,2,4995649,0.716785,57,4995592,0,4995650,1,1
II,+,4996383,0.954861,0.0,288,13,275,208,2,gene,F59A6.6,2,4996423,0.716785,93,4996290,40,4996383,0,-40
II,+,4999508,0.0165485,0.0,423,416,7,7,5,gene,F59A6.5,0,4999509,0.785014,1490,4998018,1,4999510,2,1
II,+,5022748,0.0020284,0.0,493,492,1,1,2,gene,F59A6.1,0,5022788,0.985359,7439,5015309,40,5022748,0,-40
II,+,5049900,0.0171429,0.0,175,172,3,2,0,gene,F33G12.6,0,5049906,0.842866,19916,5029984,6,5049900,0,-6
II,+,5055601,0.00864071,0.0,34025,33731,294,204,5,gene,C27A2.2,0,5055606,97.8381,1650,5053951,5,5055601,0,-5
II,+,5062116,0.012605,0.0,238,235,3,3,2,gene,C27A2.1,0,5062121,0.778648,5629,5056487,5,5062122,6,1
II,+,5104101,0.0,5.16988e-26,84,84,0,0,0,gene,C04G6.1,0,5104196,0.288726,1471,5102630,95,5104101,0,-95
II,+,5104505,0.0,0.125,3,3,0,0,13,gene,C04G6.1,0,5104585,0.288726,1875,5102630,80,5104623,118,38
II,+,5104623,0.0,0.000976562,10,10,0,0,0,gene,C04G6.1,0,5104628,0.288726,1993,5102630,5,5104623,0,-5
II,+,5130367,0.0,4.54747e-13,41,41,0,0,0,gene,F09C12.1,0,5130367,0.065443,12057,5118310,0,5130368,1,1
II,+,5136849,0.0,0.03125,5,5,0,0,4,gene,F58A6.2,0,5136855,0.0976374,3392,5133457,6,5136856,7,1
II,+,5142902,0.00137174,0.0,729,728,1,1,5,gene,F58A6.1,0,5142910,0.543494,4270,5138632,8,5142902,0,-8
II,+,5203303,0.00114745,0.0,1743,1741,2,1,1,gene,C34F11.3,0,5203307,2.49891,3142,5200161,4,5203303,0,-4
II,+,5229543,0.0,0.03125,5,5,0,0,30,gene,EGAP2.2,0,5229599,0.00149521,15631,5213912,56,5230058,515,459
II,+,5229973,0.0,0.03125,5,5,0,0,69,gene,EGAP2.2,0,5229983,0.00149521,16061,5213912,10,5230058,85,75
II,+,5231401,0.0116959,0.0,171,169,2,2,3,gene,EGAP2.1,0,5231408,0.300422,1109,5230292,7,5231401,0,-7
II,+,5289413,0.0,1.97215e-31,102,102,0,0,0,gene,ZK622.5,0,5289413,0.136323,511,5288902,0,5289414,1,1
II,+,5292673,0.008,2.93874e-36,125,124,1,1,1,gene,ZK622.4,0,5292679,0.592825,2390,5290283,6,5292673,0,-6
II,+,5293906,0.0,0.5,1,1,0,0,0,gene,ZK622.1,0,5293924,0.0963486,631,5293275,18,5293906,0,-18
II,+,5312017,0.00909091,8.47409e-32,110,109,1,0,0,gene,F08B1.2,0,5312078,0.323239,16418,5295599,61,5312091,74,13
II,+,5322978,0.00581395,0.0,172,171,1,1,48,gene,F08B1.1,0,5322998,2.65221,3842,5319136,20,5322978,0,-20
II,+,5331457,0.00617284,0.0,162,161,1,1,0,gene,F08B1.1,0,5331459,2.65221,12321,5319136,2,5331457,0,-2
II,+,5334499,0.0,1.19209e-07,23,23,0,0,0,gene,F08B1.1,0,5334528,2.65221,15363,5319136,29,5334499,0,-29
II,+,5338000,0.0666667,4.05125e-07,30,28,2,2,8,gene,F08B1.1,0,5338033,2.65221,18864,5319136,33,5338143,143,110
II,+,5338143,0.0,0.0,330,330,0,0,1,gene,F08B1.1,0,5338198,2.65221,19007,5319136,55,5338143,0,-55
II,+,5350640,0.0218579,0.0,183,179,4,2,9,gene,F09E5.8,1,5350646,1.01313,3258,5347382,6,5350640,0,-6
II,+,5352058,0.956522,1.47082e-11,46,2,44,35,11,gene,F09E5.7,2,5352079,1.27977,94,5351964,21,5352056,-2,-23
II,+,5352070,0.92674,0.0,546,40,506,327,135,gene,F09E5.7,2,5352079,1.27977,106,5351964,9,5352070,0,-9
II,+,5355657,0.0,0.03125,5,5,0,0,2,gene,F09E5.4,0,5355682,0.00718732,1989,5353668,25,5355683,26,1
II,+,5358666,0.0118168,0.0,677,669,8,5,1,gene,F09E5.17,1,5358720,1.30861,1335,5357331,54,5358666,0,-54
II,+,5358672,0.0,0.5,1,1,0,0,278,gene,F09E5.17,1,5358720,1.30861,1341,5357331,48,5358666,-6,-54
II,+,5359523,0.909091,0.00537109,11,1,10,10,0,gene,F09E5.5,2,5359531,0.70828,83,5359440,8,5359531,8,0
II,+,5359531,0.961644,0.0,365,14,351,253,24,gene,F09E5.5,2,5359531,0.70828,91,5359440,0,5359531,0,0
II,+,5373968,0.216377,0.0,2015,1579,436,280,8,gene,F09E5.3,1,5373974,3.00647,1764,5372204,6,5373968,0,-6
II,+,5375238,0.93865,0.0,326,20,306,210,1,gene,F09E5.2,2,5375238,0.759079,100,5375138,0,5375238,0,0
II,+,5375267,1.0,0.25,2,0,2,1,675,gene,F09E5.2,2,5375302,0.759079,129,5375138,35,5375238,-29,-64
II,+,5377806,0.0,0.5,1,1,0,0,7,gene,F09E5.15,3,5378017,40.3294,718,5377088,211,5378034,228,17
II,+,5378385,0.0,0.03125,5,5,0,0,3,gene,F09E5.15,3,5378393,40.3294,1297,5377088,8,5378034,-351,-359
II,+,5378813,0.0276157,0.0,23139,22500,639,425,20,gene,F09E5.15,3,5378870,40.3294,1725,5377088,57,5378813,0,-57
II,+,5379998,0.471243,0.0141023,539,285,254,182,1,gene,F09E5.1,4,5379998,1.08022,398,5379600,0,5379998,0,0
II,+,5399509,0.00588235,0.0,170,169,1,1,0,gene,EEED8.5,0,5399509,0.778553,15358,5384151,0,5399510,1,1
II,+,5410438,0.0,0.0,810,810,0,0,6,gene,EEED8.4,0,5410453,0.225887,1820,5408618,15,5410438,0,-15
II,+,5416685,0.0,1.2326e-32,106,106,0,0,0,gene,EEED8.2,0,5416706,0.705475,1347,5415338,21,5416685,0,-21
II,+,5419206,0.0,0.0,453,453,0,0,1,gene,EEED8.15,0,5419244,0.642938,789,5418417,38,5419219,13,-25
II,+,5421227,0.0833333,1.64509e-05,24,22,2,2,7,gene,EEED8.1,0,5421249,1.28181,163,5421064,22,5421248,21,-1
II,+,5421233,0.0,0.0625,4,4,0,0,29,gene,EEED8.1,0,5421249,1.28181,169,5421064,16,5421248,15,-1
II,+,5421248,0.00458716,0.0,218,217,1,1,296,gene,EEED8.1,0,5421249,1.28181,184,5421064,1,5421248,0,-1
II,+,5421261,0.0,0.125,3,3,0,0,1345,gene,EEED8.1,0,5421322,1.28181,197,5421064,61,5421248,-13,-74
II,+,5447652,0.0,1.65436e-24,79,79,0,0,0,gene,F56D1.6,0,5447653,0.687182,7425,5440227,1,5447654,2,1
II,+,5453818,0.0,0.0,282,282,0,0,1,gene,F56D1.5,0,5453949,0.896571,5180,5448638,131,5453818,0,-131
II,+,5456276,0.0125733,0.0,1193,1178,15,15,1,gene,F56D1.7,0,5456301,1.86095,328,5455948,25,5456276,0,-25
II,+,5466336,0.0,0.0,276,276,0,0,28,gene,F56D1.4,1,5466408,0.9544,7754,5458582,72,5466445,109,37
II,+,5466365,0.0,0.25,2,2,0,0,146,gene,F56D1.4,1,5466408,0.9544,7783,5458582,43,5466445,80,37
II,+,5474283,0.0188679,5.88418e-15,53,52,1,1,1,gene,F56D1.3,2,5474355,1.29281,512,5473771,72,5474344,61,-11
II,+,5474344,0.0194175,0.0,309,303,6,6,20,gene,F56D1.3,2,5474355,1.29281,573,5473771,11,5474344,0,-11
II,+,5475223,0.0,0.5,1,1,0,0,1,gene,F56D1.2,3,5475369,0.705726,231,5474992,146,5475223,0,-146
II,+,5475489,0.956522,2.74181e-06,23,1,22,16,136,gene,F56D1.2,3,5475503,0.705726,98,5475391,14,5475223,-266,-280
II,+,5478591,0.944681,0.0,235,13,222,169,5,gene,F56D1.1,4,5478636,0.75985,98,5478493,45,5478549,-42,-87
II,+,5501604,0.000875657,0.0,3426,3423,3,3,2,gene,ZK177.6,1,5501622,1.88308,2462,5499142,18,5501604,0,-18
II,+,5501607,0.047619,1.00136e-05,21,20,1,1,25,gene,ZK177.6,1,5501622,1.88308,2465,5499142,15,5501604,-3,-18
II,+,5503741,1.0,0.25,2,0,2,1,195,gene,ZK177.5,2,5503756,0.36322,122,5503619,15,5503937,196,181
II,+,5504015,0.764706,2.03482e-09,119,28,91,83,41,gene,ZK177.5,2,5504017,0.36322,140,5503875,2,5504015,0,-2
II,+,5506211,0.314815,1.50084e-08,216,148,68,52,2,gene,ZK177.4,3,5506212,0.552392,101,5506110,1,5506211,0,-1
II,+,5535211,0.0,0.5,1,1,0,0,1,gene,C17C3.7,0,5535234,0.00230258,5603,5529608,23,5535211,0,-23
II,+,5554588,0.0123457,3.35008e-23,81,80,1,1,0,gene,C17C3.19,0,5554599,0.101355,2282,5552306,11,5554588,0,-11
II,+,5561717,0.0,1.38778e-17,56,56,0,0,0,gene,C17C3.3,0,5561733,0.0755825,4574,5557143,16,5561734,17,1
II,+,5561720,0.0,0.125,3,3,0,0,1,gene,C17C3.3,0,5561733,0.0755825,4577,5557143,13,5561734,14,1
II,+,5572402,0.0,0.000976562,10,10,0,0,215,gene,C17C3.1,0,5572508,1.01923,62,5572340,106,5572300,-102,-208
II,+,5586149,0.00236887,0.0,2955,2948,7,7,88,gene,C17G10.5,0,5586149,10.1235,1429,5584720,0,5586149,0,0
II,+,5594684,0.00327869,0.0,305,304,1,1,1,gene,C17G10.2,1,5594684,0.528595,7062,5587622,0,5594706,22,22
II,+,5596517,1.0,0.03125,5,0,5,4,0,gene,C17G10.1,2,5596540,0.656199,88,5596429,23,5596517,0,-23
II,+,5596530,0.948718,0.0,273,14,259,197,9,gene,C17G10.1,2,5596540,0.656199,101,5596429,10,5596530,0,-10
II,+,5596539,0.888889,0.0175781,9,1,8,8,955,gene,C17G10.1,2,5596540,0.656199,110,5596429,1,5596530,-9,-10
II,+,5622865,0.0,1.90735e-06,19,19,0,0,2,gene,F59E12.5,0,5622866,0.67701,22745,5600120,1,5622865,0,-1
II,+,5631327,0.0,2.38419e-07,22,22,0,0,0,gene,F59E12.4,0,5631328,0.0328976,6463,5624864,1,5631327,0,-1
II,+,5649718,0.010101,1.56194e-28,99,98,1,1,125,gene,F59E12.2,1,5649738,0.470896,9946,5639772,20,5649718,0,-20
II,+,5654485,0.918004,0.0,561,46,515,426,0,gene,F59E12.1,2,5654518,1.05359,93,5654392,33,5654485,0,-33
II,+,5691690,0.00724638,3.96041e-40,138,137,1,1,0,gene,C25H3.4,1,5691693,0.506005,9054,5682636,3,5691690,0,-3
II,+,5691721,0.0,0.5,1,1,0,0,44,gene,C25H3.4,1,5691837,0.506005,9085,5682636,116,5691690,-31,-147
II,+,5694164,0.777778,6.22916e-27,351,78,273,199,1,gene,C25H3.3,2,5694174,0.714893,261,5693903,10,5694162,-2,-12
II,+,5695352,0.79927,0.0,548,110,438,313,1,gene,C25H3.14,3,5695362,0.807352,146,5695206,10,5695352,0,-10
II,+,5707659,0.0,0.0,497,497,0,0,2,gene,C18A3.4,0,5707681,1.21507,6267,5701392,22,5707659,0,-22
II,+,5710022,0.0,6.16298e-33,107,107,0,0,15,gene,C18A3.4,0,5710090,1.21507,8630,5701392,68,5710022,0,-68
II,+,5716274,0.97416,0.0,387,10,377,251,2,gene,C18A3.3,2,5716285,1.27737,101,5716173,11,5716274,0,-11
II,+,5718098,0.960674,2.60221e-42,178,7,171,121,42,gene,C18A3.2,3,5718100,0.836776,96,5718002,2,5718112,14,12
II,+,5720100,1.0,0.5,1,0,1,1,0,gene,C18A3.1,4,5720102,0.211613,81,5720019,2,5720130,30,28
II,+,5720115,0.988372,1.11152e-24,86,1,85,65,0,gene,C18A3.1,4,5720129,0.211613,96,5720019,14,5720130,15,1
II,+,5750156,0.000959079,0.0,3128,3125,3,3,4,gene,F10C1.7,1,5750165,7.41961,18297,5731859,9,5750156,0,-9
II,+,5754384,0.916667,0.00292969,12,1,11,5,0,gene,F10C1.8,2,5754394,0.33806,280,5754104,10,5754434,50,40
II,+,5754434,0.897143,3.12657e-29,175,18,157,94,4,gene,F10C1.8,2,5754445,0.33806,330,5754104,11,5754434,0,-11
II,+,5765584,0.00831354,0.0,842,835,7,6,3,gene,F10C1.2,0,5765607,5.01472,8932,5756652,23,5765584,0,-23
II,+,5768911,0.00227618,0.0,1318,1315,3,1,10,gene,F10C1.2,0,5768926,5.01472,3006,5765905,15,5768911,0,-15
II,+,5768925,0.0,6.10352e-05,14,14,0,0,2199,gene,F10C1.2,0,5768926,5.01472,3020,5765905,1,5768911,-14,-15
II,+,5782492,0.00865801,0.0,231,229,2,2,0,gene,K05F1.6,0,5782544,0.250801,8106,5774386,52,5782914,422,370
II,+,5820677,0.0,0.0,280,280,0,0,0,gene,ZK1248.3,0,5820684,0.887269,1881,5818796,7,5820677,0,-7
II,+,5846600,0.0,1.49012e-08,26,26,0,0,4,gene,H41C03.3,0,5846723,0.17529,2021,5844579,123,5846600,0,-123
II,+,5847713,0.0,0.00390625,8,8,0,0,0,gene,H41C03.3,0,5847777,0.17529,3134,5844579,64,5847713,0,-64
II,+,5854457,0.0,0.0,432,432,0,0,31,gene,H41C03.1,0,5854516,0.512332,4202,5850255,59,5854389,-68,-127
II,+,5884516,0.00307692,0.0,325,324,1,1,1,gene,F55C12.1,0,5884594,1.70321,7101,5877415,78,5884516,0,-78
II,+,5890451,0.0,2.01948e-28,92,92,0,0,0,gene,F55C12.1,0,5890459,1.70321,3814,5886637,8,5890451,0,-8
II,+,5896134,0.0,1.77636e-15,49,49,0,0,0,gene,F59G1.4,1,5896137,0.0803246,3499,5892635,3,5896134,0,-3
II,+,5906534,0.0,0.0,296,296,0,0,10,gene,F59G1.8,3,5906555,0.422139,184,5906350,21,5906556,22,1
II,+,5907780,0.607843,0.000478464,204,80,124,104,1,gene,F59G1.3,4,5907783,0.841315,203,5907577,3,5907780,0,-3
II,+,5911288,0.948276,0.0,464,24,440,352,2,gene,F59G1.1,5,5911291,2.04619,104,5911184,3,5911288,0,-3
II,+,5912521,0.00460299,0.0,869,865,4,3,66,gene,F59G1.1,5,5912567,2.04619,1337,5911184,46,5912521,0,-46
II,+,5915018,0.0,0.0,169,169,0,0,5,gene,F59G1.1,5,5915187,2.04619,2039,5912979,169,5915018,0,-169
II,+,5917386,0.810945,4.7049e-20,201,38,163,107,47,gene,F59G1.7,6,5917452,0.435302,512,5916874,66,5917386,0,-66
II,+,5918611,0.0231959,0.0,388,379,9,8,0,gene,F59G1.5,7,5918675,0.908582,329,5918282,64,5918611,0,-64
II,+,5921931,0.6,0.000124683,295,118,177,133,0,gene,F28B12.3,8,5921935,0.966788,350,5921581,4,5921935,4,0
II,+,5921935,0.263158,0.0017198,38,28,10,6,7,gene,F28B12.3,8,5921935,0.966788,354,5921581,0,5921935,0,0
II,+,5936404,0.0,0.0,362,362,0,0,0,gene,F28B12.2,0,5936443,1.07587,11602,5924802,39,5936404,0,-39
II,+,5937016,0.0,0.00195312,9,9,0,0,2,gene,F28B12.2,0,5937057,1.07587,12214,5924802,41,5937016,0,-41
II,+,5938500,0.0,0.00195312,9,9,0,0,0,gene,F28B12.2,0,5938536,1.07587,13698,5924802,36,5938500,0,-36
II,+,5940827,0.666667,0.164062,9,3,6,4,1,gene,F28B12.1,0,5940896,0.13723,50,5940777,69,5940897,70,1
II,+,5942928,0.0185185,2.9976e-15,54,53,1,0,16,gene,F28B12.1,0,5942949,0.13723,1307,5941621,21,5942950,22,1
II,+,5961640,0.0,1.13687e-13,43,43,0,0,9,gene,B0034.7,0,5961677,0.154513,17689,5943951,37,5961678,38,1
II,+,5961651,0.0,0.000976562,10,10,0,0,113,gene,B0034.7,0,5961677,0.154513,17700,5943951,26,5961678,27,1
II,+,5970064,0.0,0.0,169,169,0,0,1,gene,B0034.1,0,5970071,0.255335,8036,5962028,7,5970072,8,1
II,+,5988618,0.0,0.5,1,1,0,0,37,gene,ZK75.2,0,5988666,0.307391,16004,5972614,48,5988497,-121,-169
II,+,5996331,0.0,3.55271e-15,48,48,0,0,4,gene,ZK75.1,0,5996354,0.145406,6977,5989354,23,5996355,24,1
II,+,5998380,0.0,0.5,1,1,0,0,4,gene,ZK84.3,0,5998442,0.217044,1414,5996966,62,5998402,22,-40
II,+,5998411,0.02,3.90486e-27,100,98,2,2,32,gene,ZK84.3,0,5998442,0.217044,1445,5996966,31,5998402,-9,-40
II,+,6020611,0.0,0.0,193,193,0,0,2,gene,ZK84.1,0,6020611,1.90145,4728,6015883,0,6020611,0,0
II,+,6048066,0.0124481,0.0,1205,1190,15,14,0,gene,R12C12.2,0,6048067,1.20569,24709,6023357,1,6048066,0,-1
II,+,6050377,0.00133511,0.0,749,748,1,0,49,gene,R12C12.1,0,6050396,1.4791,734,6049643,19,6050377,0,-19
II,+,6077891,0.04,1.08802e-12,50,48,2,2,0,gene,H12I13.6,0,6078062,0.32052,23627,6054264,171,6077860,-31,-202
II,+,6097786,0.00407166,0.0,1228,1223,5,4,0,gene,F21H12.1,0,6097787,0.61967,5075,6092711,1,6097786,0,-1
II,+,6100017,0.0,0.5,1,1,0,0,2,gene,C29H12.3,0,6100020,0.262723,399,6099618,3,6100017,0,-3
II,+,6103558,0.0,0.0078125,7,7,0,0,2,gene,C29H12.3,0,6103821,0.262723,3940,6099618,263,6103480,-78,-341
II,+,6106013,0.0,0.5,1,1,0,0,1,gene,C29H12.3,0,6106068,0.262723,6395,6099618,55,6106013,0,-55
II,+,6108646,0.0,2.77556e-17,55,55,0,0,8,gene,C29H12.3,0,6108654,0.262723,9028,6099618,8,6108655,9,1
II,+,6123764,0.00897227,0.0,1226,1215,11,10,4,gene,C29H12.2,1,6123774,3.39039,13681,6110083,10,6123764,0,-10
II,+,6123770,0.0127042,0.0,551,544,7,6,60,gene,C29H12.2,1,6123774,3.39039,13687,6110083,4,6123770,0,-4
II,+,6125514,0.912214,0.0,262,23,239,168,39,gene,C29H12.1,2,6125630,0.518083,127,6125387,116,6125514,0,-116
II,+,6136049,0.0,8.88178e-16,50,50,0,0,1,gene,F57F10.1,0,6136050,0.496067,2456,6133593,1,6136049,0,-1
II,+,6147088,0.00330033,0.0,303,302,1,0,0,gene,F57F10.1,0,6147106,0.496067,13495,6133593,18,6147088,0,-18
II,+,6171552,0.0,6.10352e-05,14,14,0,0,50,gene,F40H3.3,0,6171605,0.116583,14434,6157118,53,6171497,-55,-108
II,+,6173604,0.00925926,3.32801e-31,108,107,1,1,113,gene,F40H3.2,0,6173629,0.407852,492,6173112,25,6173604,0,-25
II,+,6183023,0.0,0.0,890,890,0,0,7,gene,F40H3.1,0,6183047,0.90018,8200,6174823,24,6183048,25,1
II,+,6197141,0.00982318,0.0,1018,1008,10,9,104,gene,C30B5.2,0,6197188,3.77639,2019,6195122,47,6197141,0,-47
II,+,6198721,0.125,0.03125,8,7,1,0,535,gene,C30B5.1,0,6198729,0.689786,461,6198260,8,6198683,-38,-46
II,+,6245701,0.00501253,0.0,399,397,2,1,1,gene,T24H7.4,1,6245704,1.05681,3208,6242493,3,6245701,0,-3
II,+,6246288,1.0,0.25,2,0,2,2,1,gene,T24H7.3,2,6246316,1.39123,74,6246214,28,6246315,27,-1
II,+,6246308,0.878492,0.0,2148,261,1887,1376,1,gene,T24H7.3,2,6246316,1.39123,94,6246214,8,6246308,0,-8
II,+,6246315,0.81982,2.06447e-12,111,20,91,51,5367,gene,T24H7.3,2,6246316,1.39123,101,6246214,1,6246315,0,-1
II,+,6247262,0.975262,0.0,1334,33,1301,987,1,gene,T24H7.2,3,6247266,1.81402,108,6247154,4,6247262,0,-4
II,+,6251362,0.022082,0.0,4121,4030,91,56,1,gene,T24H7.1,4,6251365,6.25077,570,6250792,3,6251362,0,-3
II,+,6262590,1.0,0.03125,5,0,5,3,10,gene,F13H8.12,0,6262609,0.153936,60,6262530,19,6262487,-103,-122
II,+,6264085,0.0,2.98023e-08,25,25,0,0,17,gene,F13H8.3,0,6264094,0.146986,812,6263273,9,6264011,-74,-83
II,+,6264095,0.0,2.98023e-08,25,25,0,0,52,gene,F13H8.3,0,6264221,0.146986,822,6263273,126,6264011,-84,-210
II,+,6270322,0.17033,1.52184e-20,182,151,31,28,0,gene,F13H8.2,0,6270349,0.749462,946,6269376,27,6270322,0,-27
II,+,6274172,0.0,0.0078125,7,7,0,0,18,gene,F13H8.10,0,6274214,0.461616,218,6273954,42,6274215,43,1
II,+,6277291,0.0181818,1.52656e-15,55,54,1,0,54,gene,F13H8.10,0,6277383,0.461616,3035,6274256,92,6277291,0,-92
II,+,6277554,0.0208333,1.7053e-13,48,47,1,1,3,gene,F13H8.10,0,6277639,0.461616,3298,6274256,85,6277554,0,-85
II,+,6300145,0.0,0.5,1,1,0,0,0,gene,C29F5.2,0,6300211,0.0232073,15471,6284674,66,6300145,0,-66
II,+,6324433,0.0123457,3.35008e-23,81,80,1,1,4,gene,C32D5.2,0,6324437,0.455132,16261,6308172,4,6324433,0,-4
II,+,6365689,0.00316456,0.0,632,630,2,2,25,gene,K10B2.3,1,6365725,4.58338,20224,6345465,36,6365689,0,-36
II,+,6365799,0.0,0.0078125,7,7,0,0,1362,gene,K10B2.3,1,6365880,4.58338,20334,6345465,81,6365689,-110,-191
II,+,6371254,0.0029098,0.0,1031,1028,3,3,0,gene,K10B2.1,0,6371261,1.42003,2194,6369060,7,6371254,0,-7
II,+,6383594,0.00577692,0.0,6751,6712,39,35,1,gene,F58F12.1,0,6383601,16.6894,9102,6374492,7,6383594,0,-7
II,+,6386718,0.0,9.31323e-10,30,30,0,0,2,gene,F58F12.4,0,6386741,0.285817,2077,6384641,23,6386742,24,1
II,+,6386742,0.0,3.30872e-24,78,78,0,0,62,gene,F58F12.4,0,6386844,0.285817,2101,6384641,102,6386742,0,-102
II,+,6398655,0.0,3.85186e-34,111,111,0,0,0,gene,T25D10.2,0,6398657,0.234954,11277,6387378,2,6398655,0,-2
II,+,6403523,0.0,0.00195312,9,9,0,0,30,gene,T25D10.1,0,6403639,0.336824,472,6403051,116,6403430,-93,-209
II,+,6423350,0.0,0.5,1,1,0,0,3,gene,K03H9.3,0,6423385,0.0317184,18367,6404983,35,6423061,-289,-324
II,+,6441377,0.0,4.48416e-44,144,144,0,0,16,gene,K06A1.3,0,6441377,0.947093,9553,6431824,0,6441377,0,0
II,+,6441442,0.0,0.5,1,1,0,0,62,gene,K06A1.3,0,6441487,0.947093,9618,6431824,45,6441377,-65,-110
II,+,6444267,1.0,0.5,1,0,1,1,0,gene,K06A1.2,0,6444310,0.0693954,398,6443869,43,6444592,325,282
II,+,6454922,0.0,8.88178e-16,50,50,0,0,2,gene,K06A1.1,0,6454922,0.0419108,8825,6446097,0,6454923,1,1
II,+,6476904,0.0178571,0.0,336,330,6,5,8,gene,T28D9.4,0,6476907,1.31222,374,6476530,3,6476908,4,1
II,+,6490116,0.00757576,0.0,1188,1179,9,7,2,gene,T28D9.2,0,6490117,2.82814,1278,6488838,1,6490118,2,1
II,+,6492351,0.0174553,0.0,12088,11877,211,186,1,gene,T28D9.1,0,6492354,11.0764,1070,6491281,3,6492351,0,-3
II,+,6524875,0.0,0.0,381,381,0,0,24,gene,C56E6.2,0,6524882,0.906275,6276,6518599,7,6524875,0,-7
II,+,6532113,0.0,0.03125,5,5,0,0,0,gene,C56E6.1,0,6532125,0.239127,5836,6526277,12,6532126,13,1
II,+,6554924,0.937198,6.81031e-43,207,13,194,158,2,gene,F18C5.2,2,6554933,0.315252,111,6554813,9,6554924,0,-9
II,+,6569310,0.0,0.5,1,1,0,0,1,gene,F18C5.1,0,6569343,0.00227516,1427,6567883,33,6568961,-349,-382
II,+,6589655,0.00343348,0.0,1165,1161,4,4,1,gene,C56C10.3,0,6589657,4.77647,5192,6584463,2,6589655,0,-2
II,+,6618165,0.00420168,0.0,238,237,1,0,1,gene,F54H5.4,0,6618224,0.684004,14765,6603400,59,6618165,0,-59
II,+,6618195,0.0,0.5,1,1,0,0,213,gene,F54H5.4,0,6618224,0.684004,14795,6603400,29,6618165,-30,-59
II,+,6631091,0.0,0.5,1,1,0,0,2,gene,T19D12.4,0,6631113,1.0175,1875,6629216,22,6631100,9,-13
II,+,6631144,0.00503778,0.0,397,395,2,2,62,gene,T19D12.4,0,6631152,1.0175,1928,6629216,8,6631144,0,-8
II,+,6660087,0.0,0.0625,4,4,0,0,2,gene,T19D12.3,0,6660123,0.011727,23043,6637044,36,6660219,132,96
II,+,6661822,0.00352113,0.0,284,283,1,0,42,gene,T19D12.2,0,6661830,0.344983,24778,6637044,8,6661822,0,-8
II,+,6666845,0.0,6.61744e-24,77,77,0,0,1,gene,T19D12.1,0,6666864,0.656424,1681,6665164,19,6666865,20,1
II,+,6674252,0.0238095,9.54969e-12,42,41,1,0,162,gene,H43E16.1,0,6674261,0.326758,555,6673697,9,6674213,-39,-48
II,+,6684183,0.00242131,0.0,413,412,1,1,0,gene,C18H9.3,0,6684193,0.806945,1169,6683014,10,6684194,11,1
II,+,6691248,0.0232558,4.88853e-12,43,42,1,1,0,gene,C18H9.2,0,6691262,0.562749,3653,6687595,14,6691248,0,-14
II,+,6714234,0.0,0.0,289,289,0,0,3,gene,T14B4.6,0,6714235,2.20149,13807,6700427,1,6714234,0,-1
II,+,6716890,0.0,0.0625,4,4,0,0,47,gene,T14B4.5,0,6716898,0.253732,977,6715913,8,6716899,9,1
II,+,6718502,0.00668896,0.0,299,297,2,2,21,gene,T14B4.4,0,6718526,0.525375,723,6717779,24,6718502,0,-24
II,+,6736141,0.902821,0.0,638,62,576,370,2,gene,T14B4.2,2,6736141,1.30865,93,6736048,0,6736142,1,1
II,+,6736842,0.964126,0.0,223,8,215,158,0,gene,T14B4.1,3,6736844,0.369944,113,6736729,2,6736845,3,1
II,+,6741628,0.872093,3.16194e-13,86,11,75,49,53,gene,F41G3.14,4,6741672,0.768169,212,6741416,44,6741628,0,-44
II,+,6742851,0.959375,0.0,960,39,921,721,0,gene,F41G3.6,5,6742856,1.24331,96,6742755,5,6742851,0,-5
II,+,6764991,0.0,1.11022e-16,53,53,0,0,615,gene,F41G3.1,0,6765027,2.58684,4556,6760435,36,6764977,-14,-50
II,+,6765015,0.00574713,0.0,174,173,1,1,684,gene,F41G3.1,0,6765027,2.58684,4580,6760435,12,6764977,-38,-50
II,+,6777008,0.00898876,0.0,445,441,4,3,1,gene,T13C2.4,0,6777008,0.913689,8129,6768879,0,6777009,1,1
II,+,6779382,0.0,7.62939e-06,17,17,0,0,3,gene,T13C2.7,0,6779395,0.0665299,1570,6777812,13,6779396,14,1
II,+,6783359,0.000857265,0.0,2333,2331,2,2,0,gene,T13C2.6,0,6783400,2.27741,1741,6781618,41,6783359,0,-41
II,+,6789180,0.0,1.20371e-35,116,116,0,0,0,gene,T13C2.3,0,6789192,0.519787,980,6788200,12,6789180,0,-12
II,+,6792193,0.0,0.000244141,12,12,0,0,86,gene,T13C2.2,0,6792193,0.134127,479,6791714,0,6792163,-30,-30
II,+,6810895,0.00675676,0.0,296,294,2,1,3,gene,F31E8.2,0,6810899,0.475382,6100,6804795,4,6810895,0,-4
II,+,6834940,0.0,0.25,2,2,0,0,0,gene,C04A2.3,0,6835012,2.94305,18567,6816373,72,6835013,73,1
II,+,6834953,0.0,0.0,235,235,0,0,5,gene,C04A2.3,0,6835012,2.94305,18580,6816373,59,6835013,60,1
II,+,6842342,0.00328947,0.0,304,303,1,1,0,gene,C04A2.3,0,6842614,2.94305,25969,6816373,272,6842341,-1,-273
II,+,6845294,0.00348432,0.0,574,572,2,2,0,gene,C04A2.3,0,6845306,2.94305,28921,6816373,12,6845294,0,-12
II,+,6847986,0.615385,0.157104,13,5,8,7,6,gene,C04A2.1,0,6848103,0.306308,148,6847838,117,6847992,6,-111
II,+,6898667,0.00649351,7.00649e-45,154,153,1,1,0,gene,C44B7.2,1,6898681,0.771265,6391,6892276,14,6898667,0,-14
II,+,6902026,0.800847,0.0,708,141,567,415,0,gene,C44B7.1,2,6902077,1.29366,287,6901739,51,6902026,0,-51
II,+,6910003,0.0,0.000976562,10,10,0,0,7,gene,B0252.2,0,6910014,0.230851,7128,6902875,11,6910003,0,-11
II,+,6916116,0.0,0.0,192,192,0,0,1887,gene,B0252.8,0,6916127,1.34178,3533,6912583,11,6916087,-29,-40
II,+,6928701,0.00615385,0.0,325,323,2,0,2,gene,F22D3.2,0,6928897,2.93358,489,6928212,196,6928701,0,-196
II,+,6929237,0.0,0.25,2,2,0,0,0,gene,F22D3.2,0,6929243,2.93358,1025,6928212,6,6929237,0,-6
II,+,6944236,0.0,0.0,648,648,0,0,47,gene,F22D3.2,0,6944291,2.93358,10109,6934127,55,6944236,0,-55
II,+,6944379,0.0,0.015625,6,6,0,0,181,gene,F22D3.2,0,6944396,2.93358,10252,6934127,17,6944236,-143,-160
II,+,6951461,0.0,9.31323e-10,30,30,0,0,0,gene,F22D3.1,0,6951486,1.69628,4490,6946971,25,6951573,112,87
II,+,6951937,0.00568182,0.0,528,525,3,2,0,gene,F22D3.1,0,6952002,1.69628,4966,6946971,65,6951937,0,-65
II,+,6979886,0.0,2.91038e-11,35,35,0,0,1,gene,C15F1.2,0,6979938,0.133851,3953,6975933,52,6979939,53,1
II,+,6994984,0.0210526,1.12712e-25,95,93,2,2,7,gene,C52E12.2,0,6995084,0.387887,3332,6991652,100,6994984,0,-100
II,+,7025735,0.00173611,0.0,576,575,1,1,36,gene,C52E12.1,0,7025746,0.817574,868,7024867,11,7025735,0,-11
II,+,7038227,0.0,1.38778e-17,56,56,0,0,0,gene,ZK1127.7,0,7038236,0.110178,8137,7030090,9,7038227,0,-9
II,+,7050604,0.0,4.48416e-44,144,144,0,0,4,gene,ZK1127.5,1,7050606,0.640229,6017,7044587,2,7050604,0,-2
II,+,7052010,0.961538,2.94431e-13,52,2,50,35,32,gene,ZK1127.12,2,7052166,0.785356,91,7051919,156,7052031,21,-135
II,+,7052286,1.0,3.55271e-15,48,0,48,40,0,gene,ZK1127.12,2,7052292,0.785356,367,7051919,6,7052286,0,-6
II,+,7053864,1.0,0.00195312,9,0,9,9,0,gene,ZK1127.4,3,7053881,0.756813,88,7053776,17,7053881,17,0
II,+,7053881,0.958904,0.0,219,9,210,141,18,gene,ZK1127.4,3,7053881,0.756813,105,7053776,0,7053881,0,0
II,+,7055219,0.934426,1.81099e-25,122,8,114,78,5,gene,ZK1127.3,0,7055228,1.67275,93,7055126,9,7055224,5,-4
II,+,7055229,0.88764,8.21529e-15,89,10,79,61,259,gene,ZK1127.3,0,7055349,1.67275,103,7055126,120,7055224,-5,-125
II,+,7073746,0.00633357,0.0,2842,2824,18,16,0,gene,T02G5.8,1,7073746,3.09083,6848,7066898,0,7073746,0,0
II,+,7075546,0.357836,4.724e-28,1442,926,516,298,9,gene,T02G5.7,2,7075558,3.30105,98,7075448,12,7075546,0,-12
II,+,7075550,0.333333,0.375,3,2,1,1,34,gene,T02G5.7,2,7075558,3.30105,102,7075448,8,7075546,-4,-12
II,+,7082022,0.0,4.23516e-22,71,71,0,0,3,gene,T02G5.4,0,7082033,0.187465,3523,7078499,11,7082034,12,1
II,+,7094138,0.0,1.52588e-05,16,16,0,0,43,gene,T02G5.3,0,7094143,0.0846208,1873,7092265,5,7094131,-7,-12
II,+,7105495,0.0069087,0.0,44292,43986,306,274,3,gene,F10E7.7,0,7105500,117.736,6216,7099279,5,7105495,0,-5
II,+,7111910,0.00868403,0.0,1497,1484,13,10,20,gene,F10E7.5,1,7111923,4.00515,5612,7106298,13,7111910,0,-13
II,+,7113012,0.950048,0.0,1041,52,989,765,20,gene,F10E7.6,2,7113015,2.02075,100,7112912,3,7113012,0,-3
II,+,7122172,0.00114025,0.0,877,876,1,1,5,gene,F10E7.2,0,7122173,0.717614,1697,7120475,1,7122174,2,1
II,+,7132575,0.00127959,0.0,1563,1561,2,2,2,gene,T07F8.3,0,7132590,1.3937,3630,7128945,15,7132575,0,-15
II,+,7144547,0.0,7.62939e-06,17,17,0,0,0,gene,T07F8.2,0,7144551,0.0660543,7093,7137454,4,7144552,5,1
II,+,7152585,0.00424547,0.0,2591,2580,11,10,311,gene,C27H5.3,0,7152632,3.05461,892,7151693,47,7152585,0,-47
II,+,7183741,0.00653595,0.0,306,304,2,0,3,gene,C27H5.1,0,7183757,0.593009,22860,7160881,16,7183758,17,1
II,+,7229085,0.00208914,0.0,2872,2866,6,6,4,gene,F32A5.4,0,7229085,6.49189,22260,7206825,0,7229085,0,0
II,+,7232786,0.00314961,0.0,635,633,2,1,18,gene,F32A5.3,0,7232786,1.47332,2220,7230566,0,7232786,0,0
II,+,7245848,0.00735294,1.5612e-39,136,135,1,0,7,gene,F32A5.2,0,7245850,0.684314,6128,7239720,2,7245848,0,-2
II,+,7253353,0.00210084,0.0,476,475,1,1,10,gene,F32A5.1,0,7253357,0.89413,3239,7250114,4,7253353,0,-4
II,+,7256797,0.0,1.52588e-05,16,16,0,0,2,gene,F32A5.8,0,7256929,0.868956,1127,7255670,132,7256955,158,26
II,+,7256945,0.00793651,1.48112e-36,126,125,1,1,8,gene,F32A5.8,0,7256954,0.868956,1275,7255670,9,7256955,10,1
II,+,7290276,0.0,3.05176e-05,15,15,0,0,6,gene,C30G12.2,0,7290288,0.713848,26689,7263587,12,7290306,30,18
II,+,7302034,0.00449102,0.0,668,665,3,3,0,gene,F45E12.3,1,7302043,0.609754,462,7301572,9,7302034,0,-9
II,+,7305782,1.0,0.125,3,0,3,3,2,gene,F45E12.2,2,7305803,0.555887,91,7305691,21,7305794,12,-9
II,+,7305794,0.878641,9.65403e-31,206,25,181,137,15,gene,F45E12.2,2,7305803,0.555887,103,7305691,9,7305794,0,-9
II,+,7305797,0.771429,0.000684983,35,8,27,20,19,gene,F45E12.2,2,7305803,0.555887,106,7305691,6,7305794,-3,-9
II,+,7311422,0.0232558,4.88853e-12,43,42,1,1,6,gene,F45E12.1,0,7311448,1.27613,2751,7308671,26,7311449,27,1
II,+,7339162,0.0,0.0,257,257,0,0,2,gene,F21D12.1,0,7339195,0.822836,25437,7313725,33,7339162,0,-33
II,+,7346441,0.0,0.0,188,188,0,0,3,gene,F21D12.1,0,7346448,0.822836,32716,7313725,7,7346441,0,-7
II,+,7358826,0.0,4.23516e-22,71,71,0,0,1,gene,F43E2.9,0,7358829,0.138319,9772,7349054,3,7358844,18,15
II,+,7359885,0.0,0.125,3,3,0,0,0,gene,F43E2.3,0,7359891,0.33612,10831,7349054,6,7359892,7,1
II,+,7374434,0.00541191,0.0,1663,1654,9,8,7,gene,F43E2.2,1,7374436,3.5764,11240,7363194,2,7374428,-6,-8
II,+,7375211,0.97619,1.80222e-22,84,2,82,60,1,gene,F43E2.1,2,7375295,0.421517,41,7375170,84,7375211,0,-84
II,+,7375220,1.0,0.00390625,8,0,8,3,194,gene,F43E2.1,2,7375295,0.421517,50,7375170,75,7375211,-9,-84
II,+,7381492,0.00128866,0.0,776,775,1,1,2,gene,C07D10.5,0,7381493,0.854793,1904,7379588,1,7381492,0,-1
II,+,7387081,0.0,0.0625,4,4,0,0,0,gene,C07D10.3,0,7387092,0.00996263,3659,7383422,11,7387093,12,1
II,+,7394886,0.00259965,0.0,1154,1151,3,3,1,gene,C07D10.2,0,7394888,1.36377,5813,7389073,2,7394886,0,-2
II,+,7398943,0.0263158,1.38243e-10,38,37,1,1,0,gene,C07D10.1,0,7398960,0.113216,1662,7397281,17,7398944,1,-16
II,+,7479137,0.0,0.00390625,8,8,0,0,212,gene,D1022.1,0,7479202,1.15263,6617,7472520,65,7479144,7,-58
II,+,7479323,0.0,0.125,3,3,0,0,3,gene,D1022.1,0,7479336,1.15263,6803,7472520,13,7479323,0,-13
II,+,7494596,0.0,1.81899e-12,39,39,0,0,161,gene,R10H1.1,0,7494637,0.908896,13955,7480641,41,7494388,-208,-249
II,+,7529568,0.0,0.0,416,416,0,0,2,gene,ZK1290.5,0,7529570,0.514369,1407,7528161,2,7529571,3,1
II,+,7535044,0.0,6.10352e-05,14,14,0,0,6,gene,ZK1290.13,0,7535107,0.352355,1873,7533171,63,7535054,10,-53
II,+,7538119,0.0225564,3.52011e-35,133,130,3,2,13,gene,ZK1290.4,0,7538119,0.743427,928,7537191,0,7538119,0,0
II,+,7538494,0.0,0.00012207,13,13,0,0,0,gene,ZK1290.4,0,7538518,0.743427,1303,7537191,24,7538625,131,107
II,+,7538625,0.0,0.125,3,3,0,0,2,gene,ZK1290.4,0,7538628,0.743427,1434,7537191,3,7538628,3,0
II,+,7549259,0.0,0.0625,4,4,0,0,0,gene,ZK1290.2,0,7549281,0.0346135,3999,7545260,22,7549259,0,-22
II,+,7549300,0.0,0.125,3,3,0,0,3,gene,ZK1290.2,0,7549311,0.0346135,4040,7545260,11,7549259,-41,-52
II,+,7570529,0.00126743,0.0,789,788,1,1,1,gene,F35D2.3,0,7570530,0.836152,7906,7562623,1,7570529,0,-1
II,+,7575840,0.0,0.5,1,1,0,0,0,gene,F35D2.1,0,7575853,0.0441153,119,7575721,13,7575846,6,-7
II,+,7599581,0.0243902,6.86767e-22,82,80,2,2,41,gene,R07G3.3,0,7599582,1.30953,19379,7580202,1,7599581,0,-1
II,+,7613465,0.00537634,0.0,186,185,1,1,0,gene,R07G3.9,0,7613546,0.227834,2650,7610815,81,7613465,0,-81
II,+,7616376,0.00788782,0.0,1141,1132,9,6,0,gene,R07G3.1,0,7616380,4.3933,2020,7614356,4,7616376,0,-4
II,+,7664502,0.0118026,0.0,932,921,11,7,9,gene,F18A1.5,0,7664511,2.76887,46340,7618162,9,7664502,0,-9
II,+,7667913,0.0434783,8.87589e-17,69,66,3,3,9,gene,F18A1.4,1,7667925,0.314864,883,7667030,12,7667913,0,-12
II,+,7668348,0.0,1.52588e-05,16,16,0,0,1,gene,F18A1.4,1,7668387,0.314864,1318,7667030,39,7668346,-2,-41
II,+,7671930,0.958042,0.0,429,18,411,304,0,gene,F18A1.3,2,7671962,2.7211,105,7671825,32,7671930,0,-32
II,+,7680970,0.0,0.0,211,211,0,0,6,gene,F18A1.3,2,7681033,2.7211,9145,7671825,63,7680970,0,-63
II,+,7682394,0.936728,0.0,648,41,607,367,2,gene,F18A1.2,3,7682441,2.09234,118,7682276,47,7682394,0,-47
II,+,7699201,0.0,0.00012207,13,13,0,0,82,gene,B0495.2,0,7699229,0.752,9546,7689655,28,7699171,-30,-58
II,+,7699219,0.0217391,6.53699e-13,46,45,1,1,458,gene,B0495.2,0,7699229,0.752,9564,7689655,10,7699171,-48,-58
II,+,7781489,0.0,0.0,262,262,0,0,11,gene,C06A8.5,0,7781509,0.847646,7655,7773834,20,7781502,13,-7
II,+,7783442,0.0444444,2.81375e-11,45,43,2,1,5,gene,C06A8.4,0,7783475,0.558472,167,7783275,33,7783740,298,265
II,+,7783776,0.00776699,0.0,515,511,4,3,28,gene,C06A8.4,0,7783800,0.558472,501,7783275,24,7783740,-36,-60
II,+,7790664,0.0,0.25,2,2,0,0,1790,gene,C06A8.3,0,7790883,29.8256,6099,7784565,219,7790483,-181,-400
II,+,7811164,0.00301205,0.0,332,331,1,1,1,gene,T05A6.1,0,7811182,1.42112,19846,7791318,18,7811164,0,-18
II,+,7816616,0.0,2.93874e-39,128,128,0,0,8,gene,T05A6.2,0,7816631,0.786221,4591,7812025,15,7816616,0,-15
II,+,7832154,0.0,0.5,1,1,0,0,1,gene,T09A5.14,0,7832203,0.0442706,11954,7820200,49,7832314,160,111
II,+,7842278,0.004,0.0,250,249,1,1,1,gene,T09A5.2,0,7842339,0.589685,4036,7838242,61,7842340,62,1
II,+,7846401,0.0,0.00390625,8,8,0,0,4,gene,T09A5.4,0,7846411,0.163756,825,7845576,10,7846412,11,1
II,+,7857877,0.00324675,0.0,1232,1228,4,2,7,gene,T09A5.15,1,7857882,2.38023,9981,7847896,5,7857796,-81,-86
II,+,7858324,0.887019,0.0,416,47,369,239,2,gene,T09A5.9,2,7858342,1.11337,95,7858229,18,7858324,0,-18
II,+,7860582,0.00367107,0.0,1362,1357,5,4,194,gene,T09A5.10,0,7860582,1.37953,867,7859715,0,7860582,0,0
II,+,7864430,0.0912343,0.0,559,508,51,36,7,gene,T09A5.11,0,7864430,4.55787,944,7863486,0,7864430,0,0
II,+,7879670,0.0,0.5,1,1,0,0,1,gene,T01H3.5,0,7879696,0.130852,13494,7866176,26,7879680,10,-16
II,+,7880736,0.00811359,0.0,493,489,4,4,1,gene,T01H3.4,0,7880744,0.549401,348,7880388,8,7880736,0,-8
II,+,7893153,0.00295858,0.0,338,337,1,1,0,gene,ZK675.1,1,7893188,1.39999,10462,7882691,35,7893153,0,-35
II,+,7900553,0.779221,3.24611e-07,77,17,60,34,0,gene,ZK675.2,2,7900563,0.208723,124,7900429,10,7900571,18,8
II,+,7941079,0.0,2.40741e-35,115,115,0,0,42,gene,ZK669.3,0,7941094,0.302109,28638,7912441,15,7941075,-4,-19
II,+,7958768,0.0,0.0078125,7,7,0,0,0,gene,C04H4.1,0,7958770,0.0494528,16242,7942526,2,7958768,0,-2
II,+,7976538,0.0,2.11758e-22,72,72,0,0,0,gene,DH11.5,0,7976574,0.603783,16377,7960161,36,7976538,0,-36
II,+,7985134,0.0,2.22045e-16,52,52,0,0,2,gene,DH11.5,0,7985227,0.603783,24973,7960161,93,7985160,26,-67
II,+,7992284,0.0,9.09495e-13,40,40,0,0,4,gene,DH11.4,0,7992306,0.27014,2252,7990032,22,7992307,23,1
II,+,8008589,0.0,1.86265e-09,29,29,0,0,34,gene,DH11.1,0,8008606,0.648266,14457,7994132,17,8008598,9,-8
II,+,8008598,0.0,0.0,264,264,0,0,70,gene,DH11.1,0,8008606,0.648266,14466,7994132,8,8008598,0,-8
II,+,8012740,0.0107527,9.3906e-27,93,92,1,1,42,gene,DH11.2,0,8012758,0.769392,1184,8011556,18,8012740,0,-18
II,+,8013134,0.0,0.25,2,2,0,0,2,gene,DH11.2,0,8013148,0.769392,29,8013105,14,8012740,-394,-408
II,+,8017604,0.0063857,0.0,783,778,5,5,2,gene,C08B11.1,0,8017615,1.65789,2419,8015185,11,8017604,0,-11
II,+,8039931,0.0116279,1.11152e-24,86,85,1,1,1,gene,C08B11.8,0,8039932,0.439745,19227,8020704,1,8039933,2,1
II,+,8042512,0.00309917,0.0,968,965,3,2,33,gene,T05H10.1,1,8042578,0.904399,857,8041655,66,8042512,0,-66
II,+,8047487,0.901907,0.0,367,36,331,244,1,gene,T05H10.2,2,8047624,0.71612,115,8047372,137,8047487,0,-137
II,+,8047513,1.0,0.5,1,0,1,1,307,gene,T05H10.2,2,8047624,0.71612,141,8047372,111,8047487,-26,-137
II,+,8053060,0.00357143,0.0,280,279,1,1,8,gene,T05H10.4,0,8053077,1.49401,4009,8049051,17,8053060,0,-17
II,+,8053178,0.0,0.5,1,1,0,0,1,gene,T05H10.4,0,8053207,1.49401,4127,8049051,29,8053178,0,-29
II,+,8059001,0.0277778,5.23869e-10,36,35,1,1,2,gene,T05H10.8,0,8059009,0.0761948,4170,8054831,8,8058992,-9,-17
II,+,8062666,0.0,0.0,608,608,0,0,9,gene,T05H10.5,1,8062674,2.4912,1159,8061507,8,8062666,0,-8
II,+,8066210,0.962963,7.94365e-14,54,2,52,13,3,gene,T05H10.6,2,8066222,6.73108,73,8066137,12,8066210,0,-12
II,+,8066368,0.927118,0.0,2113,154,1959,1231,7,gene,T05H10.6,2,8066404,6.73108,132,8066236,36,8066368,0,-36
II,+,8066371,0.913043,2.0308e-13,69,6,63,37,17,gene,T05H10.6,2,8066404,6.73108,135,8066236,33,8066371,0,-33
II,+,8078364,0.0,0.0,471,471,0,0,12,gene,K02C4.5,0,8078379,0.52992,1607,8076757,15,8078380,16,1
II,+,8129883,0.0174419,0.0,344,338,6,6,0,gene,C41C4.6,0,8129897,1.48397,7052,8122831,14,8129883,0,-14
II,+,8138419,0.00389755,0.0,3592,3578,14,10,171,gene,C41C4.8,0,8138433,3.64326,3758,8134661,14,8138419,0,-14
II,+,8143804,0.00392903,0.0,87808,87463,345,310,278,gene,F10B5.1,1,8143806,119.432,2616,8141188,2,8143804,0,-2
II,+,8144685,0.980645,0.0,310,6,304,241,2,gene,F10B5.2,2,8144717,0.662249,92,8144593,32,8144724,39,7
II,+,8157284,0.0,1.19209e-07,23,23,0,0,2,gene,F10B5.9,0,8157284,0.0304132,10125,8147159,0,8157285,1,1
II,+,8158272,0.0,7.34684e-40,130,130,0,0,16,gene,F10B5.5,0,8158279,0.626195,64,8158208,7,8158272,0,-7
II,+,8185366,0.0140228,0.0,1141,1125,16,16,0,gene,T05C12.7,0,8185368,6.90477,3134,8182232,2,8185366,0,-2
II,+,8198727,0.0,9.09495e-13,40,40,0,0,0,gene,T05C12.10,0,8198803,0.701706,11202,8187525,76,8198727,0,-76
II,+,8204265,0.0,0.0,223,223,0,0,0,gene,M110.1,0,8204265,1.56995,340,8203925,0,8204265,0,0
II,+,8217156,0.00865052,0.0,578,573,5,5,7,gene,M110.4,0,8217178,2.36777,9743,8207413,22,8217156,0,-22
II,+,8217282,0.0,0.03125,5,5,0,0,177,gene,M110.4,0,8217287,2.36777,9869,8207413,5,8217282,0,-5
II,+,8226241,0.00944584,0.0,1588,1573,15,13,5,gene,M110.5,0,8226254,4.60117,703,8225538,13,8226241,0,-13
II,+,8226750,0.0,0.0625,4,4,0,0,32,gene,M110.5,0,8226765,4.60117,1212,8225538,15,8226645,-105,-120
II,+,8242425,0.0,7.88861e-31,100,100,0,0,13,gene,F35C11.1,0,8242452,0.236567,5253,8237172,27,8242432,7,-20
II,+,8249801,0.0,5.29396e-23,74,74,0,0,1,gene,F35C11.4,0,8249866,0.198829,1577,8248224,65,8249845,44,-21
II,+,8253667,0.00641711,0.0,935,929,6,6,1,gene,F35C11.5,0,8253678,0.986647,1762,8251905,11,8253192,-475,-486
II,+,8256238,0.0111524,0.0,269,266,3,1,0,gene,F35C11.7,0,8256242,0.665665,994,8255244,4,8256236,-2,-6
II,+,8265114,0.00441501,0.0,453,451,2,1,9,gene,K01C8.1,0,8265126,0.839693,7584,8257530,12,8265114,0,-12
II,+,8270522,0.00678733,0.0,442,439,3,3,30,gene,K01C8.3,0,8270531,0.860019,3237,8267285,9,8270532,10,1
II,+,8276285,0.0,2.84217e-14,45,45,0,0,72,gene,K01C8.7,0,8276291,0.359012,2782,8273503,6,8276284,-1,-7
II,+,8283593,0.00328283,0.0,3960,3947,13,11,0,gene,K01C8.10,0,8283771,6.26861,2489,8281104,178,8283593,0,-178
II,+,8329217,0.0,0.000976562,10,10,0,0,7,gene,C26D10.4,0,8329263,0.104813,1359,8327858,46,8329683,466,420
II,+,8334015,0.0,0.5,1,1,0,0,0,gene,C26D10.7,0,8334018,0.00303511,623,8333392,3,8334019,4,1
II,+,8346615,0.0,2.1684e-19,62,62,0,0,0,gene,C26D10.5,0,8346618,0.160871,10187,8336428,3,8346615,0,-3
II,+,8361015,0.0,0.000976562,10,10,0,0,2,gene,M195.2,0,8361018,0.295376,10533,8350482,3,8361019,4,1
II,+,8381421,0.0,1.79366e-43,142,142,0,0,1,gene,F49E12.12,0,8381426,0.227829,4140,8377281,5,8381427,6,1
II,+,8412595,0.00193798,0.0,516,515,1,1,0,gene,F49E12.6,0,8412622,0.862878,3434,8409161,27,8412595,0,-27
II,+,8442691,0.00943396,0.0,2014,1995,19,17,136,gene,F22B5.2,1,8442707,3.08684,616,8442075,16,8442695,4,-12
II,+,8444231,0.80597,3.85541e-37,402,78,324,242,2,gene,F22B5.1,2,8444278,0.421831,48,8444183,47,8444231,0,-47
II,+,8452051,0.00224719,0.0,890,888,2,2,7,gene,F22B5.4,0,8452051,0.801042,7022,8445029,0,8452051,0,0
II,+,8457742,0.0123839,0.0,323,319,4,4,0,gene,F22B5.7,1,8457744,1.39188,5042,8452700,2,8457742,0,-2
II,+,8464457,1.0,0.0625,4,0,4,2,0,gene,F22B5.9,2,8464513,2.19836,23,8464434,56,8464772,315,259
II,+,8464772,0.318653,8.42269e-25,772,526,246,169,11,gene,F22B5.9,2,8464775,2.19836,281,8464491,3,8464772,0,-3
II,+,8467098,0.951264,0.0,1662,81,1581,1182,1,gene,F22B5.10,3,8467165,3.34748,102,8466996,67,8467098,0,-67
II,+,8468033,0.962162,0.0,370,14,356,261,3,gene,M05D6.2,4,8468046,0.982727,95,8467938,13,8468033,0,-13
II,+,8468043,0.789474,0.00739288,19,4,15,9,942,gene,M05D6.2,4,8468046,0.982727,105,8467938,3,8468033,-10,-13
II,+,8485853,0.0,1.50463e-36,119,119,0,0,73,gene,M05D6.7,0,8485861,0.606944,7973,8477880,8,8485862,9,1
II,+,8485857,0.0,0.015625,6,6,0,0,79,gene,M05D6.7,0,8485861,0.606944,7977,8477880,4,8485862,5,1
II,+,8494204,0.0,0.000244141,12,12,0,0,5,gene,M05D6.9,0,8494211,0.134847,6709,8487495,7,8494204,0,-7
II,+,8515006,0.00934579,6.59438e-31,107,106,1,1,7,gene,T13H5.2,1,8515013,0.709349,15987,8499019,7,8515014,8,1
II,+,8517074,0.00496524,0.0,1007,1002,5,2,3,gene,T13H5.7,2,8517076,0.581232,141,8516933,2,8517074,0,-2
II,+,8518434,0.909091,0.0,330,30,300,207,3,gene,T13H5.8,3,8518481,0.773914,101,8518333,47,8518434,0,-47
II,+,8525611,0.0190024,0.0,421,413,8,7,27,gene,T13H5.5,0,8525612,1.95653,2169,8523442,1,8525613,2,1
II,+,8535983,0.0,0.25,2,2,0,0,9,gene,W01C9.2,0,8535990,0.0733776,9258,8526725,7,8536284,301,294
II,+,8536334,0.0,0.0078125,7,7,0,0,3,gene,W01C9.2,0,8536367,0.0733776,9609,8526725,33,8536284,-50,-83
II,+,8540637,0.00689655,3.25101e-42,145,144,1,1,1,gene,W01C9.3,1,8540643,0.664387,2143,8538494,6,8540644,7,1
II,+,8569851,0.00316708,0.0,50204,50045,159,133,3,gene,F54C9.5,1,8569856,92.9286,6151,8563700,5,8569851,0,-5
II,+,8571009,0.666667,0.375,3,1,2,2,1,gene,F54C9.6,2,8571019,0.719116,33,8570976,10,8571009,0,-10
II,+,8571015,0.983333,5.37154e-33,120,2,118,100,3,gene,F54C9.6,2,8571019,0.719116,39,8570976,4,8571020,5,1
II,+,8571020,0.928,3.59472e-25,125,9,116,84,162,gene,F54C9.6,2,8571092,0.719116,44,8570976,72,8571020,0,-72
II,+,8573277,0.0,2.84217e-14,45,45,0,0,1,gene,F54C9.7,0,8573278,0.182259,453,8572824,1,8573276,-1,-2
II,+,8575467,0.00254813,0.0,3532,3523,9,9,155,gene,F54C9.8,1,8575500,4.44868,479,8574988,33,8575465,-2,-35
II,+,8577973,0.1975,4.08071e-36,400,321,79,58,3,gene,F54C9.9,2,8577979,0.723222,317,8577656,6,8577973,0,-6
II,+,8581924,0.837009,0.0,1043,170,873,568,35,gene,F54C9.10,3,8581933,1.64166,487,8581437,9,8581924,0,-9
II,+,8594114,0.0,0.0,233,233,0,0,3,gene,F28C6.2,0,8594272,0.194365,1175,8592939,158,8594273,159,1
II,+,8594272,0.0,1.90735e-06,19,19,0,0,56,gene,F28C6.2,0,8594272,0.194365,1333,8592939,0,8594273,1,1
II,+,8599470,0.0,4.70198e-38,124,124,0,0,8,gene,F28C6.5,0,8599478,0.810309,3253,8596217,8,8599432,-38,-46
II,+,8602711,0.00732733,0.0,33300,33056,244,219,0,gene,F28C6.7,1,8602716,114.839,2263,8600448,5,8602711,0,-5
II,+,8603782,0.92217,0.0,424,33,391,350,195,gene,F28C6.6,2,8603784,0.939538,227,8603555,2,8603782,0,-2
II,+,8606773,0.903399,0.0,559,54,505,325,4,gene,F28C6.8,3,8606827,1.00865,108,8606665,54,8606773,0,-54
II,+,8606823,0.666667,0.375,3,1,2,0,91,gene,F28C6.8,3,8606827,1.00865,158,8606665,4,8606773,-50,-54
II,+,8647072,0.0,7.88861e-31,100,100,0,0,0,gene,D2085.7,0,8647079,0.279379,2120,8644952,7,8647070,-2,-9
II,+,8651034,0.00534759,0.0,187,186,1,1,1,gene,D2085.1,0,8651043,1.40633,2882,8648152,9,8651059,25,16
II,+,8659060,0.238095,0.00970316,21,16,5,4,2,gene,D2085.2,0,8659070,0.152389,366,8658694,10,8659071,11,1
II,+,8659065,0.223881,2.3431e-06,67,52,15,12,6,gene,D2085.2,0,8659070,0.152389,371,8658694,5,8659071,6,1
II,+,8661794,0.0,0.0,181,181,0,0,1,gene,D2085.3,1,8661803,0.506372,2069,8659725,9,8661793,-1,-10
II,+,8664758,0.929664,0.0,327,23,304,213,11,gene,D2085.4,2,8664788,0.562093,111,8664647,30,8664797,39,9
II,+,8691666,0.0,0.000976562,10,10,0,0,0,gene,C34C6.3,0,8691732,0.36696,5167,8686499,66,8691847,181,115
II,+,8691842,0.0026178,0.0,382,381,1,1,1,gene,C34C6.3,0,8691846,0.36696,5343,8686499,4,8691847,5,1
II,+,8691847,0.0,6.93889e-18,57,57,0,0,76,gene,C34C6.3,0,8691873,0.36696,5348,8686499,26,8691847,0,-26
II,+,8704749,0.00265252,0.0,377,376,1,1,0,gene,C34C6.6,0,8704749,0.602857,10649,8694100,0,8704750,1,1
II,+,8707414,0.0,0.125,3,3,0,0,80,gene,C34C6.7,0,8707443,0.482957,723,8706691,29,8707308,-106,-135
II,+,8716759,0.0138889,0.0,288,284,4,4,1,gene,T01B7.5,1,8716769,1.35661,1094,8715665,10,8716770,11,1
II,+,8718314,0.0,4.70198e-38,124,124,0,0,2,gene,T01B7.5,1,8718350,1.35661,810,8717504,36,8718314,0,-36
II,+,8722399,0.596,0.000497692,250,101,149,116,3,gene,T01B7.6,2,8722417,1.34462,789,8721610,18,8722399,0,-18
II,+,8722437,1.0,0.5,1,0,1,1,148,gene,T01B7.6,2,8722439,1.34462,827,8721610,2,8722399,-38,-40
II,+,8732975,0.0015932,0.0,1883,1880,3,3,2,gene,T01B7.7,0,8733083,3.46577,7530,8725445,108,8732975,0,-108
II,+,8744000,0.00118203,0.0,1692,1690,2,2,1,gene,K08F8.1,0,8744051,3.83032,9744,8734256,51,8744000,0,-51
II,+,8745172,0.0,0.25,2,2,0,0,9,gene,K08F8.1,0,8745187,3.83032,10916,8734256,15,8745172,0,-15
II,+,8751908,0.0,2.52435e-29,95,95,0,0,0,gene,K08F8.2,0,8752059,1.37163,4752,8747156,151,8751908,0,-151
II,+,8766697,0.0,9.53674e-07,20,20,0,0,1,gene,K08F8.5,0,8766728,0.0798297,12838,8753859,31,8767120,423,392
II,+,8767043,0.0,0.125,3,3,0,0,4,gene,K08F8.5,0,8767079,0.0798297,13184,8753859,36,8767120,77,41
II,+,8770895,0.00380228,0.0,263,262,1,0,1,gene,K08F8.6,0,8770996,0.681386,1581,8769314,101,8770895,0,-101
II,+,8784606,0.0,0.125,3,3,0,0,5,gene,F07H5.3,0,8784623,None,2666,8781940,17,8784455,-151,-168
II,+,8784676,0.0,0.000488281,11,11,0,0,466,gene,F07H5.3,0,8784728,None,2736,8781940,52,8784455,-221,-273
II,+,8786292,0.0,0.0,911,911,0,0,3,gene,F07H5.4,0,8786307,None,861,8785431,15,8786377,85,70
II,+,8786544,0.0,0.5,1,1,0,0,0,gene,F07H5.4,0,8786560,None,1113,8785431,16,8786377,-167,-183
II,+,8787689,0.00464481,0.0,3660,3643,17,15,5,gene,F07H5.5,0,8787689,None,655,8787034,0,8787690,1,1
II,+,8790483,0.0125786,1.68156e-44,159,157,2,1,3,gene,F07H5.13,0,8790501,1.08339,775,8789708,18,8790478,-5,-23
II,+,8811289,0.00246305,0.0,3654,3645,9,9,20,gene,F46C5.8,0,8811293,3.58145,6481,8804808,4,8811289,0,-4
II,+,8836090,0.0,1.81899e-12,39,39,0,0,2,gene,F46C5.4,0,8836109,0.0521583,8022,8828068,19,8836358,268,249
II,+,8836371,0.0,0.25,2,2,0,0,7,gene,F46C5.4,0,8836380,0.0521583,8303,8828068,9,8836358,-13,-22
II,+,8846145,1.0,0.5,1,0,1,1,4,gene,T14D7.1,0,8846237,1.03604,6059,8840086,92,8846145,0,-92
II,+,8884804,0.0,5.82077e-11,34,34,0,0,4,gene,T07D4.4,0,8884822,1.32809,35987,8848817,18,8884823,19,1
II,+,8884816,0.0,0.0,210,210,0,0,23,gene,T07D4.4,0,8884822,1.32809,35999,8848817,6,8884816,0,-6
II,+,8885095,0.0,0.0,170,170,0,0,7,gene,T07D4.4,0,8885121,1.32809,36278,8848817,26,8885095,0,-26
II,+,8887169,0.0,0.000244141,12,12,0,0,10,gene,T07D4.4,0,8887170,1.32809,38352,8848817,1,8887169,0,-1
II,+,8896755,0.00810185,0.0,864,857,7,6,0,gene,B0457.1,0,8896784,1.52699,7167,8889588,29,8896755,0,-29
II,+,8922352,0.0,4.76837e-07,21,21,0,0,5,gene,B0457.6,0,8922364,1.89553,13785,8908567,12,8922365,13,1
II,+,8922363,0.00428266,0.0,934,930,4,3,120,gene,B0457.6,0,8922364,1.89553,13796,8908567,1,8922365,2,1
II,+,8922372,0.0,0.0625,4,4,0,0,512,gene,B0457.6,0,8922446,1.89553,13805,8908567,74,8922365,-7,-81
II,+,8927654,0.0071568,0.0,1537,1526,11,8,3,gene,T21B10.7,1,8927657,5.09064,3369,8924285,3,8927654,0,-3
II,+,8929754,0.875467,0.0,803,100,703,470,8,gene,T21B10.1,2,8929765,1.41276,26,8929728,11,8929754,0,-11
II,+,8932019,0.0477171,0.0,5344,5089,255,197,8,gene,T21B10.2,3,8932019,14.0982,1178,8930841,0,8932019,0,0
II,+,8934295,0.115226,0.0,486,430,56,33,11,gene,T21B10.3,4,8934303,0.921217,571,8933724,8,8934295,0,-8
II,+,8940807,0.00320513,0.0,312,311,1,1,13,gene,T21B10.4,0,8940812,0.685423,1861,8938946,5,8940807,0,-5
II,+,8960627,0.00191755,0.0,1043,1041,2,2,3,gene,C18E9.1,0,8960646,0.778183,18021,8942606,19,8960647,20,1
II,+,8965041,0.0232558,4.88853e-12,43,42,1,1,762,gene,C18E9.2,0,8965086,1.70394,3559,8961482,45,8964966,-75,-120
II,+,8993081,0.00978474,0.0,511,506,5,4,0,gene,C18E9.11,1,8993084,1.29352,21203,8971878,3,8993081,0,-3
II,+,8994548,0.977083,0.0,480,11,469,244,0,gene,F44G4.1,2,8994589,1.79497,102,8994446,41,8994548,0,-41
II,+,8996265,0.953846,1.18395e-15,65,3,62,41,0,gene,F44G4.2,3,8996284,8.53458,86,8996179,19,8996276,11,-8
II,+,8996276,0.964255,0.0,2294,82,2212,1357,194,gene,F44G4.2,3,8996284,8.53458,97,8996179,8,8996276,0,-8
II,+,8997739,0.00810373,0.0,1234,1224,10,10,1,gene,F44G4.4,0,8997745,1.36291,806,8996933,6,8997739,0,-6
II,+,9054891,0.021978,1.65396e-24,91,89,2,2,129,gene,T24B8.2,0,9054891,0.960902,55257,8999634,0,9054891,0,0
II,+,9086521,0.0,0.0,297,297,0,0,1,gene,T24B8.6,0,9086523,0.480255,30104,9056417,2,9086521,0,-2
II,+,9099285,0.003,0.0,1000,997,3,2,49,gene,T24H10.1,0,9099289,1.7456,11448,9087837,4,9099290,5,1
II,+,9109453,0.00877193,5.4889e-33,114,113,1,1,1,gene,T24H10.4,0,9109487,0.830579,3792,9105661,34,9109488,35,1
II,+,9127285,0.0,7.88861e-31,100,100,0,0,866,gene,T24H10.7,1,9127324,1.598,5853,9121432,39,9127258,-27,-66
II,+,9141498,0.0,6.10352e-05,14,14,0,0,2,gene,Y9C2UA.1,0,9141545,0.715567,3171,9138327,47,9141546,48,1
II,+,9141504,0.0,0.000244141,12,12,0,0,3,gene,Y9C2UA.1,0,9141545,0.715567,3177,9138327,41,9141546,42,1
II,+,9146160,0.0,3.30872e-24,78,78,0,0,0,gene,Y9C2UA.2,0,9146172,0.113076,899,9145261,12,9146173,13,1
II,+,9147861,0.0,3.8147e-06,18,18,0,0,4,gene,W07A12.4,0,9147863,0.179469,2600,9145261,2,9148268,407,405
II,+,9158021,0.0,5.96046e-08,24,24,0,0,1,gene,W07A12.6,0,9158048,0.0206047,3798,9154223,27,9158049,28,1
II,+,9161292,0.00470588,0.0,425,423,2,2,1,gene,W07A12.7,0,9161297,0.478578,1505,9159787,5,9161292,0,-5
II,+,9169823,0.00360231,0.0,1388,1383,5,5,4,gene,T23G7.1,0,9169869,0.897829,6473,9163350,46,9169823,0,-46
II,+,9177289,0.000921659,0.0,1085,1084,1,1,539,gene,T23G7.5,0,9177296,1.32594,4809,9172480,7,9177213,-76,-83
II,+,9197432,0.0,4.44089e-16,51,51,0,0,5,gene,ZK1067.1,0,9197486,0.173649,18934,9178498,54,9197432,0,-54
II,+,9198855,0.0,0.5,1,1,0,0,2,gene,ZK1067.1,0,9198872,0.173649,20357,9178498,17,9198855,0,-17
II,+,9210290,0.0,5.96046e-08,24,24,0,0,0,gene,ZK1067.4,0,9210292,0.106182,3168,9207122,2,9210290,0,-2
II,+,9213574,0.0196078,1.01586e-27,102,100,2,2,0,gene,ZK1067.8,0,9213615,0.160315,563,9213011,41,9213616,42,1
II,+,9215127,0.0,4.44089e-16,51,51,0,0,0,gene,ZK1067.2,1,9215148,0.458393,2116,9213011,21,9215127,0,-21
II,+,9223183,0.860841,8.65162e-41,309,43,266,216,0,gene,ZK1067.3,2,9223188,0.682067,122,9223061,5,9223183,0,-5
II,+,9233137,0.00653595,1.4013e-44,153,152,1,0,2,gene,T26C5.2,0,9233152,0.446524,874,9232263,15,9233137,0,-15
II,+,9238982,0.0,7.34684e-40,130,130,0,0,1,gene,T26C5.3,0,9239017,1.39848,2860,9236122,35,9239056,74,39
II,+,9269809,0.00448833,0.0,1114,1109,5,4,6,gene,C01G6.3,0,9269852,4.15183,1561,9268248,43,9269809,0,-43
II,+,9285890,0.0110701,0.0,271,268,3,2,6,gene,C01G6.6,0,9285892,1.03817,14708,9271182,2,9285890,0,-2
II,+,9289444,0.0,0.5,1,1,0,0,0,gene,C01G6.10,0,9289480,None,404,9289040,36,9289421,-23,-59
II,+,9291932,0.0,0.0,194,194,0,0,0,gene,C01G6.7,0,9291933,0.674723,1651,9290281,1,9291932,0,-1
II,+,9319781,0.00340715,0.0,587,585,2,1,36,gene,D2013.2,0,9319793,0.982367,25780,9294001,12,9319781,0,-12
II,+,9323871,0.00327869,0.0,305,304,1,1,2,gene,D2013.10,0,9323875,0.439706,2085,9321786,4,9323876,5,1
II,+,9324790,0.00791139,0.0,632,627,5,4,1,gene,D2013.5,1,9324792,0.813531,174,9324616,2,9324790,0,-2
II,+,9329690,0.824859,0.0,708,124,584,362,1,gene,D2013.6,2,9329741,1.82789,114,9329576,51,9329690,0,-51
II,+,9331559,0.927048,0.0,1782,130,1652,989,1,gene,D2013.7,3,9331577,4.79099,103,9331456,18,9331559,0,-18
II,+,9331566,0.894737,2.55084e-16,95,10,85,68,1538,gene,D2013.7,3,9331577,4.79099,110,9331456,11,9331559,-7,-18
II,+,9333930,0.9,4.08618e-32,190,19,171,123,8,gene,D2013.8,4,9333935,0.510225,44,9333886,5,9333930,0,-5
II,+,9336885,0.0,0.25,2,2,0,0,53,gene,D2013.8,4,9336901,0.510225,2999,9333886,16,9336885,0,-16
II,+,9338913,0.922566,0.0,452,35,417,283,17,gene,D2013.9,5,9338976,1.07197,104,9338809,63,9338913,0,-63
II,+,9352916,0.00396301,0.0,757,754,3,2,1,gene,F42A8.3,0,9353012,0.474915,11606,9341310,96,9352916,0,-96
II,+,9358449,0.389722,4.01846e-07,467,285,182,137,1,gene,C06C3.1,0,9358449,1.58283,4206,9354243,0,9358450,1,1
II,+,9374998,0.0,2.38419e-07,22,22,0,0,6,gene,C06C3.12,0,9375022,None,184,9374814,24,9375023,25,1
II,+,9378449,0.0,1.16415e-10,33,33,0,0,6,gene,C06C3.11,0,9378472,None,13,9378436,23,9378473,24,1
II,+,9383294,0.0,0.125,3,3,0,0,2,gene,C06C3.6,0,9383303,0.0254338,1960,9381334,9,9383294,0,-9
II,+,9385457,0.0,4.76837e-07,21,21,0,0,2,gene,C06C3.7,0,9385463,0.0297504,544,9384913,6,9385464,7,1
II,+,9394370,0.0,0.25,2,2,0,0,1,gene,Y51B9A.10,0,9394378,None,7921,9386449,8,9394369,-1,-9
II,+,9416929,0.00557724,0.0,1793,1783,10,8,1,gene,M176.3,0,9416989,2.7077,2822,9414107,60,9416929,0,-60
II,+,9419942,0.0,0.0078125,7,7,0,0,1,gene,M176.4,1,9420061,1.34138,1710,9418232,119,9420392,450,331
II,+,9420395,0.0,5.60519e-45,147,147,0,0,1,gene,M176.4,1,9420464,1.34138,2163,9418232,69,9420395,0,-69
II,+,9422186,0.747475,1.61756e-18,297,75,222,109,1,gene,M176.11,2,9422202,0.580116,261,9421925,16,9422186,0,-16
II,+,9524089,0.0016775,0.0,9538,9522,16,16,3,gene,AH6.5,0,9524095,2.63889,640,9523449,6,9524089,0,-6
II,+,9555420,0.0,0.0,161,161,0,0,1,gene,F35H8.2,0,9555429,0.309916,3112,9552308,9,9555430,10,1
II,+,9557603,0.0,4.23516e-22,71,71,0,0,107,gene,F35H8.3,0,9557639,0.715014,156,9557447,36,9557561,-42,-78
II,+,9575886,0.0,0.0,308,308,0,0,0,gene,F35H8.5,0,9576222,0.964757,16459,9559427,336,9575886,0,-336
II,+,9592951,0.915049,0.0,412,35,377,283,1,gene,E02H1.4,2,9592960,0.860303,112,9592839,9,9592951,0,-9
II,+,9595138,0.979592,0.0,735,15,720,503,3,gene,E02H1.5,3,9595140,0.619925,96,9595042,2,9595138,0,-2
II,+,9596615,0.918981,0.0,432,35,397,302,16,gene,E02H1.6,4,9596615,0.742027,103,9596512,0,9596615,0,0
II,+,9597536,0.974359,0.0,1326,34,1292,790,7,gene,E02H1.8,5,9597538,2.05547,94,9597442,2,9597539,3,1
II,+,9624528,0.0833333,0.00292969,12,11,1,0,4,gene,ZK1307.8,0,9624553,2.46248,11177,9613351,25,9624528,0,-25
II,+,9624552,0.00198807,0.0,1006,1004,2,1,27,gene,ZK1307.8,0,9624553,2.46248,11201,9613351,1,9624552,0,-1
II,+,9636521,0.0,1.19209e-07,23,23,0,0,3,gene,ZK1307.7,0,9636542,0.0491004,9965,9626556,21,9636543,22,1
II,+,9647804,0.0130719,0.0,306,302,4,4,0,gene,ZK1307.5,1,9647818,0.739678,7749,9640055,14,9647853,49,35
II,+,9649406,0.793696,6.51114e-30,349,72,277,202,2,gene,ZK1307.9,2,9649475,0.717997,124,9649282,69,9649406,0,-69
II,+,9656526,0.0,0.125,3,3,0,0,35,gene,ZK1320.1,0,9656663,0.908852,5652,9650874,137,9656664,138,1
II,+,9656621,0.0,0.0,340,340,0,0,1,gene,ZK1320.1,0,9656663,0.908852,5747,9650874,42,9656664,43,1
II,+,9667708,0.010929,0.0,183,181,2,1,2,gene,ZK1320.11,1,9667719,0.519585,10074,9657634,11,9667708,0,-11
II,+,9669239,0.00583658,0.0,514,511,3,3,2,gene,ZK1320.12,2,9669239,0.486509,653,9668586,0,9669239,0,0
II,+,9671525,0.895604,4.42775e-30,182,19,163,103,0,gene,ZK1320.7,3,9671530,0.265413,113,9671412,5,9671531,6,1
II,+,9671530,1.0,0.5,1,0,1,1,1,gene,ZK1320.7,3,9671530,0.265413,118,9671412,0,9671531,1,1
II,+,9674893,0.935484,3.59055e-32,155,10,145,75,16,gene,ZK1320.6,4,9674895,0.366126,1719,9673174,2,9674893,0,-2
II,+,9675054,1.0,0.25,2,0,2,1,22,gene,ZK1320.6,4,9675215,0.366126,1880,9673174,161,9674893,-161,-322
II,+,9680715,0.00915033,0.0,765,758,7,4,1,gene,ZK1320.13,0,9680741,2.94159,3590,9677125,26,9680715,0,-26
II,+,9733327,0.0,0.5,1,1,0,0,0,gene,Y53C12B.5,0,9733336,0.275493,32004,9701323,9,9733337,10,1
II,+,9746632,0.0015949,0.0,1254,1252,2,2,48,gene,Y53C12B.3,0,9746648,1.6516,9220,9737412,16,9746649,17,1
II,+,9758149,0.0,2.91038e-11,35,35,0,0,0,gene,ZK1321.2,0,9758168,0.271856,3272,9754877,19,9758149,0,-19
II,+,9765341,0.0,0.000488281,11,11,0,0,0,gene,ZK1321.2,0,9765353,0.271856,10464,9754877,12,9765341,0,-12
II,+,9765344,0.0,0.015625,6,6,0,0,1,gene,ZK1321.2,0,9765353,0.271856,10467,9754877,9,9765341,-3,-12
II,+,9835132,0.0,0.5,1,1,0,0,0,gene,ZK938.4,0,9835135,0.0146983,4466,9830666,3,9835136,4,1
II,+,9881108,0.00353357,0.0,849,846,3,2,11,gene,C08H9.15,0,9881136,1.12628,3185,9877923,28,9881108,0,-28
II,+,9892693,0.0,6.93889e-18,57,57,0,0,3,gene,C08H9.16,0,9892703,None,10248,9882445,10,9892704,11,1
II,+,9895453,0.0,0.000976562,10,10,0,0,2,gene,F26C11.1,0,9895459,0.26182,1168,9894285,6,9895460,7,1
II,+,9922140,0.0,1.49012e-08,26,26,0,0,2,gene,C05C10.2,0,9922140,0.652852,24874,9897266,0,9922163,23,23
II,+,9932209,0.0,0.5,1,1,0,0,473,gene,C05C10.4,0,9932279,3.68119,1598,9930611,70,9931778,-431,-501
II,+,9940673,0.412186,6.48529e-08,837,492,345,289,74,gene,C05C10.6,2,9940675,1.33669,427,9940246,2,9940676,3,1
II,+,9944052,0.824561,2.99642e-07,57,10,47,34,15,gene,R53.1,3,9944060,0.700719,132,9943920,8,9944052,0,-8
II,+,9944069,0.622727,6.85295e-05,220,83,137,106,186,gene,R53.1,3,9944078,0.700719,149,9943920,9,9944069,0,-9
II,+,9955100,0.0,4.44089e-16,51,51,0,0,3,gene,R53.3,0,9955100,0.447943,8103,9946997,0,9955101,1,1
II,+,9960216,0.0,1.42109e-14,46,46,0,0,12,gene,R53.3,0,9960248,0.447943,13219,9946997,32,9960249,33,1
II,+,9968588,0.00617284,0.0,972,966,6,6,3,gene,R53.6,0,9968595,0.634346,5627,9962961,7,9968588,0,-7
II,+,9991284,0.00431965,0.0,1389,1383,6,2,0,gene,ZK892.1,0,9991323,2.79791,13493,9977791,39,9991284,0,-39
II,+,9993720,0.0,0.25,2,2,0,0,8,gene,ZK892.1,0,9993843,2.79791,15929,9977791,123,9993849,129,6
II,+,10030111,0.00146628,0.0,682,681,1,1,0,gene,F52H3.5,0,10030120,1.2884,20749,10009362,9,10030121,10,1
II,+,10041049,0.00660066,0.0,303,301,2,2,0,gene,F52H3.4,0,10041082,0.245897,10176,10030873,33,10041049,0,-33
II,+,10054540,0.00142248,0.0,703,702,1,1,5,gene,C18D1.3,0,10054553,1.37329,12112,10042428,13,10054540,0,-13
II,+,10094788,0.00195695,0.0,511,510,1,0,0,gene,ZK945.1,0,10094789,2.23515,35880,10058908,1,10094788,0,-1
II,+,10100225,0.0212264,0.0,424,415,9,8,1,gene,ZK945.3,0,10100243,2.33327,1525,10098700,18,10100225,0,-18
II,+,10134860,0.0,0.0,1165,1165,0,0,1,gene,F27E5.4,0,10134864,0.887374,9931,10124929,4,10134865,5,1
II,+,10137573,0.00819672,2.29456e-35,122,121,1,1,2,gene,F27E5.4,0,10137582,0.887374,1831,10135742,9,10137571,-2,-11
II,+,10139507,0.0,0.0,278,278,0,0,0,gene,F27E5.1,0,10139513,1.12974,376,10139131,6,10139514,7,1
II,+,10155327,0.0,1.49012e-08,26,26,0,0,3,gene,F33H1.6,0,10155338,0.141297,2548,10152779,11,10155339,12,1
II,+,10171185,0.00261267,0.0,1531,1527,4,3,16,gene,F33H1.2,1,10171194,2.10337,2453,10168732,9,10171185,0,-9
II,+,10172838,0.0170015,0.0,647,636,11,9,3,gene,F33H1.3,2,10172839,1.54328,432,10172406,1,10172840,2,1
II,+,10174563,0.35958,1.0355e-08,381,244,137,117,64,gene,F33H1.4,3,10174588,0.736077,305,10174258,25,10174563,0,-25
II,+,10192424,0.0,2.38419e-07,22,22,0,0,0,gene,R05H5.7,0,10192443,0.0459804,12327,10180097,19,10192444,20,1
II,+,10197526,0.0,0.25,2,2,0,0,0,gene,R05H5.3,0,10197541,7.17469,776,10196750,15,10197540,14,-1
II,+,10197540,0.0058581,0.0,4609,4582,27,26,12,gene,R05H5.3,0,10197541,7.17469,790,10196750,1,10197540,0,-1
II,+,10206639,0.0,0.0,151,151,0,0,14,gene,T01E8.1,0,10206667,0.448724,8409,10198230,28,10206639,0,-28
II,+,10218385,0.0,1.20371e-35,116,116,0,0,1,gene,T01E8.2,0,10218386,0.223842,9210,10209175,1,10218385,0,-1
II,+,10222791,0.0,0.0,184,184,0,0,0,gene,T01E8.3,0,10222791,0.198824,2852,10219939,0,10222792,1,1
II,+,10248905,0.00694444,0.0,288,286,2,0,1,gene,F54B3.3,1,10248953,1.19288,12978,10235927,48,10248904,-1,-49
II,+,10251182,0.951724,5.17532e-33,145,7,138,106,6,gene,F54B3.1,2,10251186,0.425785,98,10251084,4,10251208,26,22
II,+,10326154,0.0,3.05176e-05,15,15,0,0,19,gene,M02G9.1,0,10326207,0.353854,1395,10324759,53,10326208,54,1
II,+,10346311,0.00242718,0.0,824,822,2,2,1,gene,C07E3.10,0,10346315,0.72323,10590,10335721,4,10346311,0,-4
II,+,10350676,0.0,0.0,616,616,0,0,3,gene,C07E3.9,0,10350776,0.868311,3757,10346919,100,10350676,0,-100
II,+,10385247,0.0015625,0.0,640,639,1,1,18,gene,T09F3.1,1,10385266,0.649124,22339,10362908,19,10385247,0,-19
II,+,10391068,0.00506073,0.0,988,983,5,5,0,gene,T09F3.2,2,10391274,1.33774,3021,10388047,206,10391068,0,-206
II,+,10394043,0.00291121,0.0,2748,2740,8,8,15,gene,T09F3.3,3,10394050,0.434303,517,10393526,7,10394043,0,-7
II,+,10395630,0.522222,0.0768107,90,43,47,36,104,gene,T09F3.4,4,10395651,0.288133,370,10395260,21,10395652,22,1
II,+,10396792,0.909639,8.5324e-30,166,15,151,122,2,gene,T09F3.5,5,10396868,0.282876,92,10396700,76,10396792,0,-76
II,+,10411477,0.0714286,1.40816e-06,28,26,2,1,43,gene,E04D5.5,0,10411508,0.270659,12243,10399234,31,10411203,-274,-305
II,+,10416720,0.00263257,0.0,2659,2652,7,6,29,gene,E04D5.1,0,10416750,3.18633,4137,10412583,30,10416720,0,-30
II,+,10436055,0.0,3.55271e-15,48,48,0,0,0,gene,E04D5.3,0,10436057,0.413304,16904,10419151,2,10436058,3,1
II,+,10441652,0.0,0.25,2,2,0,0,0,gene,E04D5.4,0,10441666,0.23292,1505,10440147,14,10441667,15,1
II,+,10443315,0.0,6.10352e-05,14,14,0,0,103,gene,ZK673.1,0,10443526,0.53916,886,10442429,211,10443241,-74,-285
II,+,10444131,0.0,0.5,1,1,0,0,0,gene,ZK673.1,0,10444145,0.53916,1702,10442429,14,10444146,15,1
II,+,10448157,0.0,0.000976562,10,10,0,0,0,gene,ZK673.2,1,10448190,3.17408,3076,10445081,33,10448180,23,-10
II,+,10448180,0.0,0.0,968,968,0,0,14,gene,ZK673.2,1,10448190,3.17408,3099,10445081,10,10448180,0,-10
II,+,10450201,1.0,0.5,1,0,1,1,26,gene,ZK673.3,2,10450487,0.462258,64,10450137,286,10450588,387,101
II,+,10450482,0.85,3.49099e-06,40,6,34,20,2,gene,ZK673.3,2,10450487,0.462258,345,10450137,5,10450588,106,101
II,+,10452834,0.0,2.32831e-10,32,32,0,0,0,gene,ZK673.4,0,10452858,0.147084,916,10451918,24,10452834,0,-24
II,+,10457195,0.0,0.0625,4,4,0,0,4,gene,ZK673.13,0,10457239,None,2088,10455107,44,10457160,-35,-79
II,+,10459493,0.0,0.000244141,12,12,0,0,4,gene,ZK673.11,0,10459510,0.0756549,4386,10455107,17,10459493,0,-17
II,+,10496113,0.0,1.52588e-05,16,16,0,0,0,gene,ZK666.12,0,10496125,0.0333915,528,10495585,12,10496126,13,1
II,+,10530251,0.0,8.07794e-28,90,90,0,0,1,gene,R166.1,0,10530335,0.244535,17364,10512887,84,10530336,85,1
II,+,10579288,0.00506625,0.0,5132,5106,26,24,1,gene,C06A1.5,1,10579294,4.55844,5306,10573982,6,10579281,-7,-13
II,+,10579870,0.00269906,0.0,741,739,2,1,4,gene,C14A4.1,2,10579892,3.34802,61,10579809,22,10579870,0,-22
II,+,10581048,0.938559,0.0,472,29,443,263,45,gene,C14A4.2,3,10581048,1.17469,73,10580975,0,10581048,0,0
II,+,10581055,1.0,0.125,3,0,3,1,264,gene,C14A4.2,3,10581069,1.17469,80,10580975,14,10581048,-7,-21
II,+,10582533,0.927168,0.0,865,63,802,521,3,gene,C14A4.14,4,10582544,1.09519,93,10582440,11,10582533,0,-11
II,+,10582539,0.8,0.0439453,10,2,8,5,1429,gene,C14A4.14,4,10582544,1.09519,99,10582440,5,10582533,-6,-11
II,+,10584251,0.960168,0.0,477,19,458,341,1,gene,C14A4.3,5,10584258,0.772236,102,10584149,7,10584259,8,1
II,+,10587957,0.891156,0.0,294,32,262,174,10,gene,C14A4.4,6,10587957,0.856945,1,10587956,0,10587957,0,0
II,+,10587965,1.0,0.25,2,0,2,2,250,gene,C14A4.4,6,10587975,0.856945,9,10587956,10,10587957,-8,-18
II,+,10592667,0.970213,0.0,235,7,228,172,2,gene,C14A4.5,7,10592676,0.748109,100,10592567,9,10592672,5,-4
II,+,10599252,0.00295223,0.0,3726,3715,11,7,34,gene,C14A4.9,0,10599259,1.43866,5807,10593445,7,10599252,0,-7
II,+,10613109,0.0,5.87747e-39,127,127,0,0,1,gene,C14A4.12,0,10613115,0.319677,12631,10600478,6,10612935,-174,-180
II,+,10628178,0.0,0.0,345,345,0,0,0,gene,M28.8,0,10628183,0.363175,2320,10625858,5,10628184,6,1
II,+,10647343,0.0,0.00390625,8,8,0,0,10,gene,M28.10,0,10647377,3.14634,468,10646875,34,10647431,88,54
II,+,10647431,0.000999001,0.0,2002,2000,2,1,2,gene,M28.10,0,10647498,3.14634,556,10646875,67,10647431,0,-67
II,+,10659123,0.014881,0.0,336,331,5,5,0,gene,D2089.1,0,10659124,1.79516,10532,10648591,1,10659123,0,-1
II,+,10675517,0.0,3.63798e-12,38,38,0,0,0,gene,D2089.4,0,10675572,0.766973,13308,10662209,55,10675517,0,-55
II,+,10686270,0.0,7.17465e-43,140,140,0,0,3,gene,D2089.4,0,10686384,0.766973,24061,10662209,114,10686270,0,-114
II,+,10708875,0.0,0.0,183,183,0,0,11,gene,C09G5.6,0,10708928,0.592605,675,10708200,53,10708875,0,-53
II,+,10714803,0.0,9.31323e-10,30,30,0,0,1,gene,C09G5.7,0,10714827,0.0855857,2733,10712070,24,10714828,25,1
II,+,10785367,0.00252908,0.0,1977,1972,5,5,5,gene,R06F6.1,0,10785383,3.86853,46075,10739292,16,10785367,0,-16
II,+,10787113,0.0,0.5,1,1,0,0,501,gene,R06F6.11,0,10787134,4.7759,45,10787068,21,10787280,167,146
II,+,10820946,0.00176056,0.0,1704,1701,3,3,18,gene,R06F6.9,0,10820946,2.5179,8843,10812103,0,10820946,0,0
II,+,10824287,0.0,1.49012e-08,26,26,0,0,205,gene,M106.1,0,10824298,1.15764,1897,10822390,11,10824210,-77,-88
II,+,10869111,0.00530973,0.0,1695,1686,9,8,0,gene,M106.5,0,10869145,2.61113,27779,10841332,34,10869111,0,-34
II,+,10872772,0.0,0.5,1,1,0,0,4,gene,F59E10.3,1,10872826,5.8153,1370,10871402,54,10872804,32,-22
II,+,10872794,0.0117257,0.0,3923,3877,46,33,34,gene,F59E10.3,1,10872826,5.8153,1392,10871402,32,10872804,10,-22
II,+,10873846,0.917808,1.37983e-27,146,12,134,97,0,gene,F59E10.1,2,10873848,0.681877,145,10873701,2,10873846,0,-2
II,+,10880912,0.0103093,6.12156e-28,97,96,1,0,64,gene,F44F4.1,0,10880963,0.267513,3102,10877810,51,10880843,-69,-120
II,+,10889194,0.0,4.93038e-32,104,104,0,0,1,gene,F44F4.4,0,10889199,0.365861,6890,10882304,5,10889194,0,-5
II,+,10918621,0.00701754,0.0,570,566,4,3,8,gene,F44F4.11,0,10918632,2.12208,3418,10915203,11,10918621,0,-11
II,+,10926476,0.00376648,0.0,1593,1587,6,6,0,gene,R03D7.1,0,10926478,1.75392,1776,10924700,2,10926476,0,-2
II,+,10975296,0.0,0.00195312,9,9,0,0,0,gene,C09D8.1,0,10975422,1.30882,23778,10951518,126,10975454,158,32
II,+,10982946,0.0,3.05176e-05,15,15,0,0,0,gene,C09D8.1,0,10982953,1.30882,31428,10951518,7,10982986,40,33
II,+,10993423,0.0,0.0,516,516,0,0,8,gene,C09D8.1,0,10993432,1.30882,7393,10986030,9,10993423,0,-9
II,+,11002896,0.0,3.8147e-06,18,18,0,0,2,gene,C09D8.1,0,11002898,1.30882,16866,10986030,2,11002896,0,-2
II,+,11022286,0.00558659,0.0,895,890,5,5,1,gene,F33A8.1,0,11022289,1.05262,10123,11012163,3,11022286,0,-3
II,+,11022290,0.0,0.03125,5,5,0,0,1,gene,F33A8.1,0,11022402,1.05262,10127,11012163,112,11022286,-4,-116
II,+,11050174,0.0,2.40741e-35,115,115,0,0,1,gene,F33A8.6,0,11050176,0.17098,10899,11039275,2,11050177,3,1
II,+,11097718,0.0,0.5,1,1,0,0,4,gene,C09H10.3,0,11097761,6.03496,3948,11093770,43,11097762,44,1
II,+,11097760,0.00888889,0.0,1350,1338,12,12,1,gene,C09H10.3,0,11097761,6.03496,3990,11093770,1,11097762,2,1
II,+,11106535,0.0060024,0.0,833,828,5,5,17,gene,C09H10.6,1,11106552,2.19484,507,11106028,17,11106539,4,-13
II,+,11108078,0.875,1.03417e-13,88,11,77,64,5,gene,C09H10.7,2,11108104,0.81399,64,11108014,26,11108141,63,37
II,+,11126867,0.0049054,0.0,1427,1420,7,6,1,gene,F40F8.9,1,11126869,1.56567,6151,11120716,2,11126867,0,-2
II,+,11127485,0.0,0.0625,4,4,0,0,3,gene,F40F8.1,2,11127489,2.31093,40,11127445,4,11127562,77,73
II,+,11127553,0.913436,0.0,1109,96,1013,763,39,gene,F40F8.1,2,11127580,2.31093,108,11127445,27,11127562,9,-18
II,+,11128298,0.378378,0.0104381,74,46,28,25,9,gene,F40F8.1,2,11128404,2.31093,738,11127560,106,11128298,0,-106
II,+,11129605,0.875,0.03125,8,1,7,5,68,gene,F40F8.3,3,11129612,0.627917,417,11129188,7,11129206,-399,-406
II,+,11145760,0.0,0.25,2,2,0,0,0,gene,F40F8.8,0,11145866,0.123855,14948,11130812,106,11145760,0,-106
II,+,11147434,0.0,2.71051e-20,65,65,0,0,1,gene,F40F8.8,0,11147454,0.123855,16622,11130812,20,11147434,0,-20
II,+,11181376,0.0,0.000488281,11,11,0,0,4,gene,F37H8.3,0,11181377,0.261529,5111,11176265,1,11181570,194,193
II,+,11181570,0.0,0.0,172,172,0,0,0,gene,F37H8.3,0,11181576,0.261529,5305,11176265,6,11181570,0,-6
II,+,11203132,0.0,0.0,162,162,0,0,0,gene,T06D8.1,0,11203251,1.37668,13779,11189353,119,11203733,601,482
II,+,11222215,0.0103448,0.0,290,287,3,1,0,gene,T06D8.3,0,11222260,0.809875,1665,11220550,45,11222222,7,-38
II,+,11239628,0.00695322,0.0,1582,1571,11,10,6,gene,T06D8.9,0,11239659,2.38445,2814,11236814,31,11239628,0,-31
II,+,11269034,0.000306937,0.0,3258,3257,1,0,1,gene,C47G2.1,0,11269103,5.93815,10616,11258418,69,11269034,0,-69
II,+,11281878,0.0,1.50463e-36,119,119,0,0,2,gene,C47G2.2,0,11281904,0.359277,10299,11271579,26,11281896,18,-8
II,+,11294322,0.0,1.61559e-27,89,89,0,0,2,gene,C47G2.6,0,11294354,None,10457,11283865,32,11293907,-415,-447
II,+,11297610,0.00227531,0.0,1758,1754,4,3,251,gene,C47G2.5,1,11297645,1.3138,954,11296656,35,11297610,0,-35
II,+,11301269,0.907643,0.0,628,58,570,370,2,gene,T24F1.1,2,11301273,2.34434,105,11301164,4,11301269,0,-4
II,+,11302801,0.959016,0.0,366,15,351,261,0,gene,T24F1.2,3,11302865,0.963015,43,11302758,64,11302801,0,-64
II,+,11306309,0.0321101,0.0,218,211,7,6,1,gene,T24F1.3,4,11306319,0.694021,719,11305590,10,11306309,0,-10
II,+,11308878,0.0,5.73972e-42,137,137,0,0,1,gene,T24F1.3,4,11308932,0.694021,3288,11305590,54,11308878,0,-54
II,+,11348390,0.0,0.0,188,188,0,0,49,gene,B0491.1,1,11348401,0.550965,35134,11313256,11,11348340,-50,-61
II,+,11350102,0.969828,0.0,232,7,225,174,0,gene,B0491.7,2,11350195,0.685774,136,11349966,93,11350102,0,-93
II,+,11365302,0.0,0.00195312,9,9,0,0,0,gene,B0491.8,0,11365305,0.152499,14019,11351283,3,11365302,0,-3
II,+,11410025,0.0106383,4.74579e-27,94,93,1,0,23,gene,C05D12.7,0,11410102,0.339724,25527,11384498,77,11410108,83,6
II,+,11410053,0.0,0.0625,4,4,0,0,181,gene,C05D12.7,0,11410102,0.339724,25555,11384498,49,11410108,55,6
II,+,11418215,0.0,1.52588e-05,16,16,0,0,0,gene,C05D12.2,0,11418222,0.0583897,6027,11412188,7,11418223,8,1
II,+,11425178,0.0172414,8.02872e-32,116,114,2,2,47,gene,C05D12.3,0,11425189,0.997702,792,11424386,11,11425178,0,-11
II,+,11430440,1.0,0.5,1,0,1,1,0,gene,C05D12.4,0,11430489,0.22211,185,11430255,49,11430440,0,-49
II,+,11431777,0.0,2.32831e-10,32,32,0,0,2,gene,C05D12.4,0,11431792,0.22211,1522,11430255,15,11431777,0,-15
II,+,11434132,0.0,7.17465e-43,140,140,0,0,0,gene,C05D12.5,0,11434150,0.0854654,1457,11432675,18,11434151,19,1
II,+,11442634,0.0040282,0.0,993,989,4,4,56,gene,VW02B12L.3,1,11442646,2.2644,7767,11434867,12,11442634,0,-12
II,+,11444056,0.0,0.25,2,2,0,0,0,gene,VW02B12L.4,2,11444078,1.18554,146,11443910,22,11444071,15,-7
II,+,11444071,0.809179,5.09059e-39,414,79,335,238,31,gene,VW02B12L.4,2,11444078,1.18554,161,11443910,7,11444071,0,-7
II,+,11453889,0.00626305,0.0,1916,1904,12,10,48,gene,W02B12.3,0,11453889,3.56791,2487,11451402,0,11453889,0,0
II,+,11464795,0.0,5.96046e-08,24,24,0,0,7,gene,W02B12.8,0,11464805,0.969531,2634,11462161,10,11464803,8,-2
II,+,11464803,0.00458015,0.0,655,652,3,2,23,gene,W02B12.8,0,11464805,0.969531,2642,11462161,2,11464803,0,-2
II,+,11473966,0.00558659,0.0,358,356,2,0,2,gene,W02B12.11,0,11473972,1.10236,5393,11468573,6,11473966,0,-6
II,+,11495601,0.00511509,0.0,782,778,4,4,7,gene,B0334.4,1,11495611,2.06691,6159,11489442,10,11495601,0,-10
II,+,11496689,0.881637,0.0,904,107,797,577,1,gene,B0334.5,2,11496750,1.36477,117,11496572,61,11496689,0,-61
II,+,11510584,0.0,8.07794e-28,90,90,0,0,8,gene,B0334.6,0,11510641,0.161414,11009,11499575,57,11510584,0,-57
II,+,11545610,0.0155902,0.0,449,442,7,3,3,gene,F54D5.8,1,11545622,4.27875,22508,11523102,12,11545610,0,-12
II,+,11547271,0.0,0.5,1,1,0,0,3,gene,F54D5.7,2,11547360,2.15095,5,11547266,89,11547390,119,30
II,+,11547304,0.0,0.015625,6,6,0,0,2,gene,F54D5.7,2,11547360,2.15095,38,11547266,56,11547390,86,30
II,+,11547426,0.728,1.10888e-07,125,34,91,53,531,gene,F54D5.7,2,11547433,2.15095,160,11547266,7,11547426,0,-7
II,+,11569725,0.00152339,0.0,4595,4588,7,7,1,gene,F54D5.4,0,11569725,6.3311,11054,11558671,0,11569725,0,0
II,+,11571712,0.00319978,0.0,7188,7165,23,18,78,gene,F54D5.3,0,11571712,17.8436,805,11570907,0,11571712,0,0
II,+,11578623,0.0111732,0.0,358,354,4,4,0,gene,F54D5.14,1,11578626,0.833708,3728,11574895,3,11578623,0,-3
II,+,11582756,0.94,3.80032e-42,200,12,188,151,1,gene,D1043.1,2,11582756,0.63925,113,11582643,0,11582755,-1,-1
II,+,11603863,0.0,0.0,260,260,0,0,1,gene,F07A11.4,0,11603863,0.579045,15422,11588441,0,11603863,0,0
II,+,11646656,0.0,1.61559e-27,89,89,0,0,0,gene,ZK20.1,0,11646708,0.265037,4969,11641687,52,11646656,0,-52
II,+,11653033,0.0029656,0.0,1686,1681,5,5,4,gene,ZK20.5,0,11653035,3.63007,3985,11649048,2,11653033,0,-2
II,+,11676215,0.0160772,0.0,311,306,5,3,0,gene,C47D12.2,0,11676218,1.57065,22114,11654101,3,11676215,0,-3
II,+,11688860,0.0,1.69407e-21,69,69,0,0,0,gene,C47D12.7,1,11688878,0.176958,6107,11682753,18,11688879,19,1
II,+,11696080,0.790244,7.11579e-18,205,43,162,123,0,gene,C47D12.8,2,11696137,0.389885,109,11695971,57,11696080,0,-57
II,+,11705853,0.0,0.5,1,1,0,0,2,gene,VF13D12L.3,3,11705855,1.49961,591,11705262,2,11705900,47,45
II,+,11705920,0.704545,3.43149e-10,220,65,155,119,30,gene,VF13D12L.3,3,11705955,1.49961,658,11705262,35,11705900,-20,-55
II,+,11725031,0.0,6.10352e-05,14,14,0,0,2,gene,F13D12.2,0,11725098,3.67022,2800,11722231,67,11725234,203,136
II,+,11725234,0.0033557,0.0,894,891,3,3,1,gene,F13D12.2,0,11725234,3.67022,3003,11722231,0,11725234,0,0
II,+,11726723,0.0,0.0,171,171,0,0,2,gene,F13D12.5,0,11726725,0.587636,284,11726439,2,11726726,3,1
II,+,11728964,0.0336611,0.0,7932,7665,267,224,654,gene,F13D12.4,0,11728987,22.2931,548,11728416,23,11728964,0,-23
II,+,11778346,0.0232558,5.60519e-45,172,168,4,3,2,gene,F43G6.1,0,11778356,0.439082,4310,11774036,10,11778346,0,-10
II,+,11782876,0.0,0.0625,4,4,0,0,0,gene,F43G6.3,0,11782895,0.243511,754,11782122,19,11782896,20,1
II,+,11790670,0.0017094,0.0,585,584,1,0,7,gene,F43G6.4,0,11790671,0.484573,6484,11784186,1,11790668,-2,-3
II,+,11798409,0.0,0.5,1,1,0,0,0,gene,F43G6.11,0,11798503,0.280737,1195,11797214,94,11798946,537,443
II,+,11798946,0.0,0.0,253,253,0,0,1,gene,F43G6.11,0,11798967,0.280737,1732,11797214,21,11798946,0,-21
II,+,11809258,0.166667,0.0161133,12,10,2,2,5,gene,F43G6.10,0,11809263,1.05326,482,11808776,5,11809264,6,1
II,+,11810699,0.0,0.03125,5,5,0,0,7,gene,F43G6.7,0,11810704,1.04105,483,11810216,5,11810705,6,1
II,+,11843164,0.0,0.0,498,498,0,0,18,gene,T27D12.1,0,11843167,2.06106,355,11842809,3,11843164,0,-3
II,+,11860938,0.011236,1.43787e-25,89,88,1,1,15,gene,K12D12.5,0,11860946,0.269478,15003,11845935,8,11860947,9,1
II,+,11868446,0.0,0.0,446,446,0,0,10,gene,K12D12.3,0,11868453,5.64101,5017,11863429,7,11868454,8,1
II,+,11875056,0.00314961,0.0,2540,2532,8,8,2,gene,K12D12.1,0,11875065,2.52353,5462,11869594,9,11875066,10,1
II,+,11907610,0.0,0.125,3,3,0,0,0,gene,ZK930.4,0,11907664,0.262762,21100,11886510,54,11907691,81,27
II,+,11916422,0.00880626,0.0,1022,1013,9,8,2,gene,Y17G7A.1,0,11916422,3.05946,1091,11915331,0,11916422,0,0
II,+,11954417,0.0,1.81899e-12,39,39,0,0,1,gene,W03C9.6,0,11954425,0.235694,5034,11949383,8,11954417,0,-8
II,+,11962265,0.0,1.52588e-05,16,16,0,0,0,gene,W03C9.2,0,11962281,0.497793,197,11962068,16,11962243,-22,-38
II,+,11962282,0.0454545,2.02865e-40,176,168,8,7,103,gene,W03C9.2,0,11962286,0.497793,214,11962068,4,11962243,-39,-43
II,+,11968545,0.0104058,0.0,961,951,10,8,1,gene,W03C9.7,0,11968556,2.43065,3379,11965166,11,11968545,0,-11
II,+,11980379,0.0,0.0,292,292,0,0,32,gene,Y17G7B.2,1,11980382,1.00582,8110,11972269,3,11980383,4,1
II,+,11988932,0.769565,3.00285e-17,230,53,177,130,1,gene,Y17G7B.3,2,11988943,0.210097,51,11988881,11,11988932,0,-11
II,+,11992909,0.883117,3.59684e-35,231,27,204,143,2,gene,Y17G7B.4,3,11992922,0.538346,952,11991957,13,11992916,7,-6
II,+,11999113,0.0,0.0078125,7,7,0,0,1,gene,Y17G7B.23,0,11999125,0.126984,1196,11997917,12,11999168,55,43
II,+,12021209,0.0,9.53674e-07,20,20,0,0,2,gene,Y17G7B.6,1,12021220,0.0771118,19879,12001330,11,12021221,12,1
II,+,12023769,0.012987,0.0,1232,1216,16,14,66,gene,Y17G7B.12,2,12023773,0.507911,2,12023767,4,12023769,0,-4
II,+,12042818,0.0,7.52316e-37,120,120,0,0,3,gene,Y17G7B.13,1,12042889,0.514225,17148,12025670,71,12042818,0,-71
II,+,12049491,0.959184,7.08408e-35,147,6,141,99,1,gene,Y17G7B.10,2,12049604,1.21255,323,12049168,113,12049491,0,-113
II,+,12054221,0.0,0.0,294,294,0,0,2,gene,Y17G7B.10,2,12054272,1.21255,441,12053780,51,12054221,0,-51
II,+,12054601,0.0,0.00195312,9,9,0,0,22,gene,Y17G7B.10,2,12054756,1.21255,821,12053780,155,12054601,0,-155
II,+,12055421,0.0,0.125,3,3,0,0,1,gene,Y17G7B.10,2,12055425,1.21255,1641,12053780,4,12055421,0,-4
II,+,12064982,0.0,0.000244141,12,12,0,0,0,gene,Y17G7B.14,0,12064992,0.00989247,5209,12059773,10,12064875,-107,-117
II,+,12068007,0.0,0.00390625,8,8,0,0,3,gene,Y17G7B.22,0,12068007,0.0441932,477,12067530,0,12068007,0,0
II,+,12147279,1.0,0.5,1,0,1,1,2,gene,Y57A10A.2,2,12147390,0.165457,124,12147155,111,12147711,432,321
II,+,12147541,1.0,0.00195312,9,0,9,7,3,gene,Y57A10A.2,2,12147548,0.165457,386,12147155,7,12147711,170,163
II,+,12147701,0.888889,8.57181e-07,36,4,32,28,8,gene,Y57A10A.2,2,12147710,0.165457,546,12147155,9,12147711,10,1
II,+,12147708,0.5,0.5,2,1,1,0,46,gene,Y57A10A.2,2,12147710,0.165457,553,12147155,2,12147711,3,1
II,+,12147772,1.0,0.125,3,0,3,3,16,gene,Y57A10A.2,2,12147791,0.165457,617,12147155,19,12147711,-61,-80
II,+,12150800,0.260417,9.48816e-07,96,71,25,23,0,gene,Y57A10A.3,3,12150825,0.230674,688,12150112,25,12150800,0,-25
II,+,12156822,1.0,0.125,3,0,3,3,0,gene,Y57A10A.6,6,12156847,None,102,12156720,25,12156848,26,1
II,+,12159380,1.0,0.5,1,0,1,1,2,gene,Y57A10A.7,7,12159383,0.0408483,250,12159130,3,12159391,11,8
II,+,12164747,0.242718,5.55925e-08,103,78,25,16,0,gene,Y57A10A.8,8,12164754,0.242705,2180,12162567,7,12164747,0,-7
II,+,12185898,0.0,7.62939e-06,17,17,0,0,67,gene,Y57A10A.14,0,12185943,0.464698,7169,12178729,45,12185915,17,-28
II,+,12185929,0.0,0.0625,4,4,0,0,152,gene,Y57A10A.14,0,12185943,0.464698,7200,12178729,14,12185915,-14,-28
II,+,12225264,0.00931414,0.0,1181,1170,11,10,1,gene,Y57A10A.19,1,12225265,1.12875,16260,12209004,1,12225266,2,1
II,+,12228213,0.846154,4.85218e-09,65,10,55,43,3,gene,Y57A10A.20,2,12228226,0.167276,100,12228113,13,12228227,14,1
II,+,12228223,1.0,0.000244141,12,0,12,10,201,gene,Y57A10A.20,2,12228226,0.167276,110,12228113,3,12228227,4,1
II,+,12240262,0.0,0.00390625,8,8,0,0,2,gene,Y57A10A.23,3,12240294,8.44839,3081,12237181,32,12240295,33,1
II,+,12240295,0.00140845,0.0,7100,7090,10,8,10,gene,Y57A10A.23,3,12240424,8.44839,3114,12237181,129,12240295,0,-129
II,+,12264076,0.0,1.90735e-06,19,19,0,0,56,gene,Y57A10A.26,0,12264104,2.93451,16541,12247535,28,12264073,-3,-31
II,+,12264099,0.00151057,0.0,1986,1983,3,2,134,gene,Y57A10A.26,0,12264104,2.93451,16564,12247535,5,12264099,0,-5
II,+,12279599,0.00433839,0.0,461,459,2,2,3,gene,Y57A10A.29,1,12279615,0.894212,13590,12266009,16,12279599,0,-16
II,+,12280570,0.2,0.0439453,10,8,2,1,0,gene,Y57A10A.30,2,12280586,0.245259,68,12280502,16,12280570,0,-16
II,+,12283268,0.0,4.70198e-38,124,124,0,0,4,gene,Y57A10A.30,2,12283270,0.245259,2464,12280804,2,12283268,0,-2
II,+,12289293,0.0535714,0.0,504,477,27,20,0,gene,Y57A10A.31,0,12289312,0.676836,5252,12284041,19,12289313,20,1
II,+,12303420,0.0,0.125,3,3,0,0,0,gene,C50E10.11,0,12303432,0.00231258,2938,12300482,12,12303433,13,1
II,+,12318732,0.0,0.25,2,2,0,0,0,gene,C50E10.9,0,12318748,0.000630789,5119,12313613,16,12318749,17,1
II,+,12329196,0.0,0.25,2,2,0,0,0,gene,C50E10.7,0,12329201,0.00112942,1774,12327422,5,12329202,6,1
II,+,12339852,0.0,0.0,354,354,0,0,6,gene,C50E10.4,0,12339853,0.685646,1851,12338001,1,12339852,0,-1
II,+,12388189,0.0,0.25,2,2,0,0,0,gene,Y57A10B.5,0,12388200,0.000798474,3586,12384603,11,12388201,12,1
II,+,12445236,0.0,4.65661e-10,31,31,0,0,2,gene,W05H5.3,0,12445239,0.0157592,40400,12404836,3,12445240,4,1
II,+,12459678,0.0198676,1.97049e-40,151,148,3,3,1,gene,F15A4.11,1,12459691,0.63821,260,12459418,13,12459680,2,-11
II,+,12460560,0.959239,0.0,736,30,706,372,1,gene,F15A4.12,2,12460563,1.23681,100,12460460,3,12460560,0,-3
II,+,12490112,0.0,1.49012e-08,26,26,0,0,3,gene,T21B4.15,0,12490121,0.103198,5916,12484196,9,12490112,0,-9
II,+,12520119,0.0,0.03125,5,5,0,0,3,gene,T21B4.17,0,12520119,0.0659124,10076,12510043,0,12520120,1,1
II,+,12535663,0.0,0.015625,6,6,0,0,0,gene,F49C5.4,0,12535667,0.0142186,2778,12532885,4,12535668,5,1
II,+,12555258,0.0,0.5,1,1,0,0,0,gene,F49C5.11,0,12555283,0.0964312,6937,12548321,25,12555272,14,-11
II,+,12555794,0.0,1.73472e-18,59,59,0,0,0,gene,F49C5.11,0,12555816,0.0964312,7473,12548321,22,12555794,0,-22
II,+,12564084,0.0,0.25,2,2,0,0,0,gene,F49C5.6,0,12564090,0.00122153,7081,12557003,6,12564091,7,1
II,+,12640575,0.0,5.55112e-17,54,54,0,0,1,gene,Y38E10A.19,0,12640605,0.0462057,2182,12638393,30,12640606,31,1
II,+,12654629,0.0,2.38419e-07,22,22,0,0,2,gene,Y38E10A.20,0,12654656,0.0422996,11851,12642778,27,12654657,28,1
II,+,12678937,0.00430828,0.0,8356,8320,36,29,81,gene,Y38E10A.24,0,12678937,10.9902,6234,12672703,0,12678937,0,0
II,+,12679856,0.00508906,0.0,393,391,2,1,22,gene,Y46G5A.2,0,12679876,0.341791,550,12679306,20,12679856,0,-20
II,+,12694313,0.543933,0.020548,239,109,130,88,1,gene,Y46G5A.1,0,12694330,0.71674,7637,12686676,17,12694313,0,-17
II,+,12715574,0.0131579,1.00585e-21,76,75,1,0,7,gene,Y46G5A.1,0,12715603,0.71674,8801,12706773,29,12715607,33,4
II,+,12760698,0.0,2.27374e-13,42,42,0,0,0,gene,Y46G5A.10,0,12760721,0.24454,3120,12757578,23,12760698,0,-23
II,+,12768628,0.0047619,0.0,210,209,1,1,76,gene,Y46G5A.13,0,12768643,0.442524,1509,12767119,15,12768644,16,1
II,+,12806803,0.0,0.0,455,455,0,0,51,gene,Y46G5A.19,0,12806809,0.747783,25196,12781607,6,12806803,0,-6
II,+,12810998,0.0,2.38419e-07,22,22,0,0,45,gene,Y46G5A.20,0,12811003,0.583688,225,12810773,5,12810940,-58,-63
II,+,12850333,0.0,1.4013e-45,149,149,0,0,0,gene,Y46G5A.28,0,12850353,0.110724,17747,12832586,20,12850336,3,-17
II,+,12856102,0.0,5.29396e-23,74,74,0,0,0,gene,Y46G5A.29,0,12856121,0.198488,4248,12851854,19,12856097,-5,-24
II,+,12885176,0.0,3.63798e-12,38,38,0,0,3,gene,F35C5.2,0,12885177,0.0208358,3303,12881873,1,12885178,2,1
II,+,12895540,0.00393509,0.0,32782,32653,129,82,240,gene,F35C5.6,0,12895541,45.7888,3573,12891967,1,12895540,0,-1
II,+,12898144,0.0,3.8147e-06,18,18,0,0,0,gene,F35C5.7,0,12898154,0.0894884,756,12897388,10,12898192,48,38
II,+,12898190,0.0,0.25,2,2,0,0,5,gene,F35C5.7,0,12898191,0.0894884,802,12897388,1,12898192,2,1
II,+,12901227,0.0,0.125,3,3,0,0,58,gene,F35C5.8,0,12901233,3.28948,924,12900303,6,12901227,0,-6
II,+,12919455,0.00595238,0.0,840,835,5,5,9,gene,F58G1.1,0,12919478,0.505713,9237,12910218,23,12919479,24,1
II,+,12930434,0.0,0.015625,6,6,0,0,0,gene,F58G1.4,0,12930531,8.57355,5247,12925187,97,12930519,85,-12
II,+,12931775,0.00357846,0.0,5589,5569,20,17,16,gene,F58G1.4,0,12931775,8.57355,6588,12925187,0,12931775,0,0
II,+,12954866,0.00653595,1.4013e-44,153,152,1,1,7,gene,Y38F1A.2,0,12954881,0.345959,11031,12943835,15,12954882,16,1
II,+,12965448,0.0,0.0,186,186,0,0,0,gene,Y38F1A.3,0,12965469,0.73821,7528,12957920,21,12965470,22,1
II,+,12988125,0.00520833,0.0,192,191,1,1,1,gene,Y38F1A.5,0,12988177,0.744353,10057,12978068,52,12988125,0,-52
II,+,13056996,0.0,5.16988e-26,84,84,0,0,0,gene,F42G4.3,0,13057052,5.18282,6294,13050702,56,13056996,0,-56
II,+,13064787,0.00344828,0.0,580,578,2,1,4,gene,F42G4.3,0,13064802,5.18282,14085,13050702,15,13064787,0,-15
II,+,13073390,0.0,0.0078125,7,7,0,0,16,gene,F42G4.5,0,13073443,0.313076,1956,13071434,53,13073444,54,1
II,+,13078881,0.0,0.0625,4,4,0,0,1,gene,F42G4.6,0,13078976,0.0329731,2757,13076124,95,13079317,436,341
II,+,13084067,0.00261097,0.0,383,382,1,0,0,gene,Y81G3A.3,0,13084069,0.410833,3433,13080634,2,13084070,3,1
II,+,13107920,0.0,0.0,545,545,0,0,4,gene,F29C12.1,0,13107923,2.53055,13778,13094142,3,13107920,0,-3
II,+,13117384,0.00416089,0.0,721,718,3,2,0,gene,F29C12.4,0,13117393,1.34055,7284,13110100,9,13117384,0,-9
II,+,13122927,0.125,0.03125,8,7,1,1,0,gene,F29C12.5,0,13122938,0.0242574,1010,13121917,11,13122939,12,1
II,+,13129802,0.0357143,1.04308e-07,28,27,1,1,0,gene,F29C12.6,0,13129802,0.0360166,5112,13124690,0,13129803,1,1
II,+,13157236,0.00262812,0.0,761,759,2,1,0,gene,F32A11.1,0,13157239,1.97113,22969,13134267,3,13157236,0,-3
II,+,13183341,0.0,0.00012207,13,13,0,0,1,gene,W09H1.2,0,13183350,None,22981,13160360,9,13183351,10,1
II,+,13183351,0.0,1.90735e-06,19,19,0,0,30,gene,W09H1.2,0,13183386,None,22991,13160360,35,13183351,0,-35
II,+,13195450,0.00209251,0.0,9080,9061,19,13,2,gene,W09H1.6,1,13195479,18.9585,9635,13185815,29,13195450,0,-29
II,+,13199744,1.0,0.03125,5,0,5,4,2,gene,F15D4.1,2,13199871,0.336874,132,13199612,127,13200072,328,201
II,+,13200066,0.528571,0.0848951,70,33,37,31,4,gene,F15D4.1,2,13200071,0.336874,454,13199612,5,13200072,6,1
II,+,13215993,0.87299,0.0,1244,158,1086,591,0,gene,F15D4.2,3,13215996,1.02328,387,13215606,3,13215993,0,-3
II,+,13235207,0.0,0.0,1370,1370,0,0,4,gene,F15D4.8,0,13235235,3.38618,18542,13216665,28,13235207,0,-28
II,+,13245273,0.0,0.000488281,11,11,0,0,18,gene,F15D4.5,0,13245330,0.293225,8020,13237253,57,13245331,58,1
II,+,13278076,0.0,3.55271e-15,48,48,0,0,0,gene,Y48C3A.5,0,13278216,0.270617,13518,13264558,140,13278076,0,-140
II,+,13299597,0.011236,1.43787e-25,89,88,1,1,10,gene,Y48C3A.5,0,13299615,0.270617,19861,13279736,18,13299597,0,-18
II,+,13309191,0.0,0.0,521,521,0,0,0,gene,Y48C3A.3,0,13309228,0.734846,5072,13304119,37,13309191,0,-37
II,+,13338182,0.00691563,0.0,723,718,5,5,5,gene,Y48C3A.10,0,13338182,1.21524,26802,13311380,0,13338182,0,0
II,+,13369508,0.00970874,0.0,206,204,2,2,1,gene,Y48C3A.20,1,13369514,0.369897,29646,13339862,6,13369508,0,-6
II,+,13376313,0.929961,0.0,257,18,239,163,0,gene,Y48C3A.12,2,13376323,1.03512,1258,13375055,10,13376313,0,-10
II,+,13376322,0.75,0.109375,8,2,6,2,565,gene,Y48C3A.12,2,13376323,1.03512,1267,13375055,1,13376313,-9,-10
II,+,13389662,0.938547,1.44453e-37,179,11,168,124,1,gene,Y48C3A.14,3,13389679,0.614051,919,13388743,17,13389662,0,-17
II,+,13402881,0.820557,0.0,574,103,471,303,2,gene,Y48C3A.16,4,13403048,1.86607,971,13401910,167,13402881,0,-167
II,+,13406043,0.923913,1.43642e-35,184,14,170,120,3,gene,Y48C3A.17,5,13406051,0.240935,1494,13404549,8,13406061,18,10
II,+,13412536,0.908333,8.732e-22,120,11,109,80,13,gene,Y48C3A.18,6,13412549,0.362707,1068,13411468,13,13412546,10,-3
II,+,13412903,0.909091,0.00537109,11,1,10,7,11,gene,Y48C3A.18,6,13413033,0.362707,1435,13411468,130,13413034,131,1
II,+,13414906,0.833333,0.09375,6,1,5,1,1,gene,Y48E1C.1,7,13414929,0.354635,99,13414807,23,13414930,24,1
II,+,13414927,0.870445,7.58546e-35,247,32,215,158,10,gene,Y48E1C.1,7,13414929,0.354635,120,13414807,2,13414927,0,-2
II,+,13424450,0.968254,0.0,189,6,183,131,2,gene,Y48E1C.2,8,13424486,0.596095,106,13424344,36,13424407,-43,-79
II,+,13477585,0.0,0.5,1,1,0,0,9,gene,E01G4.7,0,13477656,None,3734,13473851,71,13477714,129,58
II,+,13482306,0.0025,0.0,400,399,1,1,2,gene,E01G4.6,0,13482306,1.71777,3477,13478829,0,13482306,0,0
II,+,13501778,0.0,0.0,190,190,0,0,1,gene,F45H10.5,0,13501796,0.110496,16103,13485675,18,13501778,0,-18
II,+,13575826,0.00347222,0.0,576,574,2,2,1,gene,Y48E1B.7,0,13575831,0.446011,52970,13522856,5,13575826,0,-5
II,+,13585759,1.0,0.5,1,0,1,1,14,gene,Y48E1B.8,0,13585776,0.262874,1122,13584637,17,13585628,-131,-148
II,+,13596856,0.00374532,0.0,1335,1330,5,3,4,gene,Y48E1B.12,0,13596856,1.15915,7922,13588934,0,13596856,0,0
II,+,13632546,0.0,9.09495e-13,40,40,0,0,0,gene,C31C9.1,0,13632562,1.53153,27504,13605042,16,13632563,17,1
II,+,13641445,0.0,0.00390625,8,8,0,0,110,gene,C31C9.3,0,13641462,0.183336,4560,13636885,17,13641463,18,1
II,+,13645668,0.0,0.03125,5,5,0,0,0,gene,C31C9.4,0,13645681,0.0138316,1977,13643691,13,13645682,14,1
II,+,13649382,0.0,0.5,1,1,0,0,1,gene,C31C9.8,0,13649398,None,543,13648839,16,13649399,17,1
II,+,13669085,0.0,3.05176e-05,15,15,0,0,982,gene,C31C9.7,0,13669150,1.90032,13837,13655248,65,13669005,-80,-145
II,+,13703778,0.0,0.000976562,10,10,0,0,0,gene,Y54G9A.3,0,13703778,0.109356,34190,13669588,0,13703778,0,0
II,+,13722968,0.0,1.54074e-33,109,109,0,0,328,gene,Y54G9A.5,0,13722975,0.857842,10169,13712799,7,13722865,-103,-110
II,+,13725966,0.0,0.0078125,7,7,0,0,2,gene,Y54G9A.6,1,13725982,2.03371,1020,13724946,16,13725963,-3,-19
II,+,13725983,0.00375,0.0,800,797,3,2,302,gene,Y54G9A.6,1,13726118,2.03371,1037,13724946,135,13725963,-20,-155
II,+,13729617,0.890741,0.0,540,59,481,307,6,gene,Y54G9A.9,2,13729670,0.990176,113,13729504,53,13729617,0,-53
II,+,13736253,0.000931532,0.0,2147,2145,2,2,12,gene,R06B9.5,0,13736405,2.52923,4803,13731450,152,13736251,-2,-154
II,+,13741646,0.0,2.06795e-25,82,82,0,0,0,gene,R06B9.6,0,13741653,0.882794,4736,13736910,7,13741654,8,1
II,+,13752218,0.00538358,0.0,743,739,4,3,10,gene,R06B9.4,0,13752221,0.745767,2334,13749884,3,13752222,4,1
II,+,13758316,0.025974,1.93626e-20,77,75,2,2,20,gene,R06B9.3,0,13758322,0.602137,2146,13756170,6,13758316,0,-6
II,+,13763322,0.0,1.49012e-08,26,26,0,0,0,gene,R06B9.1,0,13763328,0.12173,2189,13761133,6,13763329,7,1
II,+,13792131,0.0,1.86265e-09,29,29,0,0,0,gene,ZK131.11,0,13792181,1.02522,10287,13781844,50,13792131,0,-50
II,+,13830501,0.0,0.0,324,324,0,0,1,gene,F08G2.4,0,13830503,0.553665,2890,13827611,2,13830501,0,-2
II,+,13852210,0.0,3.8147e-06,18,18,0,0,0,gene,F08G2.8,0,13852267,0.121575,21094,13831116,57,13852210,0,-57
II,+,13872768,0.001693,0.0,8860,8845,15,13,4,gene,Y51H1A.3,1,13872769,7.56888,17604,13855164,1,13872768,0,-1
II,+,13875722,0.0,0.0625,4,4,0,0,2,gene,Y51H1A.4,2,13875960,0.803787,523,13875199,238,13875933,211,-27
II,+,13875933,0.848649,2.35066e-23,185,28,157,111,2,gene,Y51H1A.4,2,13875960,0.803787,734,13875199,27,13875933,0,-27
II,+,13882586,0.8,0.15625,5,1,4,4,0,gene,Y51H1A.5,3,13882611,0.396408,102,13882484,25,13882604,18,-7
II,+,13882604,0.966912,0.0,272,9,263,211,59,gene,Y51H1A.5,3,13882611,0.396408,120,13882484,7,13882604,0,-7
II,+,13888552,0.0110935,0.0,631,624,7,6,7,gene,Y51H1A.6,4,13888559,0.593597,623,13887929,7,13888556,4,-3
II,+,13908818,0.02,3.90486e-27,100,98,2,2,2,gene,W02B8.2,0,13908821,0.570463,10498,13898320,3,13908822,4,1
II,+,14006407,0.0,0.0,376,376,0,0,0,gene,F01D5.6,0,14006407,0.770294,24726,13981681,0,14006408,1,1
II,+,14011154,0.0,0.25,2,2,0,0,7,gene,F01D5.8,0,14011253,0.270095,674,14010480,99,14011099,-55,-154
II,+,14059981,0.0122378,0.0,1144,1130,14,11,26,gene,W01G7.3,1,14059985,2.74648,27778,14032203,4,14059981,0,-4
II,+,14060635,0.828979,4.2039e-45,421,72,349,263,7,gene,W01G7.4,2,14060686,0.922337,117,14060518,51,14060635,0,-51
II,+,14063348,0.0140625,0.0,640,631,9,7,1,gene,W01G7.5,1,14063350,1.55793,497,14062851,2,14063351,3,1
II,+,14068805,0.589041,0.00653403,146,60,86,57,0,gene,Y39G8C.1,2,14068892,0.712903,2129,14066676,87,14068893,88,1
II,+,14101144,0.0,2.98023e-08,25,25,0,0,0,gene,Y39G8C.3,0,14101158,None,11372,14089772,14,14101159,15,1
II,+,14104668,0.0,2.38419e-07,22,22,0,0,0,gene,K09E4.5,0,14104668,0.042863,1765,14102903,0,14104669,1,1
II,+,14155176,0.00341321,0.0,28126,28030,96,85,0,gene,Y48B6A.2,1,14155189,104.272,15214,14139962,13,14155176,0,-13
II,+,14155185,0.0,2.27374e-13,42,42,0,0,67788,gene,Y48B6A.2,1,14155189,104.272,15223,14139962,4,14155185,0,-4
II,+,14155664,0.845109,7.56701e-44,368,57,311,221,2,gene,Y48B6A.3,2,14155682,1.05413,199,14155465,18,14155664,0,-18
II,+,14180155,0.0,1.32349e-23,76,76,0,0,0,gene,Y48B6A.6,0,14180160,0.700948,14228,14165927,5,14180155,0,-5
II,+,14183861,0.0,0.25,2,2,0,0,4,gene,Y48B6A.6,0,14183932,0.700948,17934,14165927,71,14183862,1,-70
II,+,14184003,0.0,7.45058e-09,27,27,0,0,2,gene,Y48B6A.6,0,14184074,0.700948,18076,14165927,71,14184003,0,-71
II,+,14187671,0.00645161,0.0,310,308,2,2,92,gene,Y48B6A.6,0,14187674,0.700948,21744,14165927,3,14187675,4,1
II,+,14197942,0.0,0.03125,5,5,0,0,0,gene,Y48B6A.7,0,14198062,0.0279809,8171,14189771,120,14197942,0,-120
II,+,14211320,0.0909091,0.00537109,11,10,1,0,9,gene,Y48B6A.9,0,14211329,0.0696975,1212,14210108,9,14211335,15,6
II,+,14250591,0.00789084,0.0,6083,6035,48,38,9,gene,Y48B6A.14,0,14250613,40.7873,30951,14219640,22,14250591,0,-22
II,+,14252253,0.00352645,0.0,1985,1978,7,7,1,gene,Y54G11A.2,0,14252255,0.71323,912,14251341,2,14252256,3,1
II,+,14292716,0.0102041,3.09233e-28,98,97,1,0,0,gene,Y54G11A.4,0,14292718,0.135203,8848,14283868,2,14292719,3,1
II,+,14297200,0.0,0.03125,5,5,0,0,5,gene,Y54G11A.7,0,14297202,0.584351,1590,14295610,2,14297192,-8,-10
II,+,14317890,0.857143,0.0546875,7,1,6,4,1,gene,Y54G11A.14,0,14317928,0.0426457,5256,14312634,38,14318053,163,125
II,+,14350048,0.00760456,0.0,1578,1566,12,12,0,gene,Y54G11A.11,0,14350071,3.79527,29136,14320912,23,14350048,0,-23
II,+,14358263,0.0,0.0,635,635,0,0,4,gene,R06A4.9,1,14358278,1.26455,7573,14350690,15,14358287,24,9
II,+,14358370,0.0,0.5,1,1,0,0,20,gene,R06A4.9,1,14358381,1.26455,7680,14350690,11,14358370,0,-11
II,+,14361914,0.935484,3.59055e-32,155,10,145,104,0,gene,R06A4.2,2,14361917,0.448478,336,14361578,3,14361914,0,-3
II,+,14365602,0.0142857,0.0,630,621,9,7,1,gene,R06A4.4,0,14365617,1.40067,530,14365072,15,14365630,28,13
II,+,14381647,0.0,0.0,188,188,0,0,0,gene,R06A4.6,0,14381666,0.176479,7857,14373790,19,14381523,-124,-143
II,+,14383870,0.0273973,2.7825e-19,73,71,2,2,0,gene,R06A4.7,0,14383870,0.536512,597,14383273,0,14383871,1,1
II,+,14390615,0.0187793,0.0,213,209,4,3,0,gene,F26H11.2,0,14390970,4.16578,1909,14388706,355,14390615,0,-355
II,+,14399953,0.00217786,0.0,2755,2749,6,5,11,gene,F26H11.2,0,14399976,4.16578,11247,14388706,23,14399953,0,-23
II,+,14441329,0.0185185,2.9976e-15,54,53,1,0,40,gene,K04B12.3,0,14441334,0.377102,13891,14427438,5,14441330,1,-4
II,+,14455527,0.0,1.49012e-08,26,26,0,0,0,gene,Y54G11B.1,0,14455706,0.229415,8414,14447113,179,14455527,0,-179
II,+,14462274,0.0136986,7.72918e-21,73,72,1,0,0,gene,Y54G11B.1,0,14462284,0.229415,15161,14447113,10,14462274,0,-10
II,+,14489698,0.0150376,8.06132e-37,133,131,2,1,15,gene,K10H10.1,0,14489703,0.551014,24872,14464826,5,14489698,0,-5
II,+,14501761,0.0,0.5,1,1,0,0,0,gene,K10H10.5,0,14501766,0.0320731,202,14501559,5,14501761,0,-5
II,+,14524085,0.00753769,0.0,398,395,3,3,0,gene,F57C2.3,0,14524090,0.39214,14003,14510082,5,14524069,-16,-21
II,+,14528650,0.0131796,0.0,607,599,8,6,0,gene,F57C2.6,1,14528671,0.536502,2723,14525927,21,14528650,0,-21
II,+,14534196,0.782383,1.12104e-44,579,126,453,331,0,gene,C04H5.1,2,14534219,1.00734,127,14534069,23,14534196,0,-23
II,+,14550826,0.0638298,1.15215e-10,47,44,3,1,13,gene,C04H5.8,0,14550836,1.62085,11768,14539058,10,14550809,-17,-27
II,+,14573511,0.0,5.68434e-14,44,44,0,0,1,gene,C01G12.1,0,14573541,0.544546,21133,14552378,30,14573511,0,-30
II,+,14573554,0.0,0.0625,4,4,0,0,48,gene,C01G12.1,0,14573637,0.544546,21176,14552378,83,14573511,-43,-126
II,+,14583599,0.0,5.42101e-20,64,64,0,0,0,gene,C01G12.4,0,14583601,None,2428,14581171,2,14583602,3,1
II,+,14600798,0.00473934,0.0,211,210,1,1,0,gene,F19H8.1,0,14600804,1.17965,3253,14597545,6,14600798,0,-6
II,+,14615933,0.0,0.03125,5,5,0,0,3,gene,F19H8.4,0,14616031,0.275444,5484,14610449,98,14616025,92,-6
II,+,14627526,0.0,0.0,331,331,0,0,0,gene,C38C6.6,0,14627598,2.07608,1135,14626391,72,14627526,0,-72
II,+,14705410,0.0,0.0,859,859,0,0,1,gene,C09F9.2,0,14705411,1.49116,6173,14699237,1,14705412,2,1
II,+,14754545,0.00369004,0.0,271,270,1,0,2,gene,Y54E2A.4,0,14754563,0.252897,41400,14713145,18,14754564,19,1
II,+,14790964,0.0147059,2.30393e-19,68,67,1,1,1,gene,Y54E2A.10,0,14790970,0.0896754,8354,14782610,6,14790996,32,26
II,+,14795299,0.0,0.0,507,507,0,0,1,gene,Y54E2A.11,0,14795323,3.68832,2808,14792491,24,14795299,0,-24
II,+,14795305,0.111111,3.47245e-08,45,40,5,2,91,gene,Y54E2A.11,0,14795323,3.68832,2814,14792491,18,14795305,0,-18
II,+,14798367,0.105437,0.0,607,543,64,55,0,gene,Y54E2A.12,0,14798380,0.610018,227,14798140,13,14798367,0,-13
II,+,14812927,0.00990099,0.0,303,300,3,3,0,gene,W01D2.5,0,14812927,0.72211,3828,14809099,0,14812927,0,0
II,+,14815413,1.0,0.25,2,0,2,0,0,gene,W01D2.1,0,14815533,69.4487,629,14814784,120,14815413,0,-120
II,+,14852327,0.00588235,0.0,170,169,1,1,2,gene,R05H10.1,0,14852333,0.57932,1527,14850800,6,14852325,-2,-8
II,+,14855424,0.0,0.03125,5,5,0,0,2,gene,R05H10.7,1,14855430,0.529865,1905,14853519,6,14855424,0,-6
II,+,14857154,0.008,0.0,250,248,2,2,0,gene,R05H10.2,2,14857155,0.74896,249,14856905,1,14857154,0,-1
II,+,14867532,0.40951,6.16104e-22,2713,1602,1111,715,5,gene,R05H10.5,3,14867569,2.46182,1040,14866492,37,14867528,-4,-41
II,+,14869839,0.896341,2.28816e-27,164,17,147,107,0,gene,R05H10.3,4,14869843,0.37455,275,14869564,4,14869839,0,-4
II,+,14902388,0.00555556,0.0,180,179,1,0,0,gene,R03C1.3,0,14902413,0.244086,19441,14882947,25,14902388,0,-25
II,+,14904637,0.0,0.5,1,1,0,0,1,gene,R03C1.3,0,14904704,0.244086,21690,14882947,67,14904705,68,1
II,+,14919602,0.0,2.84217e-14,45,45,0,0,1,gene,R03C1.4,0,14919663,None,12176,14907426,61,14919622,20,-41
II,+,14924312,0.0,1.11022e-16,53,53,0,0,0,gene,E01F3.1,0,14924317,0.482539,16886,14907426,5,14924318,6,1
II,+,14944186,0.0,4.44089e-16,51,51,0,0,0,gene,E01F3.1,0,14944259,0.482539,36760,14907426,73,14944260,74,1
II,+,14949432,0.0,0.000488281,11,11,0,0,0,gene,E01F3.1,0,14949433,0.482539,42006,14907426,1,14949432,0,-1
II,+,14969543,0.0052356,0.0,191,190,1,1,0,gene,Y53F4B.4,0,14969552,0.27913,16295,14953248,9,14969543,0,-9
II,+,14969797,0.0,0.0,262,262,0,0,0,gene,Y53F4B.42,0,14969804,0.217486,16549,14953248,7,14969797,0,-7
II,+,14972044,0.0,0.0078125,7,7,0,0,0,gene,Y53F4B.4,0,14972101,0.27913,487,14971557,57,14972044,0,-57
II,+,14985701,0.0,0.25,2,2,0,0,3,gene,Y53F4B.6,0,14985714,0.0109853,8806,14976895,13,14985701,0,-13
II,+,15019118,0.0,7.62939e-06,17,17,0,0,0,gene,Y53F4B.12,0,15019118,0.0865312,5815,15013303,0,15019118,0,0
II,+,15026011,0.0,0.03125,5,5,0,0,0,gene,Y53F4B.13,1,15026090,0.633599,342,15025669,79,15026075,64,-15
II,+,15026020,0.0,3.05176e-05,15,15,0,0,21,gene,Y53F4B.13,1,15026090,0.633599,351,15025669,70,15026075,55,-15
II,+,15026052,0.0,0.000488281,11,11,0,0,12,gene,Y53F4B.13,1,15026090,0.633599,383,15025669,38,15026075,23,-15
II,+,15026061,0.00537634,0.0,558,555,3,3,39,gene,Y53F4B.13,1,15026090,0.633599,392,15025669,29,15026075,14,-15
II,+,15037886,0.882522,0.0,698,82,616,435,110,gene,Y53F4B.14,2,15037894,1.86381,143,15037743,8,15037884,-2,-10
II,+,15039299,0.908676,1.28438e-38,219,20,199,123,0,gene,Y53F4B.15,3,15039310,0.950915,56,15039243,11,15039298,-1,-12
II,+,15039306,0.84375,4.68865e-05,32,5,27,17,105,gene,Y53F4B.15,3,15039310,0.950915,63,15039243,4,15039298,-8,-12
II,+,15058091,1.0,0.25,2,0,2,2,0,gene,Y53F4B.17,0,15058121,0.0132543,9292,15048799,30,15058122,31,1
II,+,15084367,0.0,2.84217e-14,45,45,0,0,4,gene,Y53F4B.20,1,15084370,0.0903051,4997,15079370,3,15084371,4,1
II,+,15090067,0.028169,1.05244e-18,71,69,2,2,0,gene,Y53F4B.21,2,15090074,0.195017,629,15089438,7,15090075,8,1
II,+,15107046,0.0,0.25,2,2,0,0,0,gene,Y53F4B.41,3,15107072,None,17608,15089438,26,15107073,27,1
II,+,15110041,0.665753,5.86746e-11,365,122,243,182,1,gene,Y53F4B.39,4,15110046,1.24018,918,15109123,5,15110046,5,0
II,+,15112063,0.0,0.0,229,229,0,0,3,gene,Y53F4B.39,4,15112066,1.24018,2940,15109123,3,15112067,4,1
II,+,15120196,0.0122888,0.0,651,643,8,8,0,gene,Y53F4B.22,0,15120203,1.88238,3984,15116212,7,15120196,0,-7
II,+,15146843,0.0,0.25,2,2,0,0,0,gene,Y53F4B.27,0,15146915,0.296087,1580,15145263,72,15146843,0,-72
II,+,15158075,0.0,7.10543e-15,47,47,0,0,0,gene,Y53F4B.28,0,15158077,0.256607,6238,15151837,2,15158078,3,1
II,+,15207400,0.0,0.0,266,266,0,0,5,gene,Y46E12BL.4,0,15207417,0.891353,9433,15197967,17,15207338,-62,-79
II,+,15230214,0.473684,0.176197,19,10,9,7,1,gene,Y46E12BL.3,0,15230243,0.892806,3590,15226624,29,15230257,43,14
II,+,15233048,0.0818966,4.91856e-43,232,213,19,15,0,gene,Y46E12BL.2,0,15233056,0.64256,353,15232695,8,15233048,0,-8
II,+,15268107,0.00664452,0.0,602,598,4,2,0,gene,2RSSE.1,0,15268375,1.18871,23255,15244852,268,15268107,0,-268
III,+,3284,0.0,7.62939e-06,17,17,0,0,0,gene,H10E21.2,0,3298,0.0364948,0,0,14,3321,37,23
III,+,4146,0.0,0.5,1,1,0,0,3,gene,H10E21.2,0,4250,0.0364948,459,3687,104,4145,-1,-105
III,+,15812,0.0,2.32831e-10,32,32,0,0,5,gene,H10E21.1,0,15815,0.129754,3872,11940,3,15720,-92,-95
III,+,41061,0.00174292,0.0,2295,2291,4,3,21,gene,W05G11.3,0,41061,1.80604,23723,17338,0,41061,0,0
III,+,57661,0.0,0.5,1,1,0,0,0,gene,W05G11.2,0,57700,0.068134,4484,53177,39,57701,40,1
III,+,87558,0.0,0.0,885,885,0,0,0,gene,F54C4.1,0,87562,1.26955,28861,58697,4,87560,2,-2
III,+,117515,0.0,0.015625,6,6,0,0,0,gene,C29F9.5,0,117554,0.0157197,891,116624,39,117706,191,152
III,+,120482,0.0120482,8.582e-24,83,82,1,1,132,gene,C29F9.4,1,120490,0.333035,1716,118766,8,120491,9,1
III,+,124777,0.964912,1.10745e-14,57,2,55,28,12,gene,C29F9.3,2,124798,0.4008,91,124686,21,124777,0,-21
III,+,124790,0.761905,0.00970316,21,5,16,9,267,gene,C29F9.3,2,124798,0.4008,104,124686,8,124790,0,-8
III,+,130918,0.0,0.5,1,1,0,0,0,gene,C29F9.2,0,130931,0.39334,2981,127937,13,130946,28,15
III,+,130946,0.00862069,1.3963e-33,116,115,1,1,4,gene,C29F9.2,0,130956,0.39334,3009,127937,10,130946,0,-10
III,+,132417,0.0,0.0,271,271,0,0,0,gene,C29F9.1,1,132423,0.243227,450,131967,6,132424,7,1
III,+,134493,0.908046,3.77618e-16,87,8,79,30,0,gene,T17A3.2,2,134497,0.17264,93,134400,4,134493,0,-4
III,+,179743,0.0,0.5,1,1,0,0,48,gene,F40G9.6,0,179768,0.163797,5182,174561,25,179541,-202,-227
III,+,185637,0.0,0.000244141,12,12,0,0,1,gene,F40G9.4,0,185650,0.0194955,724,184913,13,185651,14,1
III,+,188807,0.0,0.000488281,11,11,0,0,0,gene,F40G9.3,1,188839,3.03525,1886,186921,32,188837,30,-2
III,+,188837,0.00376547,0.0,3718,3704,14,13,26,gene,F40G9.3,1,188839,3.03525,1916,186921,2,188837,0,-2
III,+,190985,0.945913,0.0,832,45,787,460,1,gene,F40G9.2,2,190995,1.76969,21,190964,10,190985,0,-10
III,+,192105,0.887701,1.58907e-29,187,21,166,111,0,gene,F40G9.1,3,192131,0.410083,125,191980,26,192105,0,-26
III,+,194461,0.893617,1.11806e-30,188,20,168,109,1,gene,F40G9.17,4,194496,None,116,194345,35,194461,0,-35
III,+,221415,0.0,1.0842e-19,63,63,0,0,0,gene,Y50D7A.6,0,221417,0.218816,21128,200287,2,221415,0,-2
III,+,230428,0.0,4.44089e-16,51,51,0,0,0,gene,Y50D7A.5,0,230433,0.140173,1615,228813,5,230434,6,1
III,+,235262,1.0,0.5,1,0,1,0,1,gene,Y50D7A.4,1,235440,0.838973,176,235086,178,235841,579,401
III,+,235843,0.00769231,0.0,260,258,2,2,2,gene,Y50D7A.4,1,235848,0.838973,757,235086,5,235843,0,-5
III,+,254534,0.91684,0.0,481,40,441,312,0,gene,Y50D7A.3,2,254557,1.24987,158,254376,23,254534,0,-23
III,+,265089,0.860627,5.88161e-38,287,40,247,172,0,gene,Y50D7A.11,3,265095,0.377072,197,264892,6,265096,7,1
III,+,284116,0.876485,0.0,421,52,369,274,1,gene,Y50D7A.9,2,284249,0.646458,1235,282881,133,284116,0,-133
III,+,292639,0.75188,1.68543e-09,133,33,100,66,0,gene,Y50D7A.1,1,292648,0.267658,3110,289529,9,292648,9,0
III,+,315459,0.876953,0.0,512,63,449,280,3,gene,Y50D7A.10,2,315460,0.941092,1133,314326,1,315459,0,-1
III,+,315495,1.0,0.5,1,0,1,1,247,gene,Y50D7A.10,2,315544,0.941092,1169,314326,49,315459,-36,-85
III,+,365948,0.0,2.71051e-20,65,65,0,0,0,gene,K10F12.3,0,365952,0.151279,43877,322071,4,365948,0,-4
III,+,403501,0.0,0.25,2,2,0,0,3,gene,Y55B1BL.1,0,403573,1.82535,25944,377557,72,403501,0,-72
III,+,429331,0.0,9.31323e-10,30,30,0,0,8,gene,Y55B1BR.3,0,429352,0.394875,23728,405603,21,429299,-32,-53
III,+,429337,0.0227273,1.23689e-23,88,86,2,2,24,gene,Y55B1BR.3,0,429352,0.394875,23734,405603,15,429299,-38,-53
III,+,434890,0.0,0.0,222,222,0,0,0,gene,Y55B1BR.2,0,434909,0.382614,3156,431734,19,434910,20,1
III,+,472316,0.00223714,0.0,447,446,1,1,18,gene,F10C5.2,1,472331,1.182,23333,448983,15,472316,0,-15
III,+,475264,0.0,0.5,1,1,0,0,98,gene,F10C5.1,2,475321,0.634018,59,475205,57,475453,189,132
III,+,475453,0.866505,0.0,412,55,357,257,7,gene,F10C5.1,2,475461,0.634018,100,475353,8,475453,0,-8
III,+,491545,0.00595238,0.0,168,167,1,1,8,gene,F30H5.1,0,491546,0.803844,2095,489450,1,491545,0,-1
III,+,542064,0.0,5.55112e-17,54,54,0,0,0,gene,T22F7.1,0,542091,0.263154,39459,502605,27,542064,0,-27
III,+,560106,0.0,2.35099e-38,125,125,0,0,1,gene,B0353.1,0,560143,1.52657,13574,546532,37,560137,31,-6
III,+,573971,0.0,2.8026e-45,148,148,0,0,1,gene,Y55B1AL.1,0,573980,0.897383,27439,546532,9,573981,10,1
III,+,640787,0.00593824,0.0,842,837,5,5,1,gene,W06E11.2,1,640790,0.782357,33798,606989,3,640791,4,1
III,+,642056,0.981707,3.08286e-44,164,3,161,113,0,gene,W06E11.1,2,642068,0.425678,434,641622,12,642069,13,1
III,+,646751,0.571429,0.140157,21,9,12,12,1,gene,C09F5.2,0,646753,0.631192,1163,645588,2,647123,372,370
III,+,647111,0.0,0.5,1,1,0,0,2,gene,C09F5.2,0,647335,0.631192,1523,645588,224,647123,12,-212
III,+,647485,0.0,6.10352e-05,14,14,0,0,3,gene,C09F5.2,0,647570,0.631192,1897,645588,85,647485,0,-85
III,+,652894,0.0108696,0.0,184,182,2,1,4,gene,C09F5.2,0,653101,0.631192,3357,649537,207,652894,0,-207
III,+,658706,0.0107143,0.0,280,277,3,1,7,gene,C09F5.1,0,658722,0.972325,4246,654460,16,658706,0,-16
III,+,676116,0.00877193,5.4889e-33,114,113,1,0,0,gene,W02B3.2,0,676122,0.274785,13388,662728,6,676116,0,-6
III,+,688715,0.0,0.0625,4,4,0,0,0,gene,C24A1.2,0,688751,0.251628,8154,680561,36,688733,18,-18
III,+,725113,0.000691802,0.0,2891,2889,2,1,2,gene,C24A1.1,0,725149,3.33753,9277,715836,36,725016,-97,-133
III,+,740676,0.0,1.73472e-18,59,59,0,0,7,gene,T17H7.1,0,740681,0.120881,14418,726258,5,740676,0,-5
III,+,761776,0.00171086,0.0,1169,1167,2,1,3,gene,F42G9.4,0,761791,0.788374,18789,742987,15,761485,-291,-306
III,+,765190,0.0253165,5.09709e-21,79,77,2,0,0,gene,F42G9.9,0,765194,0.823475,2789,762401,4,765190,0,-4
III,+,768547,0.0,0.0625,4,4,0,0,2,gene,F42G9.9,0,768864,0.823475,6146,762401,317,768553,6,-311
III,+,768553,0.0133333,1.98523e-21,75,74,1,0,4,gene,F42G9.9,0,768864,0.823475,6152,762401,311,768553,0,-311
III,+,773409,0.00624025,0.0,641,637,4,4,2,gene,F42G9.2,0,773501,3.5398,578,772831,92,773398,-11,-103
III,+,783700,0.016129,1.34441e-17,62,61,1,1,2,gene,F42G9.1,0,783711,1.98787,9547,774153,11,783709,9,-2
III,+,783709,0.00492611,0.0,406,404,2,1,192,gene,F42G9.1,0,783711,1.98787,9556,774153,2,783709,0,-2
III,+,794294,0.00420427,0.0,128203,127664,539,490,71,gene,B0412.4,1,794302,196.05,8220,786074,8,794294,0,-8
III,+,795130,0.928839,0.0,534,38,496,384,11,gene,B0412.3,2,795132,0.681279,62,795068,2,795130,0,-2
III,+,795133,0.941176,3.26545e-08,34,2,32,18,5,gene,B0412.3,2,795238,0.681279,65,795068,105,795133,0,-105
III,+,823214,0.0227273,2.50111e-12,44,43,1,1,0,gene,K02F3.5,0,823393,0.277886,1492,821722,179,823214,0,-179
III,+,834080,0.0028135,0.0,2488,2481,7,5,5,gene,K02F3.4,0,834211,8.42016,791,833289,131,834080,0,-131
III,+,834297,0.0,0.0625,4,4,0,0,6,gene,K02F3.4,0,834378,8.42016,1008,833289,81,834297,0,-81
III,+,842928,0.0,0.0,915,915,0,0,4,gene,K02F3.3,0,842941,3.68199,7128,835800,13,842926,-2,-15
III,+,845835,0.0,4.33681e-19,61,61,0,0,0,gene,K02F3.2,0,845851,0.568779,2042,843793,16,845838,3,-13
III,+,845842,0.00549451,0.0,182,181,1,1,35,gene,K02F3.2,0,845851,0.568779,2049,843793,9,845838,-4,-13
III,+,856627,0.882096,1.12142e-34,229,27,202,149,15,gene,K02F3.12,2,856631,0.63243,105,856522,4,856627,0,-4
III,+,860186,0.898798,0.0,998,101,897,678,4,gene,Y6D11A.1,3,860189,0.584859,108,860078,3,860186,0,-3
III,+,862294,0.606461,5.48949e-09,681,268,413,290,7,gene,Y6D11A.2,4,862297,1.69346,851,861443,3,862294,0,-3
III,+,874290,0.0,0.000244141,12,12,0,0,2,gene,T24C4.8,0,874298,0.134208,8909,865381,8,874297,7,-1
III,+,879847,0.0023678,0.0,1267,1264,3,2,31,gene,T24C4.1,0,879851,1.20832,4457,875390,4,879847,0,-4
III,+,911248,0.0157895,0.0,570,561,9,8,2,gene,F23H11.1,0,911264,2.42063,11075,900173,16,911265,17,1
III,+,950856,0.0,1.97215e-31,102,102,0,0,1,gene,T12B5.4,0,950868,0.133398,38629,912227,12,950869,13,1
III,+,952518,0.0833333,0.00292969,12,11,1,1,1,gene,T12B5.3,0,952530,0.0681627,283,952235,12,952531,13,1
III,+,956321,0.0,2.32831e-10,32,32,0,0,2,gene,T12B5.2,0,956343,0.240796,1039,955282,22,956321,0,-22
III,+,962264,0.0,1.90735e-06,19,19,0,0,2,gene,T12B5.1,0,962290,0.131393,4374,957890,26,962291,27,1
III,+,983248,0.0,0.0,268,268,0,0,0,gene,R06B10.5,0,983272,0.331626,18859,964389,24,983248,0,-24
III,+,991863,0.0183486,9.06882e-30,109,107,2,0,0,gene,R06B10.4,0,991867,0.221385,3430,988433,4,991863,0,-4
III,+,1008295,0.0,0.0078125,7,7,0,0,2,gene,Y34F4.6,0,1008318,None,1176,1007119,23,1008441,146,123
III,+,1037490,0.0,3.46945e-18,58,58,0,0,21,gene,BE0003N10.1,0,1037496,0.238323,15626,1021864,6,1037497,7,1
III,+,1080889,0.00212993,0.0,1878,1874,4,3,5,gene,Y92C3B.1,1,1080907,4.15255,34631,1046258,18,1080858,-31,-49
III,+,1080896,0.00479233,0.0,2504,2492,12,12,467,gene,Y92C3B.1,1,1080907,4.15255,34638,1046258,11,1080858,-38,-49
III,+,1081390,0.871486,2.49839e-35,249,32,217,174,4,gene,F58B6.3,2,1081396,0.52051,102,1081288,6,1081391,1,-5
III,+,1103201,0.0,4.70198e-38,124,124,0,0,1,gene,F58B6.2,0,1103211,0.193585,8134,1095067,10,1103212,11,1
III,+,1143151,0.0,1.69407e-21,69,69,0,0,0,gene,Y71D11A.2,0,1143177,1.58173,236,1142915,26,1143160,9,-17
III,+,1143160,0.0176991,0.0,339,333,6,5,49,gene,Y71D11A.2,0,1143177,1.58173,245,1142915,17,1143160,0,-17
III,+,1152028,0.0,5.42101e-20,64,64,0,0,0,gene,Y71D11A.1,0,1152031,0.16291,6829,1145199,3,1152032,4,1
III,+,1202538,0.00158103,0.0,1265,1263,2,1,8,gene,Y119D3B.12,0,1202540,0.993766,17606,1184932,2,1202538,0,-2
III,+,1208123,0.0176991,6.09364e-31,113,111,2,2,124,gene,Y119D3B.11,0,1208129,0.470857,787,1207336,6,1208113,-10,-16
III,+,1214891,0.0,1.32349e-23,76,76,0,0,18,gene,Y119D3B.21,0,1214989,121.845,1253,1213638,98,1214942,51,-47
III,+,1214940,0.00198807,0.0,1006,1004,2,2,142,gene,Y119D3B.21,0,1214989,121.845,1302,1213638,49,1214942,2,-47
III,+,1214961,0.0,0.000976562,10,10,0,0,3777,gene,Y119D3B.21,0,1214989,121.845,1323,1213638,28,1214942,-19,-47
III,+,1214984,0.0,1.86265e-09,29,29,0,0,52997,gene,Y119D3B.21,0,1214989,121.845,1346,1213638,5,1214942,-42,-47
III,+,1235985,0.0,0.03125,5,5,0,0,6,gene,Y119D3B.9,0,1236004,0.0941507,20712,1215273,19,1236005,20,1
III,+,1235991,0.0,0.03125,5,5,0,0,7,gene,Y119D3B.9,0,1236004,0.0941507,20718,1215273,13,1236005,14,1
III,+,1243505,0.0,2.1684e-19,62,62,0,0,13,gene,Y119D3B.7,0,1243520,0.099915,719,1242786,15,1243521,16,1
III,+,1249508,0.0,0.0625,4,4,0,0,28,gene,Y119D3B.6,0,1249508,0,4165,1245343,0,1249483,-25,-25
III,+,1279603,0.0222222,3.23521e-24,90,88,2,1,0,gene,ZC47.9,0,1279616,None,14243,1265360,13,1279617,14,1
III,+,1284992,0.0,1.52588e-05,16,16,0,0,1,gene,ZC47.14,0,1285005,0.127009,3193,1281799,13,1285006,14,1
III,+,1289725,0.0,2.38419e-07,22,22,0,0,0,gene,ZC47.12,0,1289736,None,2597,1287128,11,1289737,12,1
III,+,1295660,0.0,3.8147e-06,18,18,0,0,0,gene,Y119D3A.3,0,1295673,0.0149639,4861,1290799,13,1295674,14,1
III,+,1331997,0.0,0.5,1,1,0,0,0,gene,Y82E9BL.19,0,1332014,None,942,1331055,17,1332006,9,-8
III,+,1342962,0.0,4.65661e-10,31,31,0,0,0,gene,Y82E9BL.17,0,1342985,0.0265972,9183,1333779,23,1342986,24,1
III,+,1401938,0.0015528,0.0,644,643,1,1,0,gene,Y82E9BR.23,0,1401955,0.242865,549,1401389,17,1401956,18,1
III,+,1404782,0.180723,1.25793e-09,83,68,15,6,3,gene,Y82E9BR.21,0,1404824,0.178248,1430,1403352,42,1404782,0,-42
III,+,1419186,0.00365066,0.0,124361,123907,454,390,4,gene,Y82E9BR.3,0,1419206,229.328,12931,1406255,20,1419186,0,-20
III,+,1419192,0.0,0.0,1043,1043,0,0,37735,gene,Y82E9BR.3,0,1419206,229.328,12937,1406255,14,1419192,0,-14
III,+,1419205,0.0,0.0625,4,4,0,0,1053500,gene,Y82E9BR.3,0,1419206,229.328,12950,1406255,1,1419192,-13,-14
III,+,1439065,0.0,1.32349e-23,76,76,0,0,5,gene,Y82E9BR.2,0,1439085,0.132863,19145,1419920,20,1439086,21,1
III,+,1458508,0.0,6.61744e-24,77,77,0,0,10,gene,Y82E9BR.1,0,1458525,0.086771,15136,1443372,17,1458526,18,1
III,+,1498085,1.0,0.25,2,0,2,2,0,gene,M01G5.1,0,1498086,0.336429,31374,1466711,1,1498006,-79,-80
III,+,1533874,0.0,3.63798e-12,38,38,0,0,13,gene,Y67D2.4,0,1533882,0.216753,24601,1509273,8,1533827,-47,-55
III,+,1540483,0.00300933,0.0,3323,3313,10,10,0,gene,Y67D2.3,0,1540495,5.36151,2295,1538188,12,1540496,13,1
III,+,1558790,0.00186916,0.0,535,534,1,0,0,gene,Y67D2.2,1,1558809,0.527214,15356,1543434,19,1558790,0,-19
III,+,1570296,0.783333,1.14762e-10,120,26,94,65,0,gene,Y67D2.1,2,1570313,0.589777,178,1570118,17,1570296,0,-17
III,+,1570305,0.826087,0.0010556,23,4,19,13,391,gene,Y67D2.1,2,1570313,0.589777,187,1570118,8,1570305,0,-8
III,+,1576741,0.946309,6.97402e-33,149,8,141,99,2,gene,Y22D7AL.7,3,1576745,0.274541,102,1576639,4,1576746,5,1
III,+,1605015,0.0,0.25,2,2,0,0,27,gene,Y22D7AL.6,0,1605062,0.109414,24168,1580847,47,1604974,-41,-88
III,+,1619731,0.0012747,0.0,1569,1567,2,2,0,gene,Y22D7AL.5,0,1619747,7.2657,12892,1606839,16,1619731,0,-16
III,+,1619739,0.00527148,0.0,1897,1887,10,9,1583,gene,Y22D7AL.5,0,1619747,7.2657,12900,1606839,8,1619739,0,-8
III,+,1626621,0.0,0.0078125,7,7,0,0,0,gene,Y22D7AL.4,0,1626627,0.0284962,829,1625792,6,1626621,0,-6
III,+,1777791,0.00274627,0.0,8375,8352,23,21,1,gene,Y39A3CL.3,0,1777798,10.9554,12992,1764799,7,1777799,8,1
III,+,1824908,0.01,0.0,200,198,2,2,12,gene,Y39A3CL.7,1,1824914,0.751539,17775,1807133,6,1824908,0,-6
III,+,1834502,0.916667,5.57016e-42,228,19,209,163,3,gene,Y39A3CL.1,2,1834508,0.47269,438,1834064,6,1834502,0,-6
III,+,1849036,0.29003,4.04468e-15,331,235,96,82,0,gene,Y39A3CR.7,3,1849070,0.593288,2289,1846747,34,1849052,16,-18
III,+,1855381,0.0,7.10543e-15,47,47,0,0,0,gene,Y39A3CR.6,4,1855381,0.265362,2490,1852891,0,1855382,1,1
III,+,1859121,0.0,0.0078125,7,7,0,0,4,gene,Y39A3CR.5,5,1859217,0.389082,6230,1852891,96,1858902,-219,-315
III,+,1859879,0.00487754,0.0,9636,9589,47,38,107,gene,Y39A3CR.4,1,1859881,11.659,284,1859595,2,1859880,1,-1
III,+,1860410,0.857143,0.0546875,7,1,6,4,0,gene,Y39A3CR.3,2,1860426,0.36658,53,1860357,16,1860418,8,-8
III,+,1860418,0.98,3.90486e-27,100,2,98,62,15,gene,Y39A3CR.3,2,1860426,0.36658,61,1860357,8,1860418,0,-8
III,+,1878071,1.0,0.5,1,0,1,0,0,gene,Y39A3CR.1,4,1878089,0.36969,228,1877843,18,1878354,283,265
III,+,1878354,0.90146,0.0,274,27,247,183,0,gene,Y39A3CR.1,4,1878361,0.36969,511,1877843,7,1878354,0,-7
III,+,1879233,1.0,0.125,3,0,3,2,0,gene,Y39A3CR.1,4,1879276,0.36969,1390,1877843,43,1879233,0,-43
III,+,1905953,0.0,2.01948e-28,92,92,0,0,0,gene,F53A3.4,0,1905955,1.32029,6094,1899859,2,1905956,3,1
III,+,1950649,0.00553028,0.0,39781,39561,220,193,7,gene,F53A3.3,1,1950664,137.28,11094,1939555,15,1950649,0,-15
III,+,1951515,0.921569,0.0,459,36,423,316,4,gene,F53A3.7,2,1951515,0.938839,103,1951412,0,1951515,0,0
III,+,1951538,1.0,0.25,2,0,2,1,574,gene,F53A3.7,2,1951810,0.938839,126,1951412,272,1951515,-23,-295
III,+,1997798,0.0,1.49012e-08,26,26,0,0,1,gene,Y39A3B.2,0,1997869,0.0439478,9459,1988339,71,1998309,511,440
III,+,2092697,0.0,0.0,337,337,0,0,2,gene,Y48G9A.9,0,2092750,0.521583,4437,2088260,53,2092749,52,-1
III,+,2095742,0.0,0.000488281,11,11,0,0,0,gene,Y48G9A.9,0,2095749,0.521583,7482,2088260,7,2095750,8,1
III,+,2102283,0.00622407,0.0,482,479,3,2,0,gene,Y48G9A.8,0,2102304,1.14767,2419,2099864,21,2102283,0,-21
III,+,2111790,0.0102041,3.09233e-28,98,97,1,1,0,gene,Y48G9A.7,0,2111800,0.170623,1596,2110194,10,2111801,11,1
III,+,2134463,0.0,3.08149e-33,108,108,0,0,0,gene,Y48G9A.4,0,2134733,0.351691,15318,2119145,270,2134463,0,-270
III,+,2151933,0.0,1.17549e-38,126,126,0,0,0,gene,Y48G9A.3,1,2151971,0.550349,395,2151538,38,2151956,23,-15
III,+,2197994,0.953642,1.08042e-34,151,7,144,117,2,gene,C39B5.6,2,2198006,0.286066,98,2197896,12,2197994,0,-12
III,+,2198004,0.956522,2.74181e-06,23,1,22,15,291,gene,C39B5.6,2,2198006,0.286066,108,2197896,2,2197994,-10,-12
III,+,2208239,0.0,6.93889e-18,57,57,0,0,4,gene,C39B5.5,0,2208257,0.157323,1429,2206810,18,2208258,19,1
III,+,2227697,0.0,9.31323e-10,30,30,0,0,1,gene,C39B5.3,0,2227700,0.0247825,511,2227186,3,2227701,4,1
III,+,2234872,0.0150943,0.0,265,261,4,4,2,gene,C39B5.2,0,2234872,0.568596,855,2234017,0,2234872,0,0
III,+,2251930,0.0,0.0625,4,4,0,0,2,gene,T20H9.5,0,2251944,None,2391,2249539,14,2251945,15,1
III,+,2253427,0.0,0.25,2,2,0,0,0,gene,T20H9.4,0,2253436,0.00525858,543,2252884,9,2253437,10,1
III,+,2263398,0.0,0.03125,5,5,0,0,6,gene,Y54F10BM.6,0,2263408,0.0406471,6466,2256932,10,2263236,-162,-172
III,+,2266640,0.0,0.125,3,3,0,0,1,gene,Y54F10BM.5,0,2266679,0.0202427,2514,2264126,39,2266411,-229,-268
III,+,2291433,0.0,9.31323e-10,30,30,0,0,41,gene,Y54F10BM.15,0,2291440,0.0726967,1458,2289975,7,2291441,8,1
III,+,2314423,0.0,0.0,907,907,0,0,0,gene,Y54F10BM.2,0,2314461,1.02547,4690,2309733,38,2314423,0,-38
III,+,2331551,0.0,7.62939e-06,17,17,0,0,0,gene,Y54F10BM.1,1,2331568,0.74049,4662,2326889,17,2331569,18,1
III,+,2331562,0.00680272,0.0,294,292,2,2,60,gene,Y54F10BM.1,1,2331568,0.74049,4673,2326889,6,2331569,7,1
III,+,2343561,0.854795,0.0,730,106,624,463,1,gene,Y54F10BM.14,2,2343567,1.55196,351,2343210,6,2343568,7,1
III,+,2347579,0.967949,7.90044e-39,156,5,151,106,1,gene,H04J21.3,3,2347582,0.785679,264,2347315,3,2347579,0,-3
III,+,2376183,0.01,0.0,200,198,2,1,6,gene,H14E04.2,0,2376187,0.703232,12910,2363273,4,2376183,0,-4
III,+,2402058,0.00694444,6.45718e-42,144,143,1,1,3,gene,H14E04.1,0,2402086,0.269672,17208,2384850,28,2402067,9,-19
III,+,2402066,0.0,0.0078125,7,7,0,0,120,gene,H14E04.1,0,2402086,0.269672,17216,2384850,20,2402067,1,-19
III,+,2427893,1.0,0.5,1,0,1,0,2,gene,W04B5.1,0,2427941,0.488452,167,2427726,48,2428182,289,241
III,+,2456170,0.0,7.88861e-31,100,100,0,0,4,gene,E02H9.4,0,2456241,0.173438,7507,2448663,71,2456268,98,27
III,+,2456741,0.0,1.13687e-13,43,43,0,0,1,gene,E02H9.4,0,2456758,0.173438,8078,2448663,17,2456741,0,-17
III,+,2461899,0.0,0.00195312,9,9,0,0,3,gene,E02H9.3,0,2461994,0.333945,4147,2457752,95,2461899,0,-95
III,+,2473856,0.00150489,0.0,1329,1327,2,2,0,gene,Y54F10AL.2,1,2473868,1.07458,4378,2469478,12,2473856,0,-12
III,+,2487757,0.00458295,0.0,1091,1086,5,4,0,gene,Y54F10AL.1,2,2487761,1.37683,1148,2486609,4,2487757,0,-4
III,+,2508808,0.0,3.05176e-05,15,15,0,0,0,gene,Y54F10AM.6,0,2508967,0.522629,6097,2502711,159,2509034,226,67
III,+,2529051,0.0114848,0.0,1219,1205,14,10,0,gene,Y54F10AM.5,1,2529063,4.11732,17235,2511816,12,2529051,0,-12
III,+,2530603,0.923208,0.0,586,45,541,392,1,gene,Y54F10AM.4,2,2530607,0.698952,116,2530487,4,2530603,0,-4
III,+,2549916,0.0,4.76837e-07,21,21,0,0,0,gene,Y54F10AM.2,0,2549920,0.496938,3509,2546407,4,2549916,0,-4
III,+,2555197,0.00671141,2.08793e-43,149,148,1,0,0,gene,Y54F10AM.2,0,2555463,0.496938,8790,2546407,266,2555197,0,-266
III,+,2579295,0.0,0.0,163,163,0,0,0,gene,Y71H2B.8,0,2579302,0.0929905,12715,2566580,7,2579303,8,1
III,+,2586544,0.0,8.67362e-19,60,60,0,0,227,gene,Y71H2B.7,0,2586579,0.531431,4262,2582282,35,2586544,0,-35
III,+,2598048,0.00350058,0.0,857,854,3,3,0,gene,Y71H2B.6,1,2598049,1.24656,8744,2589304,1,2598050,2,1
III,+,2608006,1.0,2.77556e-17,55,0,55,41,2,gene,Y71H2B.5,3,2608007,0.28877,1479,2606527,1,2608008,2,1
III,+,2619925,0.0077821,0.0,257,255,2,2,0,gene,Y71H2B.3,1,2619927,0.773369,558,2619367,2,2619925,0,-2
III,+,2623159,0.958333,0.0,648,27,621,465,1,gene,Y71H2B.2,2,2623159,0.893094,656,2622503,0,2623159,0,0
III,+,2629002,0.0075188,0.0,266,264,2,1,0,gene,Y71H2B.1,0,2629030,0.341707,1251,2627751,28,2629000,-2,-30
III,+,2658073,0.0,3.38813e-21,68,68,0,0,0,gene,H19M22.2,0,2658085,1.72212,15228,2642845,12,2658073,0,-12
III,+,2686360,0.0263158,1.38243e-10,38,37,1,1,2,gene,Y71H2AL.2,0,2686397,0.104045,5259,2681101,37,2686781,421,384
III,+,2700929,0.0037594,0.0,266,265,1,1,1,gene,Y71H2AM.8,0,2700930,0.484245,11849,2689080,1,2700931,2,1
III,+,2786192,0.00334061,0.0,14668,14619,49,43,257,gene,Y71H2AM.5,1,2786193,26.2835,3385,2782807,1,2786192,0,-1
III,+,2786844,0.90902,0.0,2561,233,2328,1487,3,gene,Y71H2AM.4,2,2786851,11.0576,20,2786824,7,2786844,0,-7
III,+,2788431,0.845588,2.81063e-17,136,21,115,85,56,gene,Y71H2AM.24,3,2788434,0.217704,414,2788017,3,2788435,4,1
III,+,2805420,0.00479846,0.0,1042,1037,5,4,0,gene,Y71H2AM.3,0,2805420,0.456548,1749,2803671,0,2805421,1,1
III,+,2819270,0.0,0.0,573,573,0,0,0,gene,Y71H2AM.2,1,2819271,0.732762,8131,2811139,1,2819272,2,1
III,+,2827060,0.957447,3.51511e-33,141,6,135,78,2,gene,Y71H2AM.1,2,2827064,0.683808,489,2826571,4,2827060,0,-4
III,+,2834653,0.746594,0.0,1101,279,822,549,4,gene,Y71H2AR.1,3,2834816,1.59874,841,2833812,163,2834653,0,-163
III,+,2836629,0.795181,2.10704e-08,83,17,66,41,4,gene,Y71H2AR.3,4,2836733,0.124648,380,2836249,104,2836629,0,-104
III,+,2858699,0.015873,0.0,189,186,3,2,2,gene,F56F11.4,0,2858699,0.560166,10127,2848572,0,2858699,0,0
III,+,2874808,0.003367,0.0,297,296,1,1,0,gene,F56F11.3,0,2874882,0.361114,9303,2865505,74,2874808,0,-74
III,+,2882290,0.0104167,1.21169e-27,96,95,1,0,72,gene,F56F11.2,0,2882293,0.155841,1572,2880718,3,2882294,4,1
III,+,2891735,0.0,8.67362e-19,60,60,0,0,0,gene,F56F11.1,0,2891751,0.0640431,6727,2885008,16,2891752,17,1
III,+,2910902,0.0,2.27374e-13,42,42,0,0,0,gene,R10F2.1,0,2910921,0.308185,12564,2898338,19,2910960,58,39
III,+,2947069,0.0,5.16988e-26,84,84,0,0,0,gene,H05C05.1,0,2947107,1.99979,10122,2936947,38,2947081,12,-26
III,+,2947081,0.00174825,0.0,572,571,1,1,303,gene,H05C05.1,0,2947107,1.99979,10134,2936947,26,2947081,0,-26
III,+,2949383,0.0,0.125,3,3,0,0,2,gene,H05C05.1,0,2949759,1.99979,12436,2936947,376,2949611,228,-148
III,+,2949611,0.00141844,0.0,705,704,1,0,9,gene,H05C05.1,0,2949759,1.99979,12664,2936947,148,2949611,0,-148
III,+,2982404,0.0,3.67342e-40,131,131,0,0,0,gene,Y55D5A.1,0,2982460,0.839118,20732,2961672,56,2982404,0,-56
III,+,2984302,0.0,0.5,1,1,0,0,1,gene,Y55D5A.1,0,2984342,0.839118,22630,2961672,40,2984302,0,-40
III,+,3068307,0.0030074,0.0,36909,36798,111,93,5,gene,H06I04.4,1,3068324,87.4885,10731,3057576,17,3068307,0,-17
III,+,3070513,0.480296,0.0288929,406,211,195,135,0,gene,H06I04.3,2,3070541,1.39039,1289,3069224,28,3070513,0,-28
III,+,3086664,0.696429,1.13743e-05,112,34,78,47,2,gene,H06I04.2,3,3086691,0.241677,1406,3085258,27,3086692,28,1
III,+,3091840,0.898305,9.69258e-30,177,18,159,118,0,gene,H06I04.1,4,3091856,0.429592,114,3091726,16,3091840,0,-16
III,+,3094834,0.0967742,2.09315e-06,31,28,3,1,1,gene,H06I04.1,4,3094891,0.429592,3108,3091726,57,3094832,-2,-59
III,+,3097438,0.0,1.69407e-21,69,69,0,0,0,gene,H06I04.1,4,3097519,0.429592,5712,3091726,81,3097438,0,-81
III,+,3129332,0.00684932,1.63672e-42,146,145,1,1,73,gene,Y53G8B.1,0,3129334,0.418365,28874,3100458,2,3129309,-23,-25
III,+,3152734,0.0,0.5,1,1,0,0,10,gene,C44B11.6,0,3152837,1.62487,220,3152514,103,3152726,-8,-111
III,+,3153115,0.0,0.5,1,1,0,0,1,gene,C44B11.6,0,3153137,1.62487,601,3152514,22,3153115,0,-22
III,+,3155257,0.0,1.16415e-10,33,33,0,0,0,gene,C44B11.1,0,3155257,0.0902468,614,3154643,0,3155258,1,1
III,+,3166274,0.0,0.0,316,316,0,0,0,gene,R148.5,0,3166293,1.57095,7717,3158557,19,3166274,0,-19
III,+,3171668,0.2,0.15625,5,4,1,1,396,gene,R148.4,0,3171702,0.377257,468,3171200,34,3171656,-12,-46
III,+,3175328,0.00123457,0.0,810,809,1,1,2,gene,R148.3,1,3175369,1.14876,495,3174833,41,3175328,0,-41
III,+,3175346,0.0,0.00195312,9,9,0,0,1783,gene,R148.3,1,3175369,1.14876,513,3174833,23,3175328,-18,-41
III,+,3183677,0.958406,0.0,577,24,553,324,77,gene,R148.2,2,3183681,0.968171,48,3183629,4,3183682,5,1
III,+,3282297,0.0384615,3.8743e-07,26,25,1,1,0,gene,Y53G8AR.7,0,3282298,0.178119,5687,3276610,1,3282297,0,-1
III,+,3286674,0.0,0.125,3,3,0,0,1,gene,Y53G8AR.7,0,3286687,0.178119,10064,3276610,13,3286675,1,-12
III,+,3294734,0.014377,0.0,626,617,9,8,0,gene,Y53G8AR.6,1,3294740,0.738582,4511,3290223,6,3294741,7,1
III,+,3297442,1.0,1.13687e-13,43,0,43,32,0,gene,Y53G8AR.5,2,3297446,0.363117,212,3297230,4,3297447,5,1
III,+,3312555,0.00843882,0.0,474,470,4,4,2,gene,Y53G8AR.3,0,3312556,1.43065,10402,3302153,1,3312555,0,-1
III,+,3322951,0.00540541,0.0,185,184,1,1,2,gene,Y53G8AR.2,0,3322962,0.668572,5201,3317750,11,3322959,8,-3
III,+,3344865,0.0,0.0,172,172,0,0,0,gene,F45H7.2,0,3344871,0.535336,10919,3333946,6,3344865,0,-6
III,+,3346008,0.0,0.25,2,2,0,0,2,gene,F45H7.2,0,3346152,0.535336,12062,3333946,144,3346014,6,-138
III,+,3346438,0.0,0.000244141,12,12,0,0,0,gene,F45H7.2,0,3346495,0.535336,12492,3333946,57,3346438,0,-57
III,+,3389908,0.0,0.0,234,234,0,0,2,gene,C56G7.3,0,3389908,0.372528,26493,3363415,0,3389908,0,0
III,+,3396571,0.00902062,0.0,1552,1538,14,13,1,gene,F59A2.3,1,3396575,7.19747,4061,3392510,4,3396571,0,-4
III,+,3397729,0.861635,7.15669e-22,159,22,137,103,2,gene,F59A2.4,2,3397739,0.718454,2,3397727,10,3397729,0,-10
III,+,3400126,0.0,3.72529e-09,28,28,0,0,0,gene,F59A2.4,2,3400183,0.718454,2399,3397727,57,3400126,0,-57
III,+,3404849,0.00599315,0.0,1168,1161,7,6,0,gene,F59A2.5,1,3404864,1.99806,4234,3400615,15,3404863,14,-1
III,+,3405556,0.931429,2.44551e-35,175,12,163,96,0,gene,F59A2.2,2,3405561,0.624581,103,3405453,5,3405562,6,1
III,+,3425716,1.0,0.5,1,0,1,1,0,gene,K01A11.2,2,3425726,0.528519,278,3425438,10,3425727,11,1
III,+,3425726,0.948837,0.0,215,11,204,135,7,gene,K01A11.2,2,3425726,0.528519,288,3425438,0,3425727,1,1
III,+,3456558,0.0,3.23117e-27,88,88,0,0,33,gene,C34C12.2,0,3456584,0.557884,419,3456139,26,3456462,-96,-122
III,+,3460391,0.010574,0.0,662,655,7,5,21,gene,C34C12.8,1,3460395,1.76716,301,3460090,4,3460391,0,-4
III,+,3461688,0.950298,0.0,503,25,478,346,0,gene,C34C12.3,2,3461688,0.887402,113,3461575,0,3461688,0,0
III,+,3471988,0.00551268,0.0,907,902,5,3,1,gene,C34C12.5,0,3471993,1.79545,4343,3467645,5,3471988,0,-5
III,+,3482575,0.00746269,6.15298e-39,134,133,1,1,2,gene,C34C12.6,0,3482579,0.560175,8872,3473703,4,3482575,0,-4
III,+,3510221,0.0247934,0.0,484,472,12,9,10,gene,M01F1.6,0,3510228,1.57913,25390,3484831,7,3510221,0,-7
III,+,3528620,1.0,7.62939e-06,17,0,17,13,3,gene,C54C6.1,0,3528625,12.6568,17625,3510995,5,3528610,-10,-15
III,+,3573571,0.0,0.00012207,13,13,0,0,0,gene,C48D5.1,0,3573661,0.111758,16960,3556611,90,3573569,-2,-92
III,+,3576176,0.0,0.00195312,9,9,0,0,1,gene,C48D5.1,0,3576336,0.111758,19565,3556611,160,3576176,0,-160
III,+,3590712,0.0,2.64698e-23,75,75,0,0,1,gene,C48D5.2,0,3590738,0.958854,11956,3578756,26,3590718,6,-20
III,+,3599119,0.0153846,1.76183e-18,65,64,1,0,10,gene,C48D5.2,0,3599129,0.958854,20363,3578756,10,3599119,0,-10
III,+,3636117,0.0,0.0078125,7,7,0,0,13,gene,C32A3.3,0,3636117,0.590074,23856,3612261,0,3636124,7,7
III,+,3636124,0.0,0.0,250,250,0,0,10,gene,C32A3.3,0,3636196,0.590074,23863,3612261,72,3636124,0,-72
III,+,3636129,0.00492611,0.0,203,202,1,0,35,gene,C32A3.3,0,3636196,0.590074,23868,3612261,67,3636129,0,-67
III,+,3644366,0.0,2.38419e-07,22,22,0,0,0,gene,C46F11.1,0,3644368,0.0937421,864,3643502,2,3644366,0,-2
III,+,3651302,0.0,4.65661e-10,31,31,0,0,1,gene,C46F11.2,0,3651314,3.20774,2501,3648801,12,3651308,6,-6
III,+,3651308,0.00832466,0.0,961,953,8,6,8,gene,C46F11.2,0,3651314,3.20774,2507,3648801,6,3651308,0,-6
III,+,3702297,0.00840336,0.0,476,472,4,4,17,gene,C14B1.2,0,3702305,1.29383,36227,3666070,8,3702261,-36,-44
III,+,3703645,0.111111,0.000583649,18,16,2,2,162,gene,C14B1.3,1,3703658,0.554556,494,3703151,13,3703627,-18,-31
III,+,3705264,0.00951087,0.0,736,729,7,6,147,gene,C14B1.4,2,3705265,1.99285,230,3705034,1,3705244,-20,-21
III,+,3706851,1.0,0.5,1,0,1,1,0,gene,C14B1.5,3,3706865,0.754605,87,3706764,14,3706866,15,1
III,+,3706865,0.96875,0.0,384,12,372,245,2,gene,C14B1.5,3,3706865,0.754605,101,3706764,0,3706866,1,1
III,+,3709309,0.931035,1.13841e-40,203,14,189,132,0,gene,C14B1.10,4,3709341,0.443885,107,3709202,32,3709309,0,-32
III,+,3713442,0.871795,1.2054e-38,273,35,238,170,6,gene,C14B1.6,5,3713475,0.446972,111,3713331,33,3713442,0,-33
III,+,3730808,0.0,0.25,2,2,0,0,31,gene,F34D10.8,0,3730835,2.71442,12083,3718725,27,3730808,0,-27
III,+,3736581,0.00518135,0.0,193,192,1,1,0,gene,F34D10.4,0,3736602,0.767174,1728,3734853,21,3736581,0,-21
III,+,3745424,0.0,3.8147e-06,18,18,0,0,1,gene,F34D10.5,0,3745439,0.136119,5680,3739744,15,3745440,16,1
III,+,3745440,0.0,0.5,1,1,0,0,110,gene,F34D10.5,0,3745453,0.136119,5696,3739744,13,3745440,0,-13
III,+,3822382,0.0108696,1.85793e-26,92,91,1,0,2,gene,R13G10.2,0,3822408,0.305025,52080,3770302,26,3822382,0,-26
III,+,3822407,1.0,0.5,1,0,1,1,170,gene,R13G10.2,0,3822408,0.305025,52105,3770302,1,3822382,-25,-26
III,+,3835199,0.0425532,7.68097e-12,47,45,2,0,8,gene,C36A4.2,0,3835330,0.24314,632,3834567,131,3835199,0,-131
III,+,3864015,0.0555556,6.86646e-05,18,17,1,1,1,gene,C36A4.9,0,3864407,3.81203,7735,3856280,392,3864015,0,-392
III,+,3864468,0.00294659,0.0,2715,2707,8,8,3,gene,C36A4.9,0,3864483,3.81203,8188,3856280,15,3864468,0,-15
III,+,3867832,0.00657375,0.0,27838,27655,183,154,3,gene,F13B10.2,0,3867840,140.346,756,3867076,8,3867832,0,-8
III,+,3916944,0.00363331,0.0,3578,3565,13,13,6,gene,ZK1058.4,1,3916972,4.22134,47421,3869523,28,3916944,0,-28
III,+,3918848,0.96875,1.09288e-16,64,2,62,39,0,gene,ZK1058.3,2,3918849,0.189562,60,3918788,1,3918848,0,-1
III,+,3922422,0.0,0.0,153,153,0,0,3,gene,ZK1058.6,0,3922428,0.515314,1756,3920666,6,3922422,0,-6
III,+,3956612,0.00784314,0.0,255,253,2,0,2,gene,F37A8.5,0,3956612,1.21597,4522,3952090,0,3956601,-11,-11
III,+,4006119,0.00306279,0.0,653,651,2,2,1,gene,C36E8.3,0,4006137,0.69709,17567,3988552,18,4006119,0,-18
III,+,4006126,0.0,2.11758e-22,72,72,0,0,184,gene,C36E8.3,0,4006137,0.69709,17574,3988552,11,4006119,-7,-18
III,+,4012313,0.00564972,0.0,177,176,1,1,0,gene,C36E8.4,0,4012320,0.264056,2374,4009939,7,4012313,0,-7
III,+,4022140,0.818605,2.18246e-22,215,39,176,119,1,gene,T02C12.3,2,4022144,0.583215,290,4021850,4,4022139,-1,-5
III,+,4049650,0.0,0.125,3,3,0,0,0,gene,E03A3.10,0,4049652,None,24020,4025630,2,4049470,-180,-182
III,+,4066608,0.0212766,3.33955e-13,47,46,1,0,0,gene,E03A3.6,0,4066619,0.13597,14147,4052461,11,4066690,82,71
III,+,4121366,0.0,0.00195312,9,9,0,0,0,gene,C30D11.1,0,4121422,0.269497,24110,4097256,56,4121437,71,15
III,+,4134101,0.0,0.00012207,13,13,0,0,0,gene,C30D11.1,0,4134202,0.269497,12403,4121698,101,4134203,102,1
III,+,4138629,0.0,2.91038e-11,35,35,0,0,6,gene,C30D11.1,0,4138645,0.269497,4250,4134379,16,4138685,56,40
III,+,4152027,0.00578846,0.0,5701,5668,33,30,3,gene,C16C10.11,1,4152029,10.741,4777,4147250,2,4152027,0,-2
III,+,4153572,0.484921,0.0126757,1260,649,611,429,4,gene,C16C10.10,2,4153573,1.04425,688,4152884,1,4153574,2,1
III,+,4171309,0.0120555,0.0,1659,1639,20,18,1,gene,C16C10.4,0,4171312,4.32248,9516,4161793,3,4171309,0,-3
III,+,4191521,0.0,0.0,230,230,0,0,19,gene,R74.4,1,4191534,1.13323,2263,4189258,13,4191521,0,-13
III,+,4193639,0.833333,0.09375,6,1,5,2,7,gene,R74.3,2,4193644,10.44,239,4193400,5,4193794,155,150
III,+,4193801,0.79845,1.8302e-12,129,26,103,73,75,gene,R74.3,2,4193955,10.44,401,4193400,154,4193794,-7,-161
III,+,4197258,0.0522979,0.0,631,598,33,24,0,gene,R74.5,3,4197270,2.50885,1920,4195338,12,4197258,0,-12
III,+,4198842,0.0,0.03125,5,5,0,0,5,gene,R74.5,3,4198886,2.50885,1105,4197737,44,4198842,0,-44
III,+,4204402,0.00327332,0.0,611,609,2,1,0,gene,R74.7,1,4204410,1.06574,2131,4202271,8,4204402,0,-8
III,+,4206250,0.0590015,0.0,661,622,39,35,11,gene,R74.8,2,4206277,1.64566,463,4205787,27,4206250,0,-27
III,+,4229152,0.0,3.63798e-12,38,38,0,0,9,gene,F43C1.5,0,4229168,0.11818,12474,4216678,16,4229169,17,1
III,+,4270229,0.0052356,0.0,191,190,1,0,2,gene,R10E4.1,0,4270242,1.42416,39864,4230365,13,4270229,0,-13
III,+,4313899,0.00178891,0.0,1118,1116,2,2,2,gene,H38K22.2,1,4313919,2.02582,17033,4296866,20,4313899,0,-20
III,+,4317674,0.639413,2.62795e-10,477,172,305,197,4,gene,H38K22.3,2,4317698,0.892401,97,4317577,24,4317674,0,-24
III,+,4332970,0.00510204,0.0,196,195,1,0,7,gene,B0285.1,0,4333042,0.988955,8649,4324321,72,4333368,398,326
III,+,4333366,0.00714286,1.00445e-40,140,139,1,1,0,gene,B0285.1,0,4333367,0.988955,1,4333365,1,4333368,2,1
III,+,4343418,0.00754717,0.0,530,526,4,4,4,gene,B0285.4,1,4343431,0.839507,1447,4341971,13,4343432,14,1
III,+,4345310,0.918367,0.0,294,24,270,199,5,gene,B0285.5,2,4345312,0.649396,121,4345189,2,4345310,0,-2
III,+,4365348,0.0,1.13687e-13,43,43,0,0,6,gene,B0285.8,1,4365410,0.173621,413,4364935,62,4365411,63,1
III,+,4367582,1.0,0.25,2,0,2,0,0,gene,B0285.9,2,4367595,0.414222,142,4367440,13,4367803,221,208
III,+,4367881,0.5,0.3125,6,3,3,1,151,gene,B0285.9,2,4367946,0.414222,441,4367440,65,4367803,-78,-143
III,+,4367920,0.0659341,3.10558e-37,182,170,12,6,7,gene,B0285.9,2,4367946,0.414222,480,4367440,26,4367803,-117,-143
III,+,4370808,0.0,0.0625,4,4,0,0,1,gene,B0285.10,0,4370855,0.011669,677,4370131,47,4370856,48,1
III,+,4373244,0.0,0.015625,6,6,0,0,9,gene,B0284.5,0,4373295,None,453,4372791,51,4373150,-94,-145
III,+,4376436,0.117647,8.0887e-14,85,75,10,5,41,gene,B0284.1,0,4376473,0.284486,1422,4375014,37,4376474,38,1
III,+,4381612,0.0,0.000976562,10,10,0,0,7,gene,B0284.2,0,4381621,0.135334,2003,4379609,9,4381710,98,89
III,+,4394767,0.00324149,0.0,617,615,2,1,1,gene,R07E5.4,1,4394826,1.63994,6827,4387940,59,4394767,0,-59
III,+,4397395,0.4,0.205078,10,6,4,4,1,gene,R07E5.5,2,4397398,0.0083421,806,4396589,3,4397401,6,3
III,+,4404757,0.0165441,0.0,544,535,9,8,0,gene,R07E5.3,1,4404759,2.86327,2284,4402473,2,4404757,0,-2
III,+,4406257,0.00804721,0.0,1864,1849,15,15,7,gene,R07E5.14,2,4406288,5.58454,1,4406256,31,4406257,0,-31
III,+,4407415,0.924509,0.0,3007,227,2780,1918,37,gene,R07E5.2,3,4407559,5.26029,121,4407294,144,4407415,0,-144
III,+,4408522,0.925234,2.00882e-21,107,8,99,71,1,gene,R07E5.1,4,4408535,0.38614,116,4408406,13,4408522,0,-13
III,+,4413428,0.306407,2.67851e-38,1077,747,330,260,21,gene,R07E5.13,5,4413483,2.67463,1247,4412181,55,4413428,0,-55
III,+,4419819,0.00378788,0.0,264,263,1,1,1,gene,R07E5.8,0,4419826,0.453183,5092,4414727,7,4419819,0,-7
III,+,4419825,0.0,9.18355e-41,133,133,0,0,32,gene,R07E5.8,0,4419826,0.453183,5098,4414727,1,4419825,0,-1
III,+,4442052,0.000829187,0.0,1206,1205,1,1,5,gene,C28A5.3,0,4442063,0.558271,18709,4423343,11,4442052,0,-11
III,+,4475886,0.00369753,0.0,38404,38262,142,119,2,gene,F56F3.5,0,4475914,113.713,5105,4470781,28,4475886,0,-28
III,+,4489327,0.00411787,0.0,7771,7739,32,31,11,gene,C07G2.1,0,4489330,11.7357,12439,4476888,3,4489327,0,-3
III,+,4520330,0.0,1.73472e-18,59,59,0,0,0,gene,F25F2.2,0,4520354,0.646332,8203,4512127,24,4520332,2,-22
III,+,4542848,0.00196657,0.0,1017,1015,2,2,87,gene,M88.7,0,4542848,0.574794,5892,4536956,0,4542848,0,0
III,+,4549012,0.0,3.05176e-05,15,15,0,0,0,gene,M88.4,0,4549020,0.126582,3030,4545982,8,4549030,18,10
III,+,4553585,0.00256739,0.0,779,777,2,2,0,gene,M88.5,0,4553679,1.66477,2051,4551534,94,4553636,51,-43
III,+,4553656,0.0285714,1.01863e-09,35,34,1,1,113,gene,M88.5,0,4553679,1.66477,2122,4551534,23,4553636,-20,-43
III,+,4562705,0.00330396,0.0,908,905,3,3,2,gene,M88.6,0,4562719,1.85265,2305,4560400,14,4562705,0,-14
III,+,4568980,0.00813008,0.0,1476,1464,12,11,1,gene,F35G12.2,0,4568990,3.98995,2739,4566241,10,4568980,0,-10
III,+,4578822,0.00507614,0.0,394,392,2,2,0,gene,F35G12.4,1,4578838,0.720674,6998,4571824,16,4578822,0,-16
III,+,4581762,0.946,0.0,500,27,473,343,1,gene,F35G12.12,2,4581780,0.888147,99,4581663,18,4581762,0,-18
III,+,4584552,0.72695,4.33368e-15,282,77,205,169,1,gene,F35G12.5,3,4584569,0.24395,692,4583860,17,4584899,347,330
III,+,4587468,0.00673401,0.0,297,295,2,0,90,gene,F35G12.8,1,4587472,1.00019,914,4586554,4,4587473,5,1
III,+,4593198,0.841121,0.0,749,119,630,481,4,gene,F35G12.11,2,4593199,2.03227,107,4593091,1,4593198,0,-1
III,+,4622998,0.0,1.19209e-07,23,23,0,0,1,gene,F10F2.4,0,4623018,0.12271,4141,4618857,20,4623019,21,1
III,+,4650459,0.00353357,0.0,566,564,2,1,0,gene,T23F11.1,0,4650462,2.70281,9932,4640527,3,4650459,0,-3
III,+,4658834,0.0,0.0,353,353,0,0,4,gene,T23F11.3,0,4658865,0.70869,4943,4653891,31,4658834,0,-31
III,+,4677729,0.0,0.25,2,2,0,0,0,gene,T04A8.1,0,4677730,0.00205147,3557,4674172,1,4677731,2,1
III,+,4693956,0.0,0.0078125,7,7,0,0,0,gene,T04A8.8,1,4693968,1.5735,1838,4692118,12,4693959,3,-9
III,+,4693967,0.0111675,0.0,985,974,11,10,8,gene,T04A8.8,1,4693968,1.5735,1849,4692118,1,4693959,-8,-9
III,+,4695325,0.959701,0.0,670,27,643,405,2,gene,T04A8.7,2,4695334,1.32988,93,4695232,9,4695325,0,-9
III,+,4698083,0.957576,1.24163e-38,165,7,158,116,0,gene,T04A8.9,3,4698089,0.97133,110,4697973,6,4698083,0,-6
III,+,4704368,0.00338983,0.0,295,294,1,1,0,gene,T04A8.11,1,4704370,1.25381,5025,4699343,2,4704368,0,-2
III,+,4705471,0.953704,0.0,216,10,206,148,1,gene,T04A8.12,2,4705482,0.578818,103,4705368,11,4705377,-94,-105
III,+,4705475,1.0,1.90735e-06,19,0,19,10,89,gene,T04A8.12,2,4705482,0.578818,107,4705368,7,4705377,-98,-105
III,+,4709197,0.0,1.83671e-40,132,132,0,0,3,gene,T04A8.18,0,4709211,None,793,4708404,14,4709212,15,1
III,+,4731902,0.0,5.55112e-17,54,54,0,0,2,gene,F17C8.3,0,4731907,0.28521,1019,4730883,5,4731902,0,-5
III,+,4734302,0.0,0.0078125,7,7,0,0,7,gene,F17C8.9,0,4734306,None,69,4734233,4,4734421,119,115
III,+,4754467,0.0,0.015625,6,6,0,0,19,gene,B0393.2,1,4754562,1.10395,4351,4750116,95,4754552,85,-10
III,+,4754552,0.00759494,0.0,395,392,3,3,1,gene,B0393.2,1,4754562,1.10395,4436,4750116,10,4754552,0,-10
III,+,4757222,0.276923,1.17458e-07,130,94,36,32,412,gene,B0393.3,2,4757265,1.28928,241,4756981,43,4757212,-10,-53
III,+,4786044,0.0190476,0.0,210,206,4,4,0,gene,C38D4.3,1,4786044,1.06645,9738,4776306,0,4786044,0,0
III,+,4793050,0.00591327,0.0,1522,1513,9,9,1,gene,C38D4.4,2,4793069,0.580008,660,4792390,19,4793050,0,-19
III,+,4793151,0.0,0.5,1,1,0,0,24,gene,C38D4.4,2,4793183,0.580008,761,4792390,32,4793050,-101,-133
III,+,4796805,0.294479,2.30576e-14,326,230,96,79,1,gene,C38D4.5,3,4796823,0.788769,1419,4795386,18,4796805,0,-18
III,+,4802971,0.989474,2.39814e-27,95,1,94,58,0,gene,C38D4.9,4,4802994,0.346578,100,4802871,23,4802971,0,-23
III,+,4837694,0.0,5.60519e-45,147,147,0,0,0,gene,F26A1.15,0,4837697,0.133774,8761,4828933,3,4837698,4,1
III,+,4850470,0.00447427,0.0,894,890,4,4,17,gene,F26A1.1,1,4850500,0.983997,3918,4846552,30,4850471,1,-29
III,+,4852288,0.841935,1.70788e-36,310,49,261,183,77,gene,C35D10.9,2,4852304,0.514588,415,4851873,16,4852288,0,-16
III,+,4856156,0.976378,1.9594e-33,127,3,124,81,0,gene,C35D10.7,4,4856165,0.562139,92,4856064,9,4856156,0,-9
III,+,4856822,0.0617284,1.05968e-17,81,76,5,5,0,gene,C35D10.7,4,4856947,0.562139,758,4856064,125,4856822,0,-125
III,+,4859302,0.968318,0.0,1231,39,1192,906,4,gene,C35D10.6,5,4859306,1.17622,99,4859203,4,4859302,0,-4
III,+,4862314,0.0,0.0,429,429,0,0,8,gene,C35D10.5,0,4862314,0.770961,1511,4860803,0,4862354,40,40
III,+,4863390,0.0175439,0.0,171,168,3,3,2,gene,C35D10.4,1,4863400,0.672805,1,4863389,10,4863390,0,-10
III,+,4867025,0.968652,0.0,957,30,927,539,16,gene,C35D10.17,2,4867026,2.1738,113,4866912,1,4867025,0,-1
III,+,4867093,0.857143,0.0546875,7,1,6,3,389,gene,C35D10.17,2,4867094,2.1738,181,4866912,1,4867025,-68,-69
III,+,4878202,0.0,0.5,1,1,0,0,368,gene,C35D10.16,1,4878259,4.34622,6194,4872008,57,4878626,424,367
III,+,4878623,0.00260824,0.0,1917,1912,5,3,1,gene,C35D10.16,1,4878625,4.34622,6615,4872008,2,4878626,3,1
III,+,4879708,0.905797,0.0,828,78,750,543,0,gene,C35D10.1,2,4879709,1.55277,74,4879634,1,4879708,0,-1
III,+,4900687,0.00609756,0.0,164,163,1,1,3,gene,F26F4.4,0,4900697,0.810634,19232,4881455,10,4900687,0,-10
III,+,4907172,0.00239234,0.0,418,417,1,1,4,gene,F26F4.3,0,4907188,0.263172,4008,4903164,16,4907189,17,1
III,+,4912662,0.0545455,7.28168e-13,55,52,3,2,0,gene,F26F4.1,0,4912666,1.17519,236,4912426,4,4912662,0,-4
III,+,4932415,0.0,0.0,163,163,0,0,2,gene,C26E6.7,1,4932441,0.556014,602,4931813,26,4932440,25,-1
III,+,4932438,0.0,0.25,2,2,0,0,366,gene,C26E6.7,1,4932441,0.556014,625,4931813,3,4932440,2,-1
III,+,4932537,0.0,0.0078125,7,7,0,0,33,gene,C26E6.7,1,4932586,0.556014,724,4931813,49,4932537,0,-49
III,+,4932587,0.0130719,1.01874e-42,153,151,2,2,74,gene,C26E6.7,1,4932762,0.556014,774,4931813,175,4932587,0,-175
III,+,4935541,0.16886,0.0,1368,1137,231,179,1,gene,C26E6.6,2,4935587,1.28167,636,4934905,46,4935541,0,-46
III,+,4937285,0.868668,0.0,1066,140,926,633,3,gene,C26E6.5,3,4937287,1.31928,101,4937184,2,4937301,16,14
III,+,4939529,0.870674,0.0,549,71,478,316,2,gene,C26E6.4,4,4939563,1.38315,114,4939415,34,4939529,0,-34
III,+,4944466,0.884211,1.97111e-15,95,11,84,60,2,gene,C26E6.3,5,4944501,0.889232,100,4944366,35,4944475,9,-26
III,+,4944475,0.944079,0.0,304,17,287,206,373,gene,C26E6.3,5,4944501,0.889232,109,4944366,26,4944475,0,-26
III,+,4952085,0.0102041,0.0,196,194,2,2,0,gene,C26E6.2,0,4952093,0.665037,4808,4947277,8,4952085,0,-8
III,+,4965533,0.0,0.125,3,3,0,0,1,gene,C27F2.2,0,4965539,0.0706444,7905,4957628,6,4965623,90,84
III,+,4970173,0.0,0.00195312,9,9,0,0,0,gene,C27F2.2,0,4970210,0.0706444,12545,4957628,37,4970173,0,-37
III,+,4999345,0.00700935,0.0,428,425,3,3,7,gene,R144.5,0,4999346,0.354185,7936,4991409,1,4999347,2,1
III,+,5018608,0.00696864,0.0,287,285,2,2,0,gene,R144.4,1,5018610,1.09372,17306,5001302,2,5018611,3,1
III,+,5021187,0.851782,0.0,533,79,454,307,0,gene,R144.9,2,5021188,0.897012,106,5021081,1,5021189,2,1
III,+,5022010,0.934866,0.0,261,17,244,166,3,gene,R144.3,3,5022156,0.814821,89,5021921,146,5022010,0,-146
III,+,5023283,0.5,0.3125,6,3,3,1,37,gene,R144.13,1,5023286,0.581194,113,5023170,3,5023287,4,1
III,+,5024876,0.0137702,0.0,2106,2077,29,19,14,gene,R144.2,2,5025005,1.59742,849,5024027,129,5025332,456,327
III,+,5025307,0.0167364,0.0,239,235,4,2,6,gene,R144.2,2,5025367,1.59742,251,5025056,60,5025371,64,4
III,+,5030909,0.5,0.5,2,1,1,1,0,gene,R144.1,0,5030912,0.0703596,472,5030437,3,5030893,-16,-19
III,+,5036544,0.0,0.00390625,8,8,0,0,8,gene,C45G9.6,0,5036681,0.709952,4,5036540,137,5036682,138,1
III,+,5036553,0.0,0.015625,6,6,0,0,29,gene,C45G9.6,0,5036681,0.709952,13,5036540,128,5036682,129,1
III,+,5042391,0.0,2.27374e-13,42,42,0,0,0,gene,C45G9.13,0,5042432,0.750198,2015,5040376,41,5042389,-2,-43
III,+,5044974,0.125,0.00183105,16,14,2,0,0,gene,C45G9.14,0,5044989,0.0119714,343,5044631,15,5045060,86,71
III,+,5048080,0.00513347,0.0,974,969,5,4,1,gene,C45G9.5,0,5048086,0.580463,2456,5045624,6,5048080,0,-6
III,+,5077726,0.00352526,0.0,1702,1696,6,6,0,gene,F54D8.3,0,5077726,4.79174,1797,5075929,0,5077726,0,0
III,+,5081687,0.00154697,0.0,30382,30335,47,42,158,gene,F54D8.2,0,5081695,19.6117,1055,5080632,8,5081687,0,-8
III,+,5107289,0.00259875,0.0,1924,1919,5,5,8,gene,F54D8.1,0,5107291,18.4233,370,5106919,2,5107289,0,-2
III,+,5109660,0.0107527,0.0,186,184,2,1,0,gene,F21H11.2,0,5109786,0.664281,1203,5108457,126,5109660,0,-126
III,+,5153423,0.0,5.82077e-11,34,34,0,0,4,gene,Y54H5A.1,0,5153504,1.62745,22792,5130631,81,5153423,0,-81
III,+,5153502,0.00179319,0.0,1673,1670,3,3,15,gene,Y54H5A.1,0,5153504,1.62745,22871,5130631,2,5153502,0,-2
III,+,5155962,0.0,0.0078125,7,7,0,0,123,gene,Y54H5A.5,0,5156115,None,532,5155430,153,5156393,431,278
III,+,5156615,0.0,0.5,1,1,0,0,2,gene,Y54H5A.5,0,5156721,None,1185,5155430,106,5156393,-222,-328
III,+,5173398,0.887798,0.0,3057,343,2714,2181,2,gene,K10D2.4,2,5173404,6.53945,107,5173291,6,5173398,0,-6
III,+,5173881,0.97549,0.0,204,5,199,150,0,gene,K10D2.3,3,5173950,0.719305,115,5173766,69,5173904,23,-46
III,+,5185879,0.0137825,0.0,1959,1932,27,25,0,gene,K10D2.2,0,5185879,3.17349,4908,5180971,0,5185879,0,0
III,+,5191090,0.00531915,0.0,188,187,1,0,55,gene,K10D2.1,0,5191129,0.389494,956,5190134,39,5191090,0,-39
III,+,5196020,0.03125,1.09288e-16,64,62,2,1,6,gene,K10D2.7,0,5196020,0.251567,18,5196002,0,5196013,-7,-7
III,+,5225582,0.00261461,0.0,5737,5722,15,10,6,gene,ZC155.1,0,5225582,7.19892,5532,5220050,0,5225582,0,0
III,+,5228376,0.00718563,0.0,5845,5803,42,42,1,gene,C34E10.6,1,5228386,43.7893,1597,5226779,10,5228376,0,-10
III,+,5230529,0.958333,0.0,360,15,345,268,5,gene,C34E10.5,2,5230537,0.735066,17,5230512,8,5230529,0,-8
III,+,5234576,0.937659,0.0,786,49,737,525,1,gene,C34E10.11,3,5234576,1.29206,115,5234461,0,5234577,1,1
III,+,5236369,0.0,3.8147e-06,18,18,0,0,0,gene,C34E10.4,4,5236389,0.395439,45,5236324,20,5236369,0,-20
III,+,5236851,0.930693,6.78405e-21,101,7,94,74,1,gene,C34E10.4,4,5238097,0.395439,527,5236324,1246,5236851,0,-1246
III,+,5237003,0.818182,0.0268555,11,2,9,9,0,gene,C34E10.4,4,5238097,0.395439,679,5236324,1094,5237003,0,-1094
III,+,5237674,0.882353,0.0010376,17,2,15,13,2,gene,C34E10.4,4,5238097,0.395439,1350,5236324,423,5237674,0,-423
III,+,5254397,0.0,0.0,190,190,0,0,0,gene,C34E10.3,1,5254397,0.351794,14383,5240014,0,5254429,32,32
III,+,5258982,0.929878,0.0,328,23,305,207,1,gene,C34E10.2,2,5258991,0.930911,274,5258708,9,5258982,0,-9
III,+,5260653,0.842239,0.0,786,124,662,456,0,gene,C34E10.1,3,5260666,1.76642,189,5260464,13,5260653,0,-13
III,+,5263902,0.944444,0.0,378,21,357,203,0,gene,ZC395.7,4,5263907,0.726762,106,5263796,5,5263902,0,-5
III,+,5265072,0.865385,3.92042e-15,104,14,90,64,13,gene,ZC395.6,5,5265094,0.288025,82,5264990,22,5265072,0,-22
III,+,5275374,0.00632911,0.0,474,471,3,3,2,gene,ZC395.3,1,5275387,1.46094,4380,5270994,13,5275374,0,-13
III,+,5277853,0.925508,0.0,443,33,410,275,2,gene,ZC395.2,2,5277931,0.950952,97,5277756,78,5277853,0,-78
III,+,5288139,0.0,7.45058e-09,27,27,0,0,1,gene,T15B12.1,0,5288141,1.10536,8840,5279299,2,5288139,0,-2
III,+,5294530,0.0,0.00012207,13,13,0,0,0,gene,T15B12.1,0,5294599,1.10536,15231,5279299,69,5294579,49,-20
III,+,5294579,0.00722022,0.0,277,275,2,1,5,gene,T15B12.1,0,5294599,1.10536,15280,5279299,20,5294579,0,-20
III,+,5302177,0.0,0.000488281,11,11,0,0,0,gene,F52C9.5,0,5302291,0.0377927,3424,5298753,114,5302177,0,-114
III,+,5308561,0.00862069,0.0,464,460,4,4,1,gene,F52C9.7,1,5308570,1.12521,2278,5306283,9,5308561,0,-9
III,+,5311205,0.910714,0.0,616,55,561,370,0,gene,F52C9.8,2,5311218,1.73523,110,5311095,13,5311205,0,-13
III,+,5311217,1.0,0.5,1,0,1,0,2173,gene,F52C9.8,2,5311218,1.73523,122,5311095,1,5311219,2,1
III,+,5319523,0.0,0.0,287,287,0,0,10,gene,F52C9.8,2,5319529,1.73523,3919,5315604,6,5319523,0,-6
III,+,5321765,1.0,0.125,3,0,3,0,0,gene,F52C9.3,3,5321850,0.634329,74,5321691,85,5321741,-24,-109
III,+,5321849,0.934783,1.0998e-28,138,9,129,74,30,gene,F52C9.3,3,5321850,0.634329,158,5321691,1,5321741,-108,-109
III,+,5326582,0.891304,1.45618e-15,92,10,82,40,0,gene,F52C9.1,4,5326589,0.323467,278,5326304,7,5326582,0,-7
III,+,5341642,0.0,1.20371e-35,116,116,0,0,0,gene,ZK121.2,0,5341647,0.519679,8064,5333578,5,5341648,6,1
III,+,5362241,0.0,0.00195312,9,9,0,0,0,gene,Y32H12A.1,0,5362244,0.0157979,17772,5344469,3,5362167,-74,-77
III,+,5405993,0.0,0.000976562,10,10,0,0,0,gene,W03A5.2,0,5406093,0.190195,41663,5364330,100,5406074,81,-19
III,+,5443125,0.0,0.0,250,250,0,0,12,gene,F48E8.6,0,5443263,0.678989,5287,5437838,138,5443264,139,1
III,+,5450687,0.00418092,0.0,5262,5240,22,18,3,gene,F48E8.5,1,5450697,7.08751,4224,5446463,10,5450687,0,-10
III,+,5453547,0.79,2.54323e-25,300,63,237,165,1,gene,F48E8.4,2,5453551,0.639717,453,5453094,4,5453563,16,12
III,+,5461336,0.951941,0.0,541,26,515,314,2,gene,F48E8.3,3,5461342,1.31176,1977,5459359,6,5461336,0,-6
III,+,5461371,0.941176,0.0001297,17,1,16,8,485,gene,F48E8.3,3,5461372,1.31176,2012,5459359,1,5461371,0,-1
III,+,5464340,0.135266,1.65617e-28,207,179,28,23,7,gene,F48E8.2,4,5464354,0.350038,163,5464177,14,5464355,15,1
III,+,5474436,0.0011308,0.0,2653,2650,3,2,40,gene,F48E8.1,0,5474470,3.68745,6478,5467958,34,5474436,0,-34
III,+,5484247,0.00694444,0.0,288,286,2,1,1,gene,R02F2.4,0,5484250,0.407992,4011,5480236,3,5484247,0,-3
III,+,5487513,0.0,2.22045e-16,52,52,0,0,0,gene,R02F2.2,0,5487599,0.199879,1550,5485963,86,5487600,87,1
III,+,5499189,0.00641026,0.0,312,310,2,2,94,gene,R02F2.9,0,5499189,1.29387,276,5498913,0,5499182,-7,-7
III,+,5501848,0.00194932,0.0,513,512,1,0,129,gene,R02F2.1,0,5501866,12.7097,1916,5499932,18,5501848,0,-18
III,+,5504593,0.00786276,0.0,1399,1388,11,10,10,gene,R02F2.1,0,5504630,12.7097,4661,5499932,37,5504593,0,-37
III,+,5527704,0.0,0.0,224,224,0,0,0,gene,D1044.2,0,5527712,0.93539,21367,5506337,8,5527713,9,1
III,+,5544259,0.00847458,3.55093e-34,118,117,1,1,2,gene,D1044.1,0,5544259,0.172523,8809,5535450,0,5544260,1,1
III,+,5547066,0.0172414,2.01228e-16,58,57,1,1,5,gene,F09F7.5,0,5547080,0.396311,823,5546243,14,5547066,0,-14
III,+,5555406,0.0087146,0.0,459,455,4,4,155,gene,F09F7.4,1,5555409,2.59404,4219,5551187,3,5555406,0,-3
III,+,5555540,0.0,9.40395e-38,123,123,0,0,1,gene,F09F7.4,1,5555554,2.59404,4353,5551187,14,5555540,0,-14
III,+,5557321,0.946429,0.0,336,18,318,233,0,gene,F09F7.3,2,5557382,1.11734,112,5557209,61,5557321,0,-61
III,+,5564794,0.0,0.25,2,2,0,0,2,gene,F09F7.2,0,5565087,24.5461,1,5564793,293,5565006,212,-81
III,+,5573950,0.010989,3.67546e-26,91,90,1,1,0,gene,F09F7.1,0,5573959,0.180628,6612,5567338,9,5573950,0,-9
III,+,5587218,0.0222222,0.0,180,176,4,4,0,gene,F56D2.2,0,5587320,0.901231,213,5587005,102,5587218,0,-102
III,+,5592090,0.0138581,0.0,1804,1779,25,20,1,gene,F56D2.1,1,5592112,9.31883,3009,5589081,22,5592090,0,-22
III,+,5595726,0.296392,1.82372e-16,388,273,115,91,11,gene,F56D2.7,2,5595792,0.788511,986,5594740,66,5595726,0,-66
III,+,5604414,0.00749064,0.0,534,530,4,4,0,gene,C05D2.5,0,5604414,0.63942,6396,5598018,0,5604414,0,0
III,+,5612228,0.0,2.01948e-28,92,92,0,0,1,gene,C05D2.4,0,5612242,0.462042,4725,5607503,14,5612228,0,-14
III,+,5625096,0.00543478,0.0,368,366,2,2,2,gene,C05D2.1,0,5625255,0.645077,7893,5617203,159,5625096,0,-159
III,+,5626561,0.0,0.5,1,1,0,0,1,gene,C05D2.1,0,5626616,0.645077,9358,5617203,55,5626561,0,-55
III,+,5635433,0.0,0.00012207,13,13,0,0,2,gene,C05H8.1,0,5635442,0.252305,2999,5632434,9,5635433,0,-9
III,+,5664187,0.0,0.0,475,475,0,0,0,gene,F54E7.3,0,5664323,1.34533,9677,5654510,136,5664324,137,1
III,+,5664314,0.0,0.125,3,3,0,0,3,gene,F54E7.3,0,5664323,1.34533,9804,5654510,9,5664314,0,-9
III,+,5668489,0.00677201,0.0,443,440,3,3,2,gene,F54E7.3,0,5668491,1.34533,13979,5654510,2,5668492,3,1
III,+,5679249,0.00553827,0.0,68794,68413,381,332,363,gene,F54E7.2,1,5679280,146.263,2500,5676749,31,5679249,0,-31
III,+,5679261,0.0,0.00012207,13,13,0,0,142150,gene,F54E7.2,1,5679280,146.263,2512,5676749,19,5679249,-12,-31
III,+,5680404,1.0,0.03125,5,0,5,3,3,gene,F54E7.1,2,5680448,0.608737,272,5680132,44,5680449,45,1
III,+,5680481,0.718182,1.66325e-06,110,31,79,48,35,gene,F54E7.1,2,5680487,0.608737,349,5680132,6,5680509,28,22
III,+,5680661,1.0,0.000976562,10,0,10,7,1,gene,F54E7.1,2,5680666,0.608737,529,5680132,5,5680661,0,-5
III,+,5681325,0.0,0.5,1,1,0,0,0,gene,F54E7.1,2,5681373,0.608737,1193,5680132,48,5681325,0,-48
III,+,5693987,0.921647,0.0,753,59,694,541,0,gene,B0336.13,2,5693998,1.02608,101,5693886,11,5693987,0,-11
III,+,5693997,0.75,0.000770943,40,10,30,21,1347,gene,B0336.13,2,5693998,1.02608,111,5693886,1,5693987,-10,-11
III,+,5711499,0.00668151,0.0,449,446,3,3,0,gene,B0336.3,1,5711536,1.57567,9244,5702255,37,5711499,0,-37
III,+,5716066,0.269029,0.0,5334,3899,1435,987,8,gene,B0336.2,2,5716066,13.0413,1272,5714794,0,5716066,0,0
III,+,5722789,0.0,1.52588e-05,16,16,0,0,5,gene,B0336.1,0,5722832,0.704009,5253,5717536,43,5722800,11,-32
III,+,5722800,0.0186916,0.0,214,210,4,4,56,gene,B0336.1,0,5722832,0.704009,5264,5717536,32,5722800,0,-32
III,+,5728130,0.0164234,0.0,548,539,9,9,15,gene,B0244.8,0,5728132,2.56208,1065,5727065,2,5728130,0,-2
III,+,5770132,0.0,9.62965e-35,113,113,0,0,0,gene,Y37B11A.1,0,5770135,0.432348,4367,5765765,3,5770136,4,1
III,+,5799000,0.0425532,7.68097e-12,47,45,2,2,6,gene,W03A3.1,0,5799023,0.0988841,24466,5774534,23,5799024,24,1
III,+,5803211,0.00995025,0.0,201,199,2,2,38,gene,R12B2.4,0,5803215,0.860364,2150,5801061,4,5803211,0,-4
III,+,5816227,0.0,0.0,303,303,0,0,258,gene,R12B2.1,0,5816228,0.517782,843,5815384,1,5816227,0,-1
III,+,5823870,0.0147059,2.30393e-19,68,67,1,0,0,gene,R12B2.8,0,5823897,0.355591,3718,5820152,27,5823909,39,12
III,+,5857161,0.00218978,0.0,2740,2734,6,4,8,gene,F01F1.6,1,5857184,2.69879,20026,5837135,23,5857161,0,-23
III,+,5859260,0.854839,1.80154e-39,310,45,265,179,13,gene,F01F1.5,2,5859331,1.14109,127,5859133,71,5859260,0,-71
III,+,5859565,0.678571,0.000388274,84,27,57,49,4,gene,F01F1.5,2,5859583,1.14109,432,5859133,18,5859565,0,-18
III,+,5864495,0.0,0.125,3,3,0,0,193,gene,F01F1.4,0,5864508,0.825726,1582,5862913,13,5864498,3,-10
III,+,5864505,0.00497512,0.0,402,400,2,2,93,gene,F01F1.4,0,5864508,0.825726,1592,5862913,3,5864498,-7,-10
III,+,5872978,0.00297619,0.0,336,335,1,1,4,gene,F01F1.3,0,5873005,10.2533,6454,5866524,27,5873000,22,-5
III,+,5878505,0.00191693,0.0,1565,1562,3,2,10,gene,F01F1.2,1,5878509,1.71238,3852,5874653,4,5878508,3,-1
III,+,5879796,0.511848,0.051722,211,103,108,69,2,gene,F01F1.1,2,5879805,0.59325,430,5879366,9,5879796,0,-9
III,+,5879819,0.5,0.5,2,1,1,1,689,gene,F01F1.1,2,5879823,0.59325,453,5879366,4,5879796,-23,-27
III,+,5884078,0.0,0.03125,5,5,0,0,1,gene,C28H8.5,0,5884215,0.306659,1701,5882377,137,5884258,180,43
III,+,5884402,0.0,5.29396e-23,74,74,0,0,1,gene,C28H8.5,0,5884423,0.306659,2025,5882377,21,5884402,0,-21
III,+,5884476,0.0,0.125,3,3,0,0,58,gene,C28H8.5,0,5884493,0.306659,2099,5882377,17,5884402,-74,-91
III,+,5907002,0.00694444,0.0,1584,1573,11,9,11,gene,C28H8.4,1,5907008,4.63262,21229,5885773,6,5907000,-2,-8
III,+,5908651,0.948718,0.0,546,28,518,334,0,gene,C28H8.3,2,5908711,2.09662,250,5908401,60,5908651,0,-60
III,+,5923140,0.0,0.000976562,10,10,0,0,2,gene,C28H8.2,0,5923154,0.496088,1306,5921834,14,5923138,-2,-16
III,+,5923245,0.0,0.015625,6,6,0,0,9,gene,C28H8.2,0,5923248,0.496088,1411,5921834,3,5923138,-107,-110
III,+,5926031,0.0,5.68434e-14,44,44,0,0,5,gene,C28H8.1,0,5926036,2.64558,1542,5924489,5,5926011,-20,-25
III,+,5926037,0.028169,1.05244e-18,71,69,2,2,140,gene,C28H8.1,0,5926088,2.64558,1548,5924489,51,5926011,-26,-77
III,+,5940935,0.0219092,0.0,1278,1250,28,26,13,gene,F25B5.4,0,5940939,11.7433,8196,5932739,4,5940935,0,-4
III,+,5948830,0.0,9.09495e-13,40,40,0,0,3,gene,F25B5.3,0,5948849,5.09,5040,5943790,19,5948839,9,-10
III,+,5948839,0.00694006,0.0,1585,1574,11,9,69,gene,F25B5.3,0,5948849,5.09,5049,5943790,10,5948839,0,-10
III,+,5949984,0.0,0.5,1,1,0,0,2,gene,F25B5.3,0,5950133,5.09,6194,5943790,149,5950083,99,-50
III,+,5950083,0.00440529,0.0,227,226,1,1,61,gene,F25B5.3,0,5950133,5.09,6293,5943790,50,5950083,0,-50
III,+,5950233,0.0,0.5,1,1,0,0,4,gene,F25B5.3,0,5950289,5.09,6443,5943790,56,5950233,0,-56
III,+,5951989,0.00146951,0.0,1361,1359,2,2,13,gene,F25B5.3,0,5952044,5.09,8199,5943790,55,5951989,0,-55
III,+,5958753,0.0,0.015625,6,6,0,0,424,gene,F25B5.2,0,5959129,0.748092,5230,5953523,376,5958725,-28,-404
III,+,5959253,0.0,5.82077e-11,34,34,0,0,64,gene,F25B5.2,0,5959253,0.748092,5730,5953523,0,5959253,0,0
III,+,5966359,0.00139665,0.0,716,715,1,1,7,gene,F25B5.1,0,5966361,0.666224,4092,5962267,2,5966362,3,1
III,+,5993166,0.00787402,0.0,381,378,3,3,0,gene,T04C9.1,0,5993220,1.35025,989,5992177,54,5993221,55,1
III,+,6002656,0.0,5.82077e-11,34,34,0,0,14,gene,T04C9.1,0,6002665,1.35025,6105,5996551,9,6002666,10,1
III,+,6002666,0.0,5.87747e-39,127,127,0,0,111,gene,T04C9.1,0,6002719,1.35025,6115,5996551,53,6002666,0,-53
III,+,6009509,0.00251889,0.0,2382,2376,6,5,1,gene,ZK328.2,0,6009526,2.35608,3197,6006312,17,6009509,0,-17
III,+,6020112,0.0145985,0.0,274,270,4,2,1,gene,ZK328.1,0,6020135,0.707869,7329,6012783,23,6020112,0,-23
III,+,6067803,0.0612245,3.27276e-11,49,46,3,3,0,gene,C05D10.2,0,6067836,0.196182,1687,6066116,33,6067803,0,-33
III,+,6080509,0.00504202,0.0,595,592,3,2,1,gene,C05D10.1,0,6080518,1.57314,8480,6072029,9,6080509,0,-9
III,+,6082111,0.0,5.73972e-42,137,137,0,0,1,gene,C05D10.1,0,6082116,1.57314,10082,6072029,5,6082111,0,-5
III,+,6082737,0.0,0.5,1,1,0,0,0,gene,C05D10.1,0,6082748,1.57314,10708,6072029,11,6082737,0,-11
III,+,6118572,0.00282752,0.0,1061,1058,3,3,0,gene,T17E9.1,0,6118638,1.15525,4222,6114350,66,6118571,-1,-67
III,+,6146211,0.00154321,0.0,648,647,1,0,120,gene,Y42G9A.3,0,6146241,1.12819,11588,6134623,30,6146211,0,-30
III,+,6159744,0.0,0.125,3,3,0,0,2,gene,F42A10.2,0,6159745,0.597611,4856,6154888,1,6159787,43,42
III,+,6159789,0.0,0.0,201,201,0,0,5,gene,F42A10.2,0,6159823,0.597611,4901,6154888,34,6159824,35,1
III,+,6160279,0.0,0.5,1,1,0,0,68,gene,F42A10.2,0,6160328,0.597611,5391,6154888,49,6159824,-455,-504
III,+,6164592,0.00977995,0.0,409,405,4,4,0,gene,F42A10.9,0,6164596,0.559169,62,6164530,4,6164592,0,-4
III,+,6173350,0.00399202,0.0,501,499,2,2,0,gene,F42A10.1,0,6173361,1.45957,2228,6171122,11,6173350,0,-11
III,+,6199130,0.0141753,0.0,776,765,11,8,1,gene,C23G10.4,0,6199149,3.52672,7044,6192086,19,6199130,0,-19
III,+,6206747,0.00481904,0.0,19921,19825,96,87,3,gene,C23G10.3,1,6206768,106.823,4187,6202560,21,6206747,0,-21
III,+,6208008,0.890511,3.237e-43,274,30,244,188,2,gene,C23G10.2,2,6208132,4.3713,100,6207908,124,6208133,125,1
III,+,6208154,0.0598291,0.0,1170,1100,70,51,94,gene,C23G10.2,2,6208174,4.3713,246,6207908,20,6208154,0,-20
III,+,6208357,0.0873702,0.0,2312,2110,202,156,8,gene,C23G10.2,2,6208375,4.3713,449,6207908,18,6208357,0,-18
III,+,6209237,1.0,0.5,1,0,1,1,2,gene,C23G10.1,0,6209261,0.100168,153,6209084,24,6209181,-56,-80
III,+,6209253,1.0,0.5,1,0,1,1,5,gene,C23G10.1,0,6209261,0.100168,169,6209084,8,6209181,-72,-80
III,+,6220481,0.015625,3.46945e-18,64,63,1,1,2,gene,T12A2.16,0,6220508,0.346263,7651,6212830,27,6220516,35,8
III,+,6240740,0.0,2.98023e-08,25,25,0,0,0,gene,T12A2.3,0,6240771,0.108004,16353,6224387,31,6240750,10,-21
III,+,6240750,0.0,2.40741e-35,115,115,0,0,26,gene,T12A2.3,0,6240771,0.108004,16363,6224387,21,6240750,0,-21
III,+,6248588,0.0129072,0.0,1627,1606,21,16,0,gene,T12A2.2,0,6248590,5.56848,7064,6241524,2,6248588,0,-2
III,+,6251755,0.0,8.67362e-19,60,60,0,0,0,gene,T12A2.1,0,6251755,0.230737,204,6251551,0,6251756,1,1
III,+,6280568,0.00517688,0.0,1159,1153,6,6,282,gene,F47D12.4,0,6280676,3.39809,4598,6275970,108,6280551,-17,-125
III,+,6298406,0.0,0.0,209,209,0,0,1,gene,F47D12.3,0,6298436,0.191304,16050,6282356,30,6298437,31,1
III,+,6309322,0.0,3.00927e-36,118,118,0,0,0,gene,F47D12.1,0,6309328,0.201709,10053,6299269,6,6309322,0,-6
III,+,6331677,0.037037,2.01166e-07,27,26,1,1,1,gene,C56G2.4,0,6331685,0.227946,10864,6320813,8,6331677,0,-8
III,+,6346232,0.0159236,0.0,314,309,5,5,7,gene,C56G2.3,0,6346453,0.196274,2070,6344162,221,6346921,689,468
III,+,6353329,0.0192308,1.15463e-14,52,51,1,0,2,gene,C56G2.1,1,6353426,3.52054,5267,6348062,97,6353329,0,-97
III,+,6362924,0.00854701,0.0,234,232,2,1,16,gene,C56G2.1,1,6363064,3.52054,8880,6354044,140,6362924,0,-140
III,+,6367984,0.359615,3.46232e-11,520,333,187,146,2,gene,C16A3.8,2,6367987,0.738382,1868,6366116,3,6367984,0,-3
III,+,6375321,0.00728597,0.0,549,545,4,3,4,gene,C16A3.7,1,6375332,0.904713,1474,6373847,11,6375321,0,-11
III,+,6379226,0.866667,0.00320435,15,2,13,5,22,gene,C16A3.6,2,6379403,4.31472,111,6379115,177,6379391,165,-12
III,+,6379391,0.406413,1.21271e-12,1341,796,545,289,1,gene,C16A3.6,2,6379403,4.31472,276,6379115,12,6379391,0,-12
III,+,6380714,0.975726,0.0,2513,61,2452,1328,24,gene,C16A3.5,3,6380732,9.20427,102,6380612,18,6380714,0,-18
III,+,6381576,0.918381,0.0,1507,123,1384,763,0,gene,C16A3.4,4,6381587,3.51827,123,6381453,11,6381576,0,-11
III,+,6383494,0.00684932,1.63672e-42,146,145,1,0,2,gene,C16A3.3,1,6383506,0.75026,397,6383097,12,6383494,0,-12
III,+,6389775,0.785256,2.00432e-25,312,67,245,190,2,gene,C16A3.2,2,6389802,0.329127,425,6389350,27,6389775,0,-27
III,+,6390877,0.75,0.109375,8,2,6,5,3,gene,C16A3.1,3,6390890,0.333446,94,6390783,13,6390891,14,1
III,+,6390888,0.883333,1.59525e-36,240,28,212,160,38,gene,C16A3.1,3,6390890,0.333446,105,6390783,2,6390888,0,-2
III,+,6407071,0.0,0.0,159,159,0,0,0,gene,C05D11.4,0,6407078,0.577928,13289,6393782,7,6407071,0,-7
III,+,6432120,0.0152778,0.0,720,709,11,8,0,gene,C05D11.3,1,6432122,1.91828,22120,6410000,2,6432123,3,1
III,+,6433181,0.914634,2.82233e-30,164,14,150,111,2,gene,C05D11.2,2,6433182,0.652176,91,6433090,1,6433181,0,-1
III,+,6436550,0.954545,0.0,484,22,462,324,0,gene,C05D11.1,3,6436559,1.51113,106,6436444,9,6436550,0,-9
III,+,6454425,0.00606061,0.0,165,164,1,1,1,gene,T26A5.5,1,6454446,0.782229,2915,6451510,21,6454425,0,-21
III,+,6460062,0.841004,0.0,478,76,402,290,2,gene,T26A5.4,2,6460068,0.513015,106,6459956,6,6460062,0,-6
III,+,6465164,0.0,0.0,742,742,0,0,121,gene,T26A5.3,1,6465165,0.912014,3000,6462164,1,6465109,-55,-56
III,+,6467247,0.981366,2.34017e-43,161,3,158,140,3,gene,T26A5.2,2,6467278,0.287337,99,6467148,31,6467324,77,46
III,+,6471745,1.0,0.5,1,0,1,1,5,gene,T26A5.1,0,6471754,0.117611,148,6471597,9,6471711,-34,-43
III,+,6478902,0.00325521,0.0,4608,4593,15,12,1,gene,F23F12.9,0,6478919,4.0121,3715,6475187,17,6478902,0,-17
III,+,6483134,0.0,0.00390625,8,8,0,0,0,gene,F23F12.8,0,6483157,0.0499108,1957,6481177,23,6483158,24,1
III,+,6489735,0.00690407,0.0,2752,2733,19,18,0,gene,F23F12.6,0,6489738,3.59586,920,6488815,3,6489735,0,-3
III,+,6495619,0.0,1.73472e-18,59,59,0,0,0,gene,F23F12.13,0,6495620,0.0736841,4397,6491222,1,6495617,-2,-3
III,+,6528142,0.0,0.000976562,10,10,0,0,0,gene,C09E7.2,0,6528164,0.0199251,18701,6509441,22,6528142,0,-22
III,+,6587832,0.0,2.71051e-20,65,65,0,0,287,gene,F20H11.5,0,6587836,0.628356,1311,6586521,4,6587804,-28,-32
III,+,6615354,0.00680272,8.23963e-43,147,146,1,1,0,gene,Y40D12A.1,1,6615370,0.254133,274,6615080,16,6615354,0,-16
III,+,6620194,0.823529,4.64888e-10,85,15,70,56,1,gene,C13B9.2,2,6620206,0.0866878,203,6619991,12,6620207,13,1
III,+,6690947,0.0,1.19209e-07,23,23,0,0,0,gene,F37A4.7,0,6690967,0.301405,11773,6679174,20,6690947,0,-20
III,+,6696691,0.0,0.015625,6,6,0,0,1,gene,F37A4.7,0,6696695,0.301405,1459,6695232,4,6696691,0,-4
III,+,6722483,0.0,0.0,1101,1101,0,0,410,gene,F37A4.2,1,6722493,1.4619,2052,6720431,10,6722483,0,-10
III,+,6722814,0.0,0.03125,5,5,0,0,1,gene,F37A4.1,2,6722854,1.62639,2383,6720431,40,6722814,0,-40
III,+,6723327,0.945312,0.0,1024,56,968,694,4,gene,F37A4.1,2,6723341,1.62639,46,6723281,14,6723327,0,-14
III,+,6723330,0.885714,3.06496e-22,140,16,124,103,11,gene,F37A4.1,2,6723341,1.62639,49,6723281,11,6723330,0,-11
III,+,6725727,0.897616,0.0,713,73,640,486,0,gene,Y102E9.2,3,6725732,1.64474,111,6725616,5,6725727,0,-5
III,+,6731158,0.0,0.125,3,3,0,0,8,gene,Y102E9.1,0,6731171,1.24552,3144,6728014,13,6731158,0,-13
III,+,6731592,0.0,0.000244141,12,12,0,0,0,gene,Y102E9.1,0,6731629,1.24552,3578,6728014,37,6731592,0,-37
III,+,6732101,0.0104712,0.0,191,189,2,2,7,gene,Y102E9.1,0,6732111,1.24552,4087,6728014,10,6732101,0,-10
III,+,6732107,0.0,7.70372e-34,110,110,0,0,34,gene,Y102E9.1,0,6732111,1.24552,4093,6728014,4,6732107,0,-4
III,+,6746246,0.0,1.35525e-20,66,66,0,0,1,gene,K07E12.1,0,6746307,0.219647,8497,6737749,61,6746246,0,-61
III,+,6795570,0.142857,0.0055542,14,12,2,1,3,gene,R05H11.1,0,6795575,0.188462,873,6794697,5,6795576,6,1
III,+,6802725,0.0,1.32349e-23,76,76,0,0,0,gene,F28F5.3,0,6802736,0.782754,2589,6800136,11,6802725,0,-11
III,+,6830329,0.00495049,0.0,202,201,1,1,0,gene,R13F6.4,0,6830393,0.606499,14251,6816078,64,6830329,0,-64
III,+,6851191,0.0192308,6.7949e-42,156,153,3,2,1,gene,R13F6.3,0,6851247,0.423933,3971,6847220,56,6851189,-2,-58
III,+,6869574,0.0,0.0,616,616,0,0,2,gene,R13F6.1,0,6869577,0.900225,8850,6860724,3,6869576,2,-1
III,+,6873027,0.00355951,0.0,4495,4479,16,14,5,gene,K04C2.3,0,6873054,6.63843,1918,6871109,27,6873027,0,-27
III,+,6882180,0.0833333,0.00292969,12,11,1,1,0,gene,K04C2.7,0,6882192,0.0963274,8513,6873667,12,6882193,13,1
III,+,6889704,0.157895,0.00184822,19,16,3,3,0,gene,K04C2.2,0,6889711,0.825272,3369,6886335,7,6889711,7,0
III,+,6889711,0.0207254,0.0,193,189,4,4,9,gene,K04C2.2,0,6889711,0.825272,3376,6886335,0,6889711,0,0
III,+,6897953,0.00167224,0.0,598,597,1,0,2,gene,T07E3.4,0,6897976,1.1093,2927,6895026,23,6897953,0,-23
III,+,6903820,0.00438596,0.0,228,227,1,1,3,gene,T07E3.3,0,6903831,1.10104,3278,6900542,11,6903832,12,1
III,+,6906648,0.0,1.49012e-08,26,26,0,0,1,gene,T07E3.2,0,6906663,0.114,627,6906021,15,6906833,185,170
III,+,6930021,0.0028341,0.0,4587,4574,13,12,2,gene,F57B9.6,1,6930072,18.6147,22069,6907952,51,6930021,0,-51
III,+,6931937,0.967177,0.0,914,30,884,443,0,gene,F57B9.5,2,6931940,3.72394,33,6931904,3,6931937,0,-3
III,+,6935903,0.847222,2.24229e-18,144,22,122,77,1,gene,F57B9.4,3,6935917,0.595039,85,6935818,14,6935903,0,-14
III,+,6946717,0.0,8.88178e-16,50,50,0,0,166,gene,F57B9.2,0,6946751,2.70595,5003,6941714,34,6946685,-32,-66
III,+,6961929,0.0,0.015625,6,6,0,0,8,gene,F57B9.1,0,6961939,0.932582,3117,6958812,10,6962105,176,166
III,+,6962081,0.0,3.63798e-12,38,38,0,0,17,gene,F57B9.1,0,6962104,0.932582,3269,6958812,23,6962105,24,1
III,+,6972191,0.00273373,0.0,1829,1824,5,5,24,gene,F31E3.3,0,6972195,1.75057,2154,6970037,4,6972146,-45,-49
III,+,6974381,0.0,2.38419e-07,22,22,0,0,15,gene,F31E3.2,0,6974397,0.199369,727,6973654,16,6974398,17,1
III,+,6979820,0.00860215,0.0,465,461,4,4,0,gene,F31E3.1,0,6979822,1.81476,1864,6977956,2,6979820,0,-2
III,+,6982023,0.333333,0.375,3,2,1,1,0,gene,F31E3.6,0,6982034,0.745482,302,6981721,11,6982446,423,412
III,+,6996416,0.0,8.47033e-22,70,70,0,0,4,gene,C06E8.3,0,6996416,0.635907,13552,6982864,0,6996416,0,0
III,+,7021819,0.0182648,0.0,219,215,4,4,2,gene,F11H8.1,0,7021823,0.78059,2304,7019515,4,7021819,0,-4
III,+,7100220,0.0,0.00390625,8,8,0,0,0,gene,ZK418.11,0,7100241,0.00920021,3212,7097008,21,7100411,191,170
III,+,7108249,0.0,8.67362e-19,60,60,0,0,1,gene,B0280.4,0,7108250,0.134289,6313,7101936,1,7108251,2,1
III,+,7123057,0.0,4.59177e-41,134,134,0,0,12,gene,B0280.3,0,7123065,2.83521,13365,7109692,8,7123057,0,-8
III,+,7123094,0.0,0.0,1342,1342,0,0,42,gene,B0280.3,0,7123113,2.83521,13402,7109692,19,7123094,0,-19
III,+,7128830,0.0,0.0625,4,4,0,0,0,gene,B0280.13,0,7128836,0.0722785,519,7128311,6,7128830,0,-6
III,+,7133768,0.0,3.72529e-09,28,28,0,0,103,gene,B0280.1,0,7133811,1.0426,1780,7131988,43,7133812,44,1
III,+,7133881,0.0,0.015625,6,6,0,0,60,gene,B0280.1,0,7133895,1.0426,1893,7131988,14,7133812,-69,-83
III,+,7162641,0.00925926,0.0,216,214,2,2,0,gene,K04G7.1,0,7162643,0.870518,26251,7136390,2,7162641,0,-2
III,+,7167767,0.0100853,0.0,1289,1276,13,11,3,gene,F37C12.7,0,7167911,2.94127,2881,7164886,144,7167767,0,-144
III,+,7180180,0.00424284,0.0,45017,44826,191,162,56,gene,F37C12.4,1,7180180,172.428,2025,7178155,0,7180180,0,0
III,+,7180681,0.92899,0.0,1535,109,1426,829,0,gene,F37C12.3,2,7180690,5.64648,83,7180598,9,7180681,0,-9
III,+,7180726,1.0,0.5,1,0,1,1,298,gene,F37C12.3,2,7180777,5.64648,128,7180598,51,7180681,-45,-96
III,+,7182096,0.424354,0.00217736,271,156,115,77,38,gene,F37C12.2,3,7182234,0.953501,247,7181849,138,7182172,76,-62
III,+,7182172,0.0,0.25,2,2,0,0,2,gene,F37C12.2,3,7182234,0.953501,323,7181849,62,7182172,0,-62
III,+,7184267,0.411314,1.72314e-09,1043,614,429,301,9,gene,F37C12.1,4,7184276,1.32104,289,7183978,9,7184277,10,1
III,+,7188572,0.0,5.82077e-11,34,34,0,0,7,gene,F37C12.21,0,7188572,None,782,7187790,0,7188286,-286,-286
III,+,7202590,0.00546448,0.0,183,182,1,0,0,gene,R151.5,0,7202590,0.849262,13676,7188914,0,7202590,0,0
III,+,7208376,0.00276964,0.0,56325,56169,156,136,6,gene,R151.3,1,7208383,112.193,785,7207591,7,7208376,0,-7
III,+,7209815,1.0,0.5,1,0,1,1,0,gene,R151.2,2,7209960,5.63295,25,7209790,145,7210002,187,42
III,+,7209896,0.894737,0.000326157,19,2,17,15,1,gene,R151.2,2,7209960,5.63295,106,7209790,64,7209896,0,-64
III,+,7210002,0.935065,6.71781e-32,154,10,144,121,15,gene,R151.2,2,7210036,5.63295,212,7209790,34,7210002,0,-34
III,+,7210076,0.8,0.15625,5,1,4,4,18,gene,R151.2,2,7210137,5.63295,286,7209790,61,7210002,-74,-135
III,+,7211365,0.236897,0.0,954,728,226,201,2,gene,R151.2,2,7211540,5.63295,1575,7209790,175,7211365,0,-175
III,+,7211371,0.0299581,0.0,1669,1619,50,45,373,gene,R151.2,2,7211540,5.63295,1581,7209790,169,7211371,0,-169
III,+,7212664,0.0,0.0,894,894,0,0,0,gene,R151.2,2,7212806,5.63295,2874,7209790,142,7212664,0,-142
III,+,7216442,0.0,1.86265e-09,29,29,0,0,0,gene,R151.1,0,7216454,0.15913,1327,7215115,12,7216455,13,1
III,+,7238956,0.0110701,0.0,813,804,9,8,3,gene,T20H4.3,0,7238966,2.78181,17849,7221107,10,7238956,0,-10
III,+,7258923,0.05,1.90735e-05,20,19,1,0,0,gene,B0361.4,0,7258939,0.324412,6377,7252546,16,7258940,17,1
III,+,7281389,0.00221729,0.0,451,450,1,1,307,gene,B0361.3,0,7281390,0.65153,266,7281123,1,7281389,0,-1
III,+,7293561,0.00628931,0.0,636,632,4,4,0,gene,B0361.2,0,7293562,0.561428,9677,7283884,1,7293559,-2,-3
III,+,7305905,0.0714286,0.000854492,14,13,1,1,2,gene,B0361.2,0,7305934,0.561428,11327,7294578,29,7305905,0,-29
III,+,7311217,0.00486618,0.0,411,409,2,2,2,gene,F56C9.3,0,7311254,0.807643,2931,7308286,37,7311224,7,-30
III,+,7311224,0.0114613,0.0,349,345,4,4,55,gene,F56C9.3,0,7311254,0.807643,2938,7308286,30,7311224,0,-30
III,+,7336514,0.00643678,0.0,2175,2161,14,11,7,gene,F56C9.1,0,7336549,7.55222,23509,7313005,35,7336514,0,-35
III,+,7338924,0.0,0.5,1,1,0,0,3,gene,F08F8.3,0,7338927,0.148834,231,7338693,3,7338928,4,1
III,+,7359423,0.0,3.9443e-31,101,101,0,0,0,gene,F08F8.2,0,7359439,0.815956,1167,7358256,16,7359423,0,-16
III,+,7367579,0.0,0.125,3,3,0,0,1,gene,T20B12.4,0,7367586,0.000841579,1158,7366421,7,7367635,56,49
III,+,7382040,0.00829876,0.0,241,239,2,2,0,gene,T20B12.3,1,7382043,0.634335,3368,7378672,3,7382040,0,-3
III,+,7383958,0.806576,0.0,1551,300,1251,1000,5,gene,T20B12.2,2,7383963,1.45699,115,7383843,5,7383958,0,-5
III,+,7386134,1.0,0.5,1,0,1,1,0,gene,T20B12.1,3,7386153,0.531566,152,7385982,19,7386154,20,1
III,+,7386154,0.964072,1.47066e-40,167,6,161,119,2,gene,T20B12.1,3,7386196,0.531566,172,7385982,42,7386154,0,-42
III,+,7454006,0.00441501,0.0,453,451,2,2,2,gene,Y69F12A.2,0,7454013,1.88359,62947,7391059,7,7454006,0,-7
III,+,7465540,0.5,0.375,4,2,2,2,7,gene,H14A12.2,2,7465544,7.01185,379,7465161,4,7465554,14,10
III,+,7465554,0.864444,0.0,900,122,778,496,26,gene,H14A12.2,2,7465559,7.01185,393,7465161,5,7465554,0,-5
III,+,7465882,0.0,0.5,1,1,0,0,0,gene,H14A12.2,2,7465936,7.01185,721,7465161,54,7465882,0,-54
III,+,7499548,0.0,0.5,1,1,0,0,0,gene,C07H6.4,0,7499685,0.729488,31972,7467576,137,7499633,85,-52
III,+,7508102,0.0,0.0,292,292,0,0,0,gene,C07H6.3,0,7508108,0.462797,4937,7503165,6,7508120,18,12
III,+,7520930,0.00436772,0.0,4808,4787,21,17,2,gene,C07H6.2,1,7520932,4.32795,5723,7515207,2,7520928,-2,-4
III,+,7521387,0.0102041,3.09233e-28,98,97,1,1,12,gene,C07H6.1,2,7521393,0.279382,131,7521256,6,7521387,0,-6
III,+,7521631,1.0,0.5,1,0,1,1,51,gene,C07H6.1,2,7521640,0.279382,243,7521388,9,7521387,-244,-253
III,+,7555584,0.0,0.0,553,553,0,0,0,gene,R13A5.5,0,7555584,0.725354,30824,7524760,0,7555584,0,0
III,+,7562129,0.0,0.5,1,1,0,0,0,gene,R13A5.4,0,7562176,0.0283436,3992,7558137,47,7562095,-34,-81
III,+,7573273,0.00586042,0.0,1877,1866,11,9,0,gene,R13A5.12,0,7573276,5.37561,5885,7567388,3,7573273,0,-3
III,+,7584612,0.0198864,0.0,352,345,7,6,1,gene,R13A5.1,0,7584654,0.66489,9420,7575192,42,7584612,0,-42
III,+,7614765,0.0,1.52588e-05,16,16,0,0,1,gene,T04A6.2,0,7614789,0.0718812,1613,7613152,24,7614790,25,1
III,+,7625312,0.0,5.87747e-39,127,127,0,0,2,gene,ZK783.1,0,7625313,0.704281,7797,7617515,1,7625304,-8,-9
III,+,7716090,0.0,0.5,1,1,0,0,0,gene,C03B8.2,0,7716093,0.0495534,15830,7700260,3,7716094,4,1
III,+,7731317,0.00643974,0.0,1087,1080,7,5,1,gene,ZK112.2,0,7731448,2.75959,14075,7717242,131,7731315,-2,-133
III,+,7772732,0.0,0.000976562,10,10,0,0,0,gene,ZK686.1,0,7772745,2.75007,11542,7761190,13,7773062,330,317
III,+,7773064,0.00218102,0.0,1834,1830,4,4,3,gene,ZK686.1,0,7773184,2.75007,11874,7761190,120,7773062,-2,-122
III,+,7773376,0.0,0.125,3,3,0,0,0,gene,ZK686.1,0,7773383,2.75007,12186,7761190,7,7773376,0,-7
III,+,7814304,0.0,0.00390625,8,8,0,0,1,gene,C08C3.1,0,7814398,0.271094,40529,7773775,94,7814399,95,1
III,+,7814310,0.0,4.81482e-35,114,114,0,0,1,gene,C08C3.1,0,7814398,0.271094,40535,7773775,88,7814310,0,-88
III,+,7829338,0.0,0.0,347,347,0,0,1,gene,ZK652.6,0,7829353,0.789046,12262,7817076,15,7829338,0,-15
III,+,7839521,0.0,4.65661e-10,31,31,0,0,0,gene,ZK652.5,0,7839615,0.0464423,7092,7832429,94,7839521,0,-94
III,+,7855044,0.0,0.0,708,708,0,0,2,gene,ZK652.4,0,7855075,86.2208,13626,7841418,31,7855044,0,-31
III,+,7855060,0.00293718,0.0,67752,67553,199,162,1203,gene,ZK652.4,0,7855075,86.2208,13642,7841418,15,7855060,0,-15
III,+,7858905,0.00752315,0.0,1728,1715,13,12,65,gene,ZK652.3,1,7858906,4.31341,3272,7855633,1,7858905,0,-1
III,+,7859539,0.943119,0.0,2514,143,2371,1603,2,gene,ZK652.2,2,7859606,7.94809,101,7859438,67,7859539,0,-67
III,+,7859555,0.916667,0.00292969,12,1,11,7,13430,gene,ZK652.2,2,7859606,7.94809,117,7859438,51,7859539,-16,-67
III,+,7861996,0.00674252,0.0,4746,4714,32,30,0,gene,ZK652.1,0,7861997,10.9937,1910,7860086,1,7861996,0,-1
III,+,7873708,0.0,0.0,290,290,0,0,11,gene,C02C2.1,0,7873713,1.69382,5052,7868656,5,7873708,0,-5
III,+,7893698,0.00553797,0.0,1264,1257,7,7,1,gene,ZK688.3,0,7893699,1.17682,16160,7877538,1,7893698,0,-1
III,+,7894976,0.0,0.5,1,1,0,0,1,gene,ZK688.4,0,7895067,0.0435781,326,7894650,91,7894953,-23,-114
III,+,7900962,0.0,0.0,284,284,0,0,0,gene,ZK688.2,0,7900963,0.45132,5757,7895205,1,7900962,0,-1
III,+,7928978,0.00941176,0.0,425,421,4,4,69,gene,C29E4.4,1,7928978,0.626745,6032,7922946,0,7928978,0,0
III,+,7933754,0.816,2.44881e-25,250,46,204,165,2,gene,C29E4.3,2,7933768,0.834471,832,7932922,14,7933754,0,-14
III,+,7941082,0.00746269,0.0,938,931,7,5,559,gene,C29E4.12,1,7941082,2.21316,222,7940860,0,7940989,-93,-93
III,+,7941646,0.962585,0.0,588,22,566,414,2,gene,C29E4.2,2,7941651,1.0157,103,7941543,5,7941646,0,-5
III,+,7973108,0.0,0.03125,5,5,0,0,3,gene,F54H12.1,0,7973224,7.21215,2896,7970212,116,7973646,538,422
III,+,7973646,0.00645393,0.0,2789,2771,18,16,3,gene,F54H12.1,0,7973653,7.21215,3434,7970212,7,7973646,0,-7
III,+,7973776,0.0,0.0625,4,4,0,0,0,gene,F54H12.1,0,7973937,7.21215,3564,7970212,161,7973776,0,-161
III,+,7974517,0.0,0.5,1,1,0,0,5,gene,F54H12.1,0,7974554,7.21215,4305,7970212,37,7974517,0,-37
III,+,7981003,0.00299401,0.0,1670,1665,5,4,2,gene,C06G4.2,1,7981097,3.17899,3737,7977266,94,7981003,0,-94
III,+,7987050,0.0677083,8.13741e-39,192,179,13,10,0,gene,C06G4.1,2,7987057,0.323751,793,7986257,7,7987058,8,1
III,+,8010707,0.00477327,0.0,419,417,2,2,0,gene,F44B9.3,0,8010717,1.27607,4943,8005764,10,8010707,0,-10
III,+,8022392,0.0109489,0.0,274,271,3,2,0,gene,F44B9.2,0,8022401,0.530534,8453,8013939,9,8022392,0,-9
III,+,8038169,0.0,8.27181e-25,80,80,0,0,1,gene,F44B9.1,0,8038174,0.257711,13045,8025124,5,8038169,0,-5
III,+,8044410,0.00246699,0.0,6891,6874,17,14,3,gene,K12H4.5,1,8044413,8.35823,3115,8041295,3,8044408,-2,-5
III,+,8044944,0.993117,0.0,3051,21,3030,1941,593,gene,K12H4.4,2,8044961,3.34817,237,8044707,17,8044944,0,-17
III,+,8045961,0.926148,0.0,501,37,464,303,8,gene,K12H4.3,3,8045971,1.44337,69,8045892,10,8045961,0,-10
III,+,8047639,0.956835,1.28852e-32,139,6,133,91,0,gene,K12H4.2,4,8047639,0.324616,100,8047539,0,8047640,1,1
III,+,8067217,0.00826446,0.0,242,240,2,1,0,gene,K12H4.1,0,8067265,0.356683,18910,8048307,48,8067217,0,-48
III,+,8080595,0.00666667,1.05097e-43,150,149,1,1,110,gene,K06H7.6,0,8080595,0.516271,9220,8071375,0,8080539,-56,-56
III,+,8085631,0.00362319,0.0,828,825,3,3,0,gene,K06H7.4,1,8085652,1.00018,2004,8083627,21,8085631,0,-21
III,+,8088461,0.97549,0.0,204,5,199,134,6,gene,K06H7.3,2,8088465,0.650523,93,8088368,4,8088461,0,-4
III,+,8091634,0.921053,5.04467e-43,228,18,210,144,0,gene,K06H7.9,3,8091637,0.784771,107,8091527,3,8091634,0,-3
III,+,8093501,0.0,0.0,160,160,0,0,8,gene,K06H7.2,0,8093510,0.273352,533,8092968,9,8093511,10,1
III,+,8099250,0.0,0.000976562,10,10,0,0,1,gene,K06H7.1,0,8099252,0.0196718,3016,8096234,2,8099253,3,1
III,+,8101274,0.00399467,0.0,2253,2244,9,9,7,gene,C14B9.4,0,8101385,2.99456,692,8100582,111,8101274,0,-111
III,+,8108716,0.0119048,4.3427e-24,84,83,1,1,4,gene,C14B9.3,0,8108740,0.317748,4722,8103994,24,8108716,0,-24
III,+,8130790,0.00443676,0.0,17355,17278,77,67,391,gene,C14B9.10,0,8130790,42.9124,19689,8111101,0,8130790,0,0
III,+,8133590,0.0204082,0.0,294,288,6,4,13,gene,C14B9.2,0,8133599,2.88087,990,8132600,9,8133590,0,-9
III,+,8138041,0.00319197,0.0,2193,2186,7,6,22,gene,C14B9.1,0,8138045,3.15944,1472,8136569,4,8138015,-26,-30
III,+,8144942,0.0183028,0.0,601,590,11,10,1,gene,D2007.4,0,8144942,1.64665,4925,8140017,0,8144940,-2,-2
III,+,8148895,0.0588235,0.0001297,17,16,1,1,0,gene,D2007.3,0,8148899,0.0215537,2987,8145908,4,8148900,5,1
III,+,8152367,0.0,5.16988e-26,84,84,0,0,1,gene,D2007.2,0,8152393,0.270587,3309,8149058,26,8152394,27,1
III,+,8155398,0.00261438,0.0,765,763,2,1,18,gene,D2007.1,0,8155398,1.26492,854,8154544,0,8155384,-14,-14
III,+,8164291,0.0,0.00390625,8,8,0,0,0,gene,C50C3.6,0,8164302,2.6255,8376,8155915,11,8164303,12,1
III,+,8164301,0.00667557,0.0,749,744,5,5,12,gene,C50C3.6,0,8164302,2.6255,8386,8155915,1,8164303,2,1
III,+,8179152,0.01,0.0,200,198,2,2,0,gene,C50C3.5,0,8179180,0.313665,2311,8176841,28,8179181,29,1
III,+,8191917,0.0,1.57772e-30,99,99,0,0,9,gene,C50C3.1,0,8191919,0.365759,923,8190994,2,8191739,-178,-180
III,+,8225017,0.018,0.0,500,491,9,9,1,gene,C30A5.3,1,8225024,3.55346,1305,8223712,7,8225017,0,-7
III,+,8226398,0.925926,2.61515e-06,27,2,25,14,6,gene,C30A5.2,2,8226421,0.864277,73,8226325,23,8226398,0,-23
III,+,8229693,0.0,0.25,2,2,0,0,12,gene,C02F5.7,3,8229733,1.13027,157,8229536,40,8229708,15,-25
III,+,8229710,0.0,0.0,426,426,0,0,19,gene,C02F5.7,3,8229733,1.13027,174,8229536,23,8229710,0,-23
III,+,8232571,0.733333,2.9341e-18,330,88,242,211,37,gene,C02F5.6,4,8232577,0.520922,88,8232483,6,8232578,7,1
III,+,8244365,0.0146751,0.0,477,470,7,7,0,gene,C02F5.4,1,8244591,0.732129,7537,8236828,226,8244363,-2,-228
III,+,8245811,0.95675,0.0,763,33,730,380,9,gene,C02F5.3,2,8245844,2.13606,97,8245714,33,8245811,0,-33
III,+,8247271,0.896552,3.31465e-15,87,9,78,53,0,gene,C02F5.13,3,8247405,0.420787,93,8247178,134,8247271,0,-134
III,+,8250554,0.0031211,0.0,1602,1597,5,5,0,gene,C02F5.1,0,8250555,0.959607,418,8250136,1,8250556,2,1
III,+,8265982,0.00977199,0.0,307,304,3,3,0,gene,F09G8.3,0,8266017,1.0895,257,8265725,35,8265982,0,-35
III,+,8279023,0.0,6.10352e-05,14,14,0,0,0,gene,F10E9.6,0,8279027,1.45361,8421,8270602,4,8279028,5,1
III,+,8293957,0.0,0.0,153,153,0,0,5,gene,F10E9.6,0,8293968,1.45361,23355,8270602,11,8293957,0,-11
III,+,8300115,0.0,0.0,210,210,0,0,0,gene,F10E9.6,0,8300132,1.45361,29513,8270602,17,8300113,-2,-19
III,+,8308460,0.933806,0.0,423,28,395,275,4,gene,F10E9.4,2,8308469,0.985646,103,8308357,9,8308410,-50,-59
III,+,8310926,0.280374,5.97149e-16,321,231,90,77,0,gene,F10E9.3,3,8310926,1.00947,1201,8309725,0,8310926,0,0
III,+,8323097,0.0,4.70198e-38,124,124,0,0,1,gene,F10E9.1,0,8323105,0.152017,8856,8314241,8,8323106,9,1
III,+,8332142,0.00728597,0.0,1098,1090,8,8,2,gene,ZC262.2,0,8332142,1.6488,5566,8326576,0,8332142,0,0
III,+,8358544,0.0264901,0.0,302,294,8,8,0,gene,R05D3.4,0,8358545,1.12669,8763,8349781,1,8358544,0,-1
III,+,8372174,0.00447761,0.0,670,667,3,3,3,gene,R05D3.2,1,8372188,0.848038,5699,8366475,14,8372174,0,-14
III,+,8375219,0.856757,0.0,370,53,317,232,4,gene,R05D3.11,2,8375270,0.629814,127,8375092,51,8375219,0,-51
III,+,8380864,0.975904,3.51862e-22,83,2,81,62,2,gene,R05D3.12,3,8380875,0.258514,96,8380768,11,8380864,0,-11
III,+,8380874,1.0,0.00012207,13,0,13,10,95,gene,R05D3.12,3,8380875,0.258514,106,8380768,1,8380876,2,1
III,+,8398632,0.0,2.11758e-22,72,72,0,0,0,gene,ZK353.2,0,8398642,0.138693,1739,8396893,10,8398643,11,1
III,+,8405793,0.00174825,0.0,572,571,1,1,0,gene,ZK353.1,1,8405823,1.04301,6738,8399055,30,8405793,0,-30
III,+,8405924,0.0,0.25,2,2,0,0,0,gene,ZK353.1,1,8405926,1.04301,6869,8399055,2,8405924,0,-2
III,+,8409415,0.954881,0.0,2305,104,2201,1750,41,gene,ZK353.9,2,8409424,0.944094,94,8409321,9,8409415,0,-9
III,+,8409473,1.0,0.5,1,0,1,0,521,gene,ZK353.9,2,8409475,0.944094,152,8409321,2,8409415,-58,-60
III,+,8419124,0.00689655,3.25101e-42,145,144,1,1,10,gene,ZK1236.3,0,8419126,0.905681,7188,8411936,2,8419127,3,1
III,+,8426253,0.000501253,0.0,1995,1994,1,1,5,gene,ZK1236.2,0,8426256,1.7141,3685,8422568,3,8426256,3,0
III,+,8429257,0.0,2.22045e-16,52,52,0,0,39,gene,ZK1236.1,0,8429257,0.25822,764,8428493,0,8429255,-2,-2
III,+,8429362,0.0,0.25,2,2,0,0,20,gene,ZK1236.1,0,8429405,0.25822,869,8428493,43,8429255,-107,-150
III,+,8447270,0.0037144,0.0,2423,2414,9,9,6,gene,C30C11.2,1,8447273,4.58507,6094,8441176,3,8447270,0,-3
III,+,8449674,0.806697,0.0,657,127,530,376,6,gene,C30C11.1,2,8449674,1.56548,411,8449263,0,8449674,0,0
III,+,8484068,0.00531915,0.0,564,561,3,3,2,gene,F42H10.3,0,8484070,0.818787,5756,8478312,2,8484071,3,1
III,+,8490539,0.00720906,0.0,971,964,7,6,0,gene,F42H10.2,0,8490557,1.69068,2263,8488276,18,8490558,19,1
III,+,8494931,0.360947,8.48517e-05,169,108,61,49,0,gene,C04D8.1,0,8495022,1.22841,3919,8491012,91,8494931,0,-91
III,+,8529990,0.0,4.1359e-25,81,81,0,0,2,gene,ZC21.10,0,8529991,0.214059,1429,8528561,1,8529990,0,-1
III,+,8535763,0.0,7.27596e-12,37,37,0,0,0,gene,ZC21.2,0,8535830,0.0752712,4507,8531256,67,8536259,496,429
III,+,8536258,0.0,0.5,1,1,0,0,2,gene,ZC21.2,0,8536258,0.0752712,5002,8531256,0,8536259,1,1
III,+,8552081,0.0,2.32831e-10,32,32,0,0,1,gene,C02D5.3,0,8552109,1.49756,9435,8542646,28,8552496,415,387
III,+,8552465,0.0115607,0.0,865,855,10,8,2,gene,C02D5.3,0,8552495,1.49756,9819,8542646,30,8552496,31,1
III,+,8554683,0.0,3.72529e-09,28,28,0,0,0,gene,C02D5.3,0,8554704,1.49756,935,8553748,21,8554705,22,1
III,+,8557344,0.00452489,0.0,442,440,2,1,9,gene,C02D5.2,0,8557423,0.37985,1692,8555652,79,8557424,80,1
III,+,8561045,0.0,0.0,415,415,0,0,0,gene,C02D5.1,0,8561093,0.377595,1942,8559103,48,8561094,49,1
III,+,8581011,0.0,2.98023e-08,25,25,0,0,0,gene,C06E1.3,0,8581055,0.334418,18043,8562968,44,8581011,0,-44
III,+,8605742,0.0,0.0,205,205,0,0,1,gene,C06E1.1,0,8605751,0.819637,21907,8583835,9,8605740,-2,-11
III,+,8622794,0.0,1.73472e-18,59,59,0,0,1,gene,C13G5.1,0,8622795,0.192165,16265,8606529,1,8622794,0,-1
III,+,8628842,0.0,0.0625,4,4,0,0,1,gene,F22B7.13,1,8628864,0.296996,2623,8626219,22,8628843,1,-21
III,+,8631073,0.515528,0.0380571,322,156,166,138,3,gene,F22B7.5,2,8631082,0.755293,389,8630684,9,8631073,0,-9
III,+,8648799,0.0,0.25,2,2,0,0,0,gene,F22B7.3,0,8648808,0.00632211,8798,8640001,9,8648971,172,163
III,+,8665248,0.0,3.8147e-06,18,18,0,0,0,gene,F22B7.1,0,8665252,0.124454,13151,8652097,4,8665253,5,1
III,+,8684716,0.00273973,0.0,365,364,1,0,1,gene,B0303.2,0,8684752,0.368888,11160,8673556,36,8684715,-1,-37
III,+,8689849,0.0,0.0,315,315,0,0,25,gene,B0303.4,0,8689867,1.01986,3534,8686315,18,8689849,0,-18
III,+,8690121,0.0,0.00390625,8,8,0,0,167,gene,B0303.4,0,8690122,1.01986,3806,8686315,1,8689849,-272,-273
III,+,8697292,0.0,0.5,1,1,0,0,58,gene,B0303.7,0,8697336,0.493647,3913,8693379,44,8696880,-412,-456
III,+,8700843,0.0,0.015625,6,6,0,0,9,gene,B0303.9,0,8700845,0.315641,1569,8699274,2,8700836,-7,-9
III,+,8717551,0.00677966,0.0,885,879,6,5,2,gene,B0303.15,1,8717553,2.12124,11250,8706301,2,8717549,-2,-4
III,+,8720109,0.668498,6.7201e-16,546,181,365,238,1,gene,ZK370.3,2,8720110,0.851682,1637,8718472,1,8720109,0,-1
III,+,8749821,0.0,0.5,1,1,0,0,73,gene,ZK370.2,0,8749871,0.274421,24575,8725246,50,8749821,0,-50
III,+,8768218,0.00036036,0.0,2775,2774,1,1,2,gene,PAR2.1,1,8768220,3.12824,11242,8756976,2,8768218,0,-2
III,+,8769443,0.479545,0.00436224,1760,916,844,551,24,gene,K02D10.1,2,8769454,3.20709,264,8769179,11,8769443,0,-11
III,+,8772663,0.0,0.015625,6,6,0,0,8,gene,K02D10.1,2,8772691,3.20709,1227,8771436,28,8773052,389,361
III,+,8773052,0.140523,4.40829e-40,306,263,43,30,1,gene,K02D10.1,2,8773076,3.20709,1616,8771436,24,8773052,0,-24
III,+,8776162,0.878446,0.0,798,97,701,412,16,gene,K02D10.5,3,8776172,2.07317,114,8776048,10,8776160,-2,-12
III,+,8793940,0.016129,1.34441e-17,62,61,1,1,0,gene,F54F2.2,0,8794009,2.73161,1617,8792323,69,8793940,0,-69
III,+,8798305,0.00211416,0.0,946,944,2,2,1,gene,F54F2.2,0,8798319,2.73161,4076,8794229,14,8798305,0,-14
III,+,8802732,0.00555556,0.0,360,358,2,2,1,gene,F54F2.2,0,8802860,2.73161,8503,8794229,128,8802732,0,-128
III,+,8818806,0.00448431,0.0,223,222,1,0,0,gene,F54F2.1,0,8818808,1.20206,12641,8806165,2,8818809,3,1
III,+,8853711,0.0130933,0.0,1222,1206,16,15,8,gene,F44E2.2,0,8853723,1.85183,799,8852912,12,8853711,0,-12
III,+,8887659,0.00604839,0.0,992,986,6,4,1,gene,ZK637.2,1,8887665,4.18205,26374,8861285,6,8887659,0,-6
III,+,8890138,0.388679,6.67513e-05,265,162,103,72,5,gene,ZK637.3,2,8890142,1.198,1,8890137,4,8890138,0,-4
III,+,8894126,0.0,0.0078125,7,7,0,0,11,gene,ZK637.4,3,8894146,0.178121,13,8894113,20,8894120,-6,-26
III,+,8894991,0.914851,0.0,505,43,462,288,0,gene,ZK637.5,4,8894995,2.33903,393,8894598,4,8894993,2,-2
III,+,8905525,0.00232919,0.0,1288,1285,3,3,0,gene,ZK637.8,1,8905535,2.49828,8965,8896560,10,8905525,0,-10
III,+,8912054,0.842105,4.10574e-10,76,12,64,42,1,gene,ZK637.9,2,8912057,0.12583,386,8911668,3,8912058,4,1
III,+,8913677,0.888889,2.53454e-12,72,8,64,41,0,gene,ZK637.10,3,8913688,0.169982,138,8913539,11,8913677,0,-11
III,+,8920007,0.0,0.25,2,2,0,0,0,gene,ZK637.15,0,8920018,0.0130836,3637,8916370,11,8920019,12,1
III,+,8934145,0.0,7.62939e-06,17,17,0,0,1,gene,ZK643.1,0,8934185,0.11133,3903,8930242,40,8934143,-2,-42
III,+,8944574,0.0,2.91038e-11,35,35,0,0,0,gene,ZK643.3,0,8944724,0.181546,7918,8936656,150,8944725,151,1
III,+,8944622,0.0,0.25,2,2,0,0,1,gene,ZK643.3,0,8944724,0.181546,7966,8936656,102,8944725,103,1
III,+,8956472,0.0,0.0,175,175,0,0,571,gene,ZK643.2,0,8956482,0.607555,3609,8952863,10,8956392,-80,-90
III,+,8962191,0.0,5.82077e-11,34,34,0,0,0,gene,ZK643.8,0,8962204,8.70536,4550,8957641,13,8962205,14,1
III,+,8962204,0.000567215,0.0,1763,1762,1,1,317,gene,ZK643.8,0,8962204,8.70536,4563,8957641,0,8962205,1,1
III,+,8967877,0.00740741,3.09945e-39,135,134,1,1,25,gene,R08D7.2,0,8967885,0.435862,2277,8965600,8,8967877,0,-8
III,+,8971825,0.00209205,0.0,478,477,1,1,137,gene,R08D7.4,1,8971840,0.981066,2288,8969537,15,8971825,0,-15
III,+,8974036,0.721264,2.26068e-17,348,97,251,174,0,gene,R08D7.5,2,8974069,0.573562,455,8973581,33,8974096,60,27
III,+,8992116,0.0,3.38813e-21,68,68,0,0,5,gene,R08D7.7,0,8992135,0.143705,17145,8974971,19,8992136,20,1
III,+,9002690,0.0,0.0,502,502,0,0,0,gene,F59B2.6,0,9002699,0.780627,8048,8994642,9,9002700,10,1
III,+,9017516,0.0,9.62965e-35,113,113,0,0,2,gene,F59B2.12,0,9017517,3.24797,684,9016832,1,9017518,2,1
III,+,9054962,0.00229358,0.0,872,870,2,2,3,gene,R107.6,1,9054999,1.38307,16451,9038511,37,9054962,0,-37
III,+,9058928,1.0,0.5,1,0,1,1,1,gene,R107.7,2,9059267,10.2862,124,9058804,339,9059242,314,-25
III,+,9059242,0.216126,0.0,8347,6543,1804,1485,24,gene,R107.7,2,9059267,10.2862,438,9058804,25,9059242,0,-25
III,+,9081739,0.00155049,0.0,118672,118488,184,152,7,gene,F02A9.3,0,9081740,144.288,21646,9060093,1,9081739,0,-1
III,+,9092152,0.00363636,0.0,550,548,2,2,0,gene,F02A9.6,0,9092155,0.790634,9730,9082422,3,9092152,0,-3
III,+,9092201,1.0,0.25,2,0,2,2,46,gene,F02A9.6,0,9092223,0.790634,9779,9082422,22,9092152,-49,-71
III,+,9114866,0.0,1.90735e-06,19,19,0,0,6,gene,ZK512.1,0,9115049,0.330738,8271,9106595,183,9114993,127,-56
III,+,9119463,0.0,3.30872e-24,78,78,0,0,0,gene,ZK512.3,0,9119469,0.234525,2282,9117181,6,9119470,7,1
III,+,9125640,0.0425532,7.68097e-12,47,45,2,2,7,gene,ZK512.5,0,9125731,1.1929,576,9125064,91,9125750,110,19
III,+,9136822,0.0,2.64698e-23,75,75,0,0,6,gene,ZK512.6,0,9136826,0.196314,5551,9131271,4,9136827,5,1
III,+,9144127,0.00819672,2.29456e-35,122,121,1,1,18,gene,ZK512.11,0,9144129,0.536287,2394,9141733,2,9144130,3,1
III,+,9145251,0.00906801,0.0,1985,1967,18,17,3,gene,ZK512.4,0,9145260,5.28784,663,9144588,9,9145261,10,1
III,+,9162985,0.0,0.125,3,3,0,0,0,gene,F54G8.2,0,9162986,0.0249741,5910,9157075,1,9162987,2,1
III,+,9181459,0.0,1.19209e-07,23,23,0,0,0,gene,ZC84.2,0,9181459,0.0103479,13519,9167940,0,9181460,1,1
III,+,9240277,0.00414938,0.0,241,240,1,0,3,gene,T23G5.6,0,9240284,0.537519,47457,9192820,7,9240277,0,-7
III,+,9242814,0.0,0.000244141,12,12,0,0,1,gene,T23G5.5,0,9242882,0.0763425,392,9242422,68,9242822,8,-60
III,+,9247434,0.0,7.45058e-09,27,27,0,0,26,gene,T02C1.1,0,9247551,0.241688,726,9246708,117,9247552,118,1
III,+,9250937,0.0,8.07794e-28,90,90,0,0,0,gene,T02C1.2,0,9250951,0.106706,2411,9248526,14,9250946,9,-5
III,+,9285931,0.0,5.42101e-20,64,64,0,0,1,gene,K01B6.1,0,9285992,0.327719,25938,9259993,61,9285956,25,-36
III,+,9293100,0.0,2.46519e-32,105,105,0,0,0,gene,K01B6.1,0,9293109,0.327719,33107,9259993,9,9293100,0,-9
III,+,9300123,0.0,2.77556e-17,55,55,0,0,0,gene,K01B6.3,0,9300182,0.153705,3541,9296582,59,9300123,0,-59
III,+,9322216,0.0,4.93038e-32,104,104,0,0,0,gene,C40H1.1,0,9322219,0.447908,604,9321612,3,9322220,4,1
III,+,9325036,0.0,0.5,1,1,0,0,29,gene,C40H1.7,0,9325062,0.281377,223,9324813,26,9324951,-85,-111
III,+,9330219,0.0030581,0.0,654,652,2,2,163,gene,C40H1.5,0,9330219,3.64171,3274,9326945,0,9330220,1,1
III,+,9331417,0.00312989,0.0,1917,1911,6,6,1,gene,C40H1.6,0,9331420,3.75425,589,9330828,3,9331417,0,-3
III,+,9359930,0.0,0.5,1,1,0,0,1,gene,K04H4.5,1,9360123,0.419691,27743,9332187,193,9360169,239,46
III,+,9363541,0.0,0.015625,6,6,0,0,1,gene,K04H4.7,2,9363974,0.621844,2315,9361226,433,9363968,427,-6
III,+,9363968,0.00301659,0.0,663,661,2,2,0,gene,K04H4.7,2,9363974,0.621844,2742,9361226,6,9363968,0,-6
III,+,9367174,0.0,1.54074e-33,109,109,0,0,12,gene,K04H4.6,0,9367219,0.361826,1894,9365280,45,9367174,0,-45
III,+,9393633,0.0033389,0.0,599,597,2,1,1,gene,C38C10.5,0,9393723,0.827906,6031,9387602,90,9393882,249,159
III,+,9393745,0.9,0.00976562,10,1,9,7,122,gene,C38C10.5,0,9393750,0.827906,6143,9387602,5,9393882,137,132
III,+,9433960,0.0,0.03125,5,5,0,0,1,gene,F54C8.2,0,9433974,0.559584,12485,9421475,14,9433975,15,1
III,+,9439808,0.2,0.15625,5,4,1,1,6,gene,F54C8.1,0,9439810,0.290155,4809,9434999,2,9439811,3,1
III,+,9456515,0.00776053,0.0,902,895,7,7,1,gene,B0464.5,0,9456542,3.35508,15667,9440848,27,9456515,0,-27
III,+,9465668,0.00378788,0.0,792,789,3,3,0,gene,B0464.9,1,9465673,0.589019,2794,9462874,5,9465674,6,1
III,+,9467365,0.104665,0.0,1672,1497,175,153,4,gene,B0464.7,2,9467369,6.71343,271,9467094,4,9467369,4,0
III,+,9468058,0.896067,0.0,356,37,319,252,1,gene,B0464.8,3,9468134,0.521952,99,9467959,76,9468058,0,-76
III,+,9488632,0.00178042,0.0,18535,18502,33,31,11,gene,B0464.3,0,9488633,16.7393,18832,9469800,1,9488632,0,-1
III,+,9491541,0.00576923,0.0,1040,1034,6,6,0,gene,B0464.2,0,9491558,1.12049,2454,9489087,17,9491541,0,-17
III,+,9504645,0.0,0.25,2,2,0,0,1,gene,F55H2.4,1,9504664,None,7687,9496958,19,9504665,20,1
III,+,9504651,0.666667,0.375,3,1,2,2,31,gene,F55H2.4,1,9504664,None,7693,9496958,13,9504665,14,1
III,+,9508001,0.103853,0.0,2388,2140,248,211,14,gene,F55H2.2,2,9508008,10.1344,875,9507126,7,9508001,0,-7
III,+,9511371,0.246696,3.39491e-15,227,171,56,52,4,gene,F55H2.5,3,9511375,0.551464,1714,9509657,4,9511376,5,1
III,+,9521976,0.00492611,0.0,812,808,4,4,24,gene,ZK1098.1,1,9521976,1.13367,7479,9514497,0,9521976,0,0
III,+,9525453,0.914583,0.0,480,41,439,262,4,gene,ZK1098.5,2,9525530,1.44713,99,9525354,77,9525453,0,-77
III,+,9528558,0.0,0.5,1,1,0,0,0,gene,ZK1098.2,0,9528606,0.613713,489,9528069,48,9529067,509,461
III,+,9529062,0.00977199,0.0,307,304,3,2,1,gene,ZK1098.2,0,9529066,0.613713,382,9528680,4,9529067,5,1
III,+,9543027,0.00212314,0.0,942,940,2,1,280,gene,ZK1098.4,0,9543042,0.772987,11236,9531791,15,9542993,-34,-49
III,+,9546203,0.00141945,0.0,1409,1407,2,1,154,gene,ZK1098.10,1,9546227,1.20614,405,9545798,24,9546260,57,33
III,+,9552568,1.0,0.03125,5,0,5,3,301,gene,ZK1098.10,1,9552570,1.20614,126,9552442,2,9552568,0,-2
III,+,9556500,0.888372,0.0,645,72,573,353,20,gene,ZK1098.11,2,9556500,1.85637,94,9556406,0,9556501,1,1
III,+,9568651,0.0,2.52435e-29,95,95,0,0,2,gene,C48B4.13,0,9568755,0.302546,11297,9557354,104,9568651,0,-104
III,+,9614385,0.0,5.96046e-08,24,24,0,0,132,gene,F58A4.6,0,9614391,0.471271,14399,9599986,6,9614392,7,1
III,+,9622048,0.0,2.1684e-19,62,62,0,0,0,gene,F58A4.7,0,9622230,2.12255,6815,9615233,182,9622048,0,-182
III,+,9622054,0.0625,1.15484e-07,32,30,2,1,20,gene,F58A4.7,0,9622230,2.12255,6821,9615233,176,9622054,0,-176
III,+,9699779,0.00616523,0.0,811,806,5,4,1,gene,C07A9.3,0,9699894,3.21098,46077,9653702,115,9699895,116,1
III,+,9704768,0.00530504,0.0,377,375,2,2,6,gene,C07A9.3,0,9704842,3.21098,51066,9653702,74,9704843,75,1
III,+,9747372,0.0143443,0.0,976,962,14,12,127,gene,T05G5.3,0,9747373,3.13115,37158,9710214,1,9747372,0,-1
III,+,9766415,0.00740741,3.09945e-39,135,134,1,0,1,gene,R10E11.1,0,9766472,2.29507,6144,9760271,57,9766415,0,-57
III,+,9776522,0.0031185,0.0,962,959,3,1,11,gene,R10E11.3,0,9776536,0.494214,1800,9774722,14,9776522,0,-14
III,+,9781143,0.00171233,0.0,584,583,1,1,11,gene,R10E11.8,1,9781153,9.63675,2393,9778750,10,9781143,0,-10
III,+,9781152,0.00526316,0.0,2090,2079,11,11,408,gene,R10E11.8,1,9781153,9.63675,2402,9778750,1,9781152,0,-1
III,+,9782064,0.657914,0.0,8226,2814,5412,3021,7,gene,R10E11.2,2,9782064,36.8097,107,9781957,0,9782064,0,0
III,+,9783217,0.714286,0.164062,7,2,5,4,4,gene,R10E11.6,3,9783227,0.366635,97,9783120,10,9783225,8,-2
III,+,9783225,0.846154,4.31443e-12,91,14,77,48,26,gene,R10E11.6,3,9783227,0.366635,105,9783120,2,9783225,0,-2
III,+,9794267,0.0130391,0.0,997,984,13,13,2,gene,ZK632.1,1,9794267,2.13258,8318,9785949,0,9794267,0,0
III,+,9799006,0.732394,2.52968e-12,213,57,156,136,0,gene,ZK632.2,2,9799009,0.621387,463,9798543,3,9799006,0,-3
III,+,9808443,0.00537634,0.0,186,185,1,1,8,gene,ZK632.5,1,9808444,0.290842,6210,9802233,1,9808443,0,-1
III,+,9813048,1.0,0.00390625,8,0,8,6,0,gene,ZK632.14,2,9813279,0.643993,510,9812538,231,9813346,298,67
III,+,9813345,0.803318,3.26954e-38,422,83,339,241,1,gene,ZK632.14,2,9813345,0.643993,807,9812538,0,9813346,1,1
III,+,9819193,0.00808081,0.0,990,982,8,8,8,gene,ZK632.7,1,9819201,1.31427,4985,9814208,8,9819193,0,-8
III,+,9823141,0.877863,5.08482e-20,131,16,115,82,0,gene,ZK632.8,2,9823151,0.57803,126,9823015,10,9823152,11,1
III,+,9827814,0.025,2.61389e-21,80,78,2,2,1,gene,ZK632.11,1,9827816,0.480022,3783,9824031,2,9827814,0,-2
III,+,9830701,0.248503,3.08071e-21,334,251,83,54,35,gene,ZK632.12,2,9830736,0.912554,1083,9829618,35,9830701,0,-35
III,+,9832851,0.0120482,0.0,166,164,2,1,0,gene,K11H3.4,1,9832857,0.153822,527,9832324,6,9832858,7,1
III,+,9835093,0.97,1.27559e-25,100,3,97,76,1,gene,K11H3.8,2,9835093,None,583,9834510,0,9835094,1,1
III,+,9843673,0.0,0.00390625,8,8,0,0,0,gene,K11H3.5,0,9843680,0.0562527,5129,9838544,7,9843681,8,1
III,+,9846342,0.2,0.15625,5,4,1,1,101,gene,K11H3.2,0,9846356,0.127222,657,9845685,14,9846357,15,1
III,+,9851753,0.00346741,0.0,1442,1437,5,3,1,gene,K11H3.3,0,9851785,1.65594,4245,9847508,32,9851753,0,-32
III,+,9860726,0.0,3.23117e-27,88,88,0,0,1,gene,K11H3.7,0,9860735,0.159619,7003,9853723,9,9860629,-97,-106
III,+,9893022,0.0,0.000244141,12,12,0,0,3,gene,F40F12.4,0,9893051,0.0152153,12067,9880955,29,9893052,30,1
III,+,9912915,0.0,6.01853e-36,117,117,0,0,2,gene,F40F12.10,0,9912916,None,14521,9898394,1,9913048,133,132
III,+,9913043,0.0,0.5,1,1,0,0,5,gene,F40F12.10,0,9913046,None,14649,9898394,3,9913048,5,2
III,+,9913446,0.0,0.0,159,159,0,0,5,gene,F40F12.9,0,9913528,None,128,9913318,82,9913452,6,-76
III,+,9914437,0.0,0.0,152,152,0,0,6,gene,F40F12.7,0,9914441,3.17902,771,9913666,4,9914437,0,-4
III,+,9914477,0.0,8.27181e-25,80,80,0,0,53,gene,F40F12.7,0,9914526,3.17902,811,9913666,49,9914437,-40,-89
III,+,9923071,0.0,1.90735e-06,19,19,0,0,0,gene,K03H1.10,0,9923121,0.373677,1738,9921333,50,9923071,0,-50
III,+,9927666,0.000712159,0.0,30892,30870,22,15,325,gene,K03H1.4,0,9927766,22.7176,2969,9924697,100,9927666,0,-100
III,+,9932289,0.047619,1.00136e-05,21,20,1,1,2,gene,K03H1.5,0,9932312,0.257141,1980,9930309,23,9932313,24,1
III,+,9932295,0.0,0.0,155,155,0,0,8,gene,K03H1.5,0,9932312,0.257141,1986,9930309,17,9932313,18,1
III,+,9947304,0.00330469,0.0,1513,1508,5,5,0,gene,K03H1.7,0,9947328,1.26858,942,9946362,24,9947304,0,-24
III,+,9957254,0.00647948,0.0,463,460,3,3,1,gene,R10E12.1,0,9957254,2.06294,9185,9948069,0,9957254,0,0
III,+,9993799,0.0,7.45058e-09,27,27,0,0,2,gene,C05B5.4,0,9993852,0.202796,6132,9987667,53,9993781,-18,-71
III,+,10003386,0.0,0.25,2,2,0,0,7,gene,C05B5.9,0,10003467,0.0531936,427,10002959,81,10003289,-97,-178
III,+,10037344,0.0,8.07794e-28,90,90,0,0,7,gene,M04D8.7,0,10037348,0.191467,505,10036839,4,10037349,5,1
III,+,10051939,0.0,1.54074e-33,109,109,0,0,0,gene,T16G12.3,0,10051960,0.110581,13798,10038141,21,10051961,22,1
III,+,10057718,0.0071048,0.0,563,559,4,4,3,gene,T16G12.4,0,10057738,0.918391,3467,10054251,20,10057739,21,1
III,+,10057731,0.5,0.5,2,1,1,1,1506,gene,T16G12.4,0,10057738,0.918391,3480,10054251,7,10057739,8,1
III,+,10059225,0.0,0.00390625,8,8,0,0,23,gene,T16G12.8,0,10059289,0.235276,652,10058573,64,10059196,-29,-93
III,+,10063188,0.0447761,3.29597e-31,134,128,6,6,1,gene,T16G12.5,1,10063200,0.549181,1310,10061878,12,10063177,-11,-23
III,+,10069459,0.93956,2.17936e-38,182,11,171,127,1,gene,T16G12.6,2,10069475,0.483392,477,10068982,16,10069470,11,-5
III,+,10069471,0.428571,0.273438,7,4,3,1,415,gene,T16G12.6,2,10069475,0.483392,489,10068982,4,10069470,-1,-5
III,+,10083527,0.2,0.15625,5,4,1,1,2,gene,T16H12.1,1,10083533,0.0158323,7596,10075931,6,10083534,7,1
III,+,10086179,1.0,0.03125,5,0,5,5,1,gene,T16H12.2,3,10086195,0.0375852,148,10086031,16,10086196,17,1
III,+,10109310,0.0,0.00195312,9,9,0,0,94,gene,T16H12.9,0,10109315,0.272751,22263,10087047,5,10109316,6,1
III,+,10114935,0.00970874,0.0,206,204,2,2,1,gene,ZK1128.2,0,10114935,0.332961,2976,10111959,0,10114935,0,0
III,+,10120674,0.00912409,0.0,548,543,5,5,3,gene,ZK1128.5,1,10120675,1.13327,4004,10116670,1,10120674,0,-1
III,+,10124076,0.871473,8.40779e-45,319,41,278,212,0,gene,ZK1128.6,2,10124151,0.871434,1221,10122855,75,10124076,0,-75
III,+,10127687,0.0294118,1.97906e-09,34,33,1,1,0,gene,ZK1128.6,2,10127697,0.871434,4832,10122855,10,10127687,0,-10
III,+,10152689,0.00757576,0.0,264,262,2,0,1,gene,K08E5.2,0,10152741,0.653047,13506,10139183,52,10152689,0,-52
III,+,10154194,0.0,0.0625,4,4,0,0,0,gene,K08E5.2,0,10154195,0.653047,15011,10139183,1,10154194,0,-1
III,+,10189112,0.0,0.25,2,2,0,0,0,gene,T20G5.5,0,10189166,0.0219954,5692,10183420,54,10189112,0,-54
III,+,10199268,0.0,0.25,2,2,0,0,4219,gene,T20G5.8,0,10199326,1.89188,1007,10198261,58,10199231,-37,-95
III,+,10199574,1.0,0.5,1,0,1,1,52,gene,T20G5.8,0,10199790,1.89188,1313,10198261,216,10199231,-343,-559
III,+,10203715,0.0122699,0.0,326,322,4,3,0,gene,T20G5.1,1,10203765,3.75903,1293,10202422,50,10203715,0,-50
III,+,10203766,0.0,0.5,1,1,0,0,201,gene,T20G5.1,1,10203808,3.75903,1344,10202422,42,10203715,-51,-93
III,+,10209718,1.0,0.5,1,0,1,1,0,gene,T20G5.9,2,10209741,1.34585,120,10209598,23,10209742,24,1
III,+,10209734,0.77433,0.0,709,160,549,398,11,gene,T20G5.9,2,10209741,1.34585,136,10209598,7,10209742,8,1
III,+,10218845,0.00766284,0.0,1044,1036,8,7,0,gene,T20G5.14,0,10218847,2.48041,4122,10214723,2,10218837,-8,-10
III,+,10223511,0.0,1.52588e-05,16,16,0,0,1,gene,Y70G10A.1,0,10223532,None,732,10222779,21,10223418,-93,-114
III,+,10238998,0.0689655,7.56234e-07,29,27,2,2,10,gene,Y70G10A.3,0,10239010,0.413643,14964,10224034,12,10238998,0,-12
III,+,10249024,0.0117647,2.1972e-24,85,84,1,1,9,gene,R01H10.3,0,10249030,0.749745,225,10248799,6,10249024,0,-6
III,+,10271151,0.0,0.0,286,286,0,0,4,gene,R01H10.8,0,10271169,0.556684,14042,10257109,18,10271151,0,-18
III,+,10279023,0.638889,0.0336264,36,13,23,9,1,gene,K10G9.3,0,10279161,0.235816,548,10278475,138,10279023,0,-138
III,+,10285817,0.00438596,0.0,228,227,1,0,1,gene,K10G9.2,0,10285948,0.489151,4357,10281460,131,10285817,0,-131
III,+,10295028,0.00401606,0.0,249,248,1,1,0,gene,K10G9.1,0,10295087,0.528965,6510,10288518,59,10295028,0,-59
III,+,10320947,0.0,0.0,239,239,0,0,188,gene,T07C4.10,0,10320949,0.460379,1037,10319910,2,10320950,3,1
III,+,10334168,0.00663265,0.0,1960,1947,13,11,180,gene,T07C4.7,1,10334168,6.08715,8602,10325566,0,10334168,0,0
III,+,10335063,0.0167131,0.0,359,353,6,6,3,gene,T07C4.8,2,10335119,0.899787,2,10335061,56,10335063,0,-56
III,+,10347239,0.0,0.5,1,1,0,0,0,gene,T07C4.2,0,10347453,0.18344,7914,10339325,214,10347466,227,13
III,+,10347466,0.0,5.82077e-11,34,34,0,0,1,gene,T07C4.2,0,10347474,0.18344,8141,10339325,8,10347466,0,-8
III,+,10352035,0.047619,1.00136e-05,21,20,1,1,0,gene,T07C4.3,0,10352112,1.48356,2407,10349628,77,10352113,78,1
III,+,10352048,0.00358423,0.0,837,834,3,3,35,gene,T07C4.3,0,10352112,1.48356,2420,10349628,64,10352048,0,-64
III,+,10364849,0.0,6.93889e-18,57,57,0,0,0,gene,C38H2.1,0,10364956,0.126083,9845,10355004,107,10364987,138,31
III,+,10381663,0.0,0.0,827,827,0,0,0,gene,C38H2.2,0,10381675,1.02628,8542,10373121,12,10381663,0,-12
III,+,10404964,0.0,0.125,3,3,0,0,43,gene,M03C11.3,1,10405031,0.82176,19746,10385218,67,10404960,-4,-71
III,+,10407535,0.0,0.03125,5,5,0,0,1,gene,M03C11.3,1,10407671,0.82176,22317,10385218,136,10408111,576,440
III,+,10408111,0.0075188,0.0,665,660,5,4,0,gene,M03C11.3,1,10408131,0.82176,22893,10385218,20,10408111,0,-20
III,+,10416027,0.545045,0.0217897,222,101,121,83,0,gene,M03C11.5,2,10416038,0.729016,257,10415770,11,10416027,0,-11
III,+,10461514,0.0100503,0.0,398,394,4,4,0,gene,D2045.1,0,10461598,5.14358,16636,10444878,84,10461514,0,-84
III,+,10464342,0.00301205,0.0,332,331,1,1,1,gene,D2045.1,0,10464349,5.14358,19464,10444878,7,10464342,0,-7
III,+,10471123,0.0159744,0.0,313,308,5,2,1,gene,D2045.6,1,10471123,1.24856,3191,10467932,0,10471123,0,0
III,+,10475856,0.0,7.52316e-37,120,120,0,0,4,gene,D2045.9,2,10475873,0.288165,701,10475155,17,10475856,0,-17
III,+,10488012,0.0,0.0,383,383,0,0,1,gene,F43D9.1,0,10488014,0.928613,4205,10483807,2,10488015,3,1
III,+,10505351,0.0,0.0625,4,4,0,0,12,gene,F43D9.6,0,10505365,None,5167,10500184,14,10505366,15,1
III,+,10505366,0.00970874,0.0,515,510,5,4,42,gene,F43D9.6,0,10505553,None,5182,10500184,187,10505366,0,-187
III,+,10505382,0.0,0.25,2,2,0,0,2480,gene,F43D9.6,0,10505553,None,5198,10500184,171,10505366,-16,-187
III,+,10507014,0.0,6.31089e-30,97,97,0,0,62,gene,F43D9.3,0,10507044,0.578483,1231,10505783,30,10507045,31,1
III,+,10520729,0.0185185,1.78048e-29,108,106,2,1,107,gene,T21C12.1,0,10520775,0.541924,2109,10518620,46,10520686,-43,-89
III,+,10530470,0.0,4.33681e-19,61,61,0,0,54,gene,T21C12.1,0,10530500,0.541924,118,10530352,30,10530460,-10,-40
III,+,10535410,0.0034418,0.0,3196,3185,11,9,21,gene,T21C12.2,0,10535431,6.23938,2822,10532588,21,10535410,0,-21
III,+,10562908,0.0,0.0,215,215,0,0,6,gene,Y45F3A.2,1,10562922,0.519491,25347,10537561,14,10562908,0,-14
III,+,10566140,0.521891,0.0193236,571,273,298,231,293,gene,Y45F3A.3,2,10566167,1.09893,659,10565481,27,10566140,0,-27
III,+,10566473,0.0216216,0.0,185,181,4,4,0,gene,Y45F3A.3,2,10566473,1.09893,992,10565481,0,10566473,0,0
III,+,10615348,0.938247,0.0,502,31,471,239,0,gene,Y39A1A.6,3,10615348,1.23814,537,10614811,0,10615348,0,0
III,+,10621423,0.0,9.62965e-35,113,113,0,0,1,gene,Y39A1A.23,0,10621438,0.176906,3645,10617778,15,10621423,0,-15
III,+,10621467,0.0,5.96046e-08,24,24,0,0,8,gene,Y39A1A.23,0,10621502,0.176906,3689,10617778,35,10621467,0,-35
III,+,10632503,0.0,0.5,1,1,0,0,0,gene,Y39A1A.10,0,10632512,0.00702189,6242,10626261,9,10632610,107,98
III,+,10642537,0.0,0.03125,5,5,0,0,73,gene,Y39A1A.12,1,10642586,0.791159,2918,10639619,49,10642947,410,361
III,+,10643007,0.00446927,0.0,895,891,4,4,67,gene,Y39A1A.12,1,10643015,0.791159,3388,10639619,8,10642947,-60,-68
III,+,10646052,0.839806,1.69811e-24,206,33,173,133,3,gene,Y39A1A.13,2,10646052,0.487414,112,10645940,0,10646052,0,0
III,+,10649401,0.947627,0.0,611,32,579,402,0,gene,Y39A1A.14,3,10649434,1.54615,661,10648740,33,10649401,0,-33
III,+,10655657,0.923077,1.66237e-08,39,3,36,30,0,gene,Y39A1A.15,4,10655660,1.05722,4871,10650786,3,10655661,4,1
III,+,10663493,0.0,1.81899e-12,39,39,0,0,3,gene,Y39A1A.15,4,10663520,1.05722,12707,10650786,27,10663329,-164,-191
III,+,10666881,0.0,0.0625,4,4,0,0,46,gene,Y39A1A.15,4,10666985,1.05722,16095,10650786,104,10666773,-108,-212
III,+,10707643,0.00145773,0.0,2058,2055,3,2,1,gene,W09D10.3,0,10707648,1.13195,8900,10698743,5,10707643,0,-5
III,+,10742686,0.0227273,2.50111e-12,44,43,1,0,18,gene,K01G5.6,0,10742711,0.359415,34270,10708416,25,10742692,6,-19
III,+,10742692,0.0181818,1.52656e-15,55,54,1,1,12,gene,K01G5.6,0,10742711,0.359415,34276,10708416,19,10742692,0,-19
III,+,10748311,0.00612472,0.0,3592,3570,22,19,4,gene,K01G5.5,1,10748323,8.19917,1765,10746546,12,10748311,0,-12
III,+,10759272,0.0125786,1.68156e-44,159,157,2,1,191,gene,K01G5.9,1,10759648,1.10389,7492,10751780,376,10759267,-5,-381
III,+,10759551,0.00645161,2.8026e-45,155,154,1,1,0,gene,K01G5.9,1,10759648,1.10389,42,10759509,97,10759551,0,-97
III,+,10763013,0.921922,0.0,666,52,614,454,0,gene,Y39A1B.3,2,10763028,0.774302,129,10762884,15,10763029,16,1
III,+,10781737,0.0,7.27596e-12,37,37,0,0,0,gene,Y39A1B.2,0,10781749,0.0934351,4527,10777210,12,10781763,26,14
III,+,10805826,0.0,0.125,3,3,0,0,35,gene,K11D9.1,0,10805914,1.59025,9575,10796251,88,10805812,-14,-102
III,+,10808223,0.017341,0.0,173,170,3,3,0,gene,K11D9.1,0,10808227,1.59025,11972,10796251,4,10808223,0,-4
III,+,10834896,0.0222222,1.27898e-12,45,44,1,1,0,gene,R17.3,0,10834906,0.192149,12573,10822323,10,10834896,0,-10
III,+,10849104,0.00420757,0.0,713,710,3,3,0,gene,Y39A1C.4,0,10849108,0.518922,2523,10846581,4,10849102,-2,-6
III,+,10856658,0.00465116,0.0,215,214,1,1,25,gene,Y39A1C.1,1,10856708,0.5739,857,10855801,50,10856709,51,1
III,+,10858166,0.935897,0.0,234,15,219,136,0,gene,Y39A1C.2,2,10858166,0.417035,98,10858068,0,10858166,0,0
III,+,10869254,0.0,1.42109e-14,46,46,0,0,0,gene,C44B9.1,0,10869273,0.211406,2422,10866832,19,10869075,-179,-198
III,+,10875316,0.285714,0.164062,7,5,2,1,9,gene,C44B9.2,0,10875340,0.206737,794,10874522,24,10875341,25,1
III,+,10881784,0.0,0.0625,4,4,0,0,5,gene,C44B9.4,0,10881802,0.391456,3823,10877961,18,10882227,443,425
III,+,10882236,0.0,4.76837e-07,21,21,0,0,0,gene,C44B9.4,0,10882251,0.391456,4275,10877961,15,10882227,-9,-24
III,+,10882243,0.0,2.84217e-14,45,45,0,0,7,gene,C44B9.4,0,10882251,0.391456,4282,10877961,8,10882227,-16,-24
III,+,10896021,0.0,0.25,2,2,0,0,2,gene,C44B9.5,2,10896066,0.358693,2469,10893552,45,10896310,289,244
III,+,10896247,0.933054,0.0,239,16,223,180,20,gene,C44B9.5,2,10896258,0.358693,108,10896139,11,10896310,63,52
III,+,10906338,0.00401606,0.0,747,744,3,3,9,gene,M142.1,0,10906351,0.881838,4620,10901718,13,10906338,0,-13
III,+,10907480,0.0,1.26218e-29,96,96,0,0,0,gene,M142.1,0,10907558,0.881838,5762,10901718,78,10907476,-4,-82
III,+,10911360,0.0,0.0,254,254,0,0,6,gene,M142.2,0,10911375,0.397274,2551,10908809,15,10911360,0,-15
III,+,10931090,0.00154083,0.0,649,648,1,1,0,gene,M142.5,1,10931090,0.742563,2271,10928819,0,10931090,0,0
III,+,10933513,0.922693,0.0,401,31,370,254,0,gene,M142.8,2,10933525,0.953288,818,10932695,12,10933513,0,-12
III,+,10936128,0.953668,0.0,259,12,247,157,1,gene,M142.6,3,10936151,1.55193,129,10935999,23,10936128,0,-23
III,+,10947328,0.906977,1.39714e-37,215,20,195,126,0,gene,Y52D3.1,4,10947340,0.689396,118,10947210,12,10947328,0,-12
III,+,10947337,0.972222,5.23869e-10,36,1,35,23,535,gene,Y52D3.1,4,10947340,0.689396,127,10947210,3,10947337,0,-3
III,+,11008104,0.00756369,0.0,5024,4986,38,33,4,gene,Y48A6B.3,1,11008112,5.22758,16305,10991799,8,11008104,0,-8
III,+,11008925,0.969697,0.0,363,11,352,259,5,gene,Y48A6B.5,2,11008932,1.13715,111,11008814,7,11008925,0,-7
III,+,11012448,0.0909091,0.00537109,11,10,1,0,0,gene,Y48A6B.6,0,11012509,0.0520738,1962,11010486,61,11012448,0,-61
III,+,11036836,0.00543478,0.0,368,366,2,2,75,gene,Y48A6B.10,0,11036865,0.574339,961,11035875,29,11036866,30,1
III,+,11055882,0.0,1.13687e-13,43,43,0,0,2,gene,Y48A6B.13,0,11056126,1.24714,2105,11053777,244,11055882,0,-244
III,+,11063462,0.0,1.35525e-20,66,66,0,0,254,gene,Y48A6B.11,1,11063577,0.907215,553,11062909,115,11063438,-24,-139
III,+,11068737,0.971429,1.01863e-09,35,1,34,28,0,gene,W09D6.1,2,11068739,0.11131,102,11068635,2,11068740,3,1
III,+,11079634,0.0,0.5,1,1,0,0,1,gene,W09D6.4,0,11079673,0.357647,177,11079457,39,11079674,40,1
III,+,11088369,0.0,0.0,918,918,0,0,2,gene,W09D6.5,0,11088371,2.73681,8074,11080295,2,11088369,0,-2
III,+,11119685,0.0113314,0.0,353,349,4,3,5,gene,Y48A6C.4,0,11119883,0.512002,28194,11091491,198,11119685,0,-198
III,+,11131530,0.0,0.25,2,2,0,0,7,gene,Y48A6C.5,0,11131574,0.247408,4472,11127058,44,11131681,151,107
III,+,11131657,0.0,3.46945e-18,58,58,0,0,1,gene,Y48A6C.5,0,11131680,0.247408,4599,11127058,23,11131681,24,1
III,+,11142330,0.00462963,0.0,216,215,1,1,3,gene,Y47D3A.29,1,11142348,0.93693,5761,11136569,18,11142330,0,-18
III,+,11154709,0.864615,8.68805e-44,325,44,281,205,2,gene,Y47D3A.4,2,11154730,0.415911,663,11154046,21,11154709,0,-21
III,+,11237027,0.00342466,0.0,584,582,2,2,1,gene,Y47D3A.15,0,11237032,1.40776,14414,11222613,5,11237033,6,1
III,+,11245002,0.212938,2.85014e-30,371,292,79,64,0,gene,Y47D3A.16,0,11245037,1.9584,7003,11237999,35,11245071,69,34
III,+,11255716,0.0,1.16415e-10,33,33,0,0,3,gene,Y47D3A.32,0,11255728,0.40041,3551,11252165,12,11255719,3,-9
III,+,11290793,0.0163043,0.0,184,181,3,3,8,gene,Y47D3A.26,0,11290810,0.822113,14879,11275914,17,11290793,0,-17
III,+,11317452,0.00909091,8.47409e-32,110,109,1,1,0,gene,Y47D3A.28,0,11317464,0.338506,11359,11306093,12,11317452,0,-12
III,+,11360337,0.00495049,0.0,202,201,1,1,1,gene,T28D6.4,0,11360357,0.342242,16309,11344028,20,11360337,0,-20
III,+,11427008,0.0,0.5,1,1,0,0,0,gene,Y47D3B.6,0,11427107,1.48203,2469,11424539,99,11427016,8,-91
III,+,11456758,0.0,5.16988e-26,84,84,0,0,0,gene,Y47D3B.11,0,11456764,0.614953,28463,11428295,6,11456758,0,-6
III,+,11496750,0.0,0.0,263,263,0,0,32,gene,Y66D12A.24,0,11496751,0.483568,5087,11491663,1,11496720,-30,-31
III,+,11508996,0.00775194,0.0,258,256,2,2,256,gene,Y66D12A.19,0,11509007,0.239445,190,11508806,11,11509008,12,1
III,+,11509562,0.0,0.25,2,2,0,0,1,gene,Y66D12A.18,0,11509757,0.191449,756,11508806,195,11509562,0,-195
III,+,11510444,0.0,0.0625,4,4,0,0,0,gene,Y66D12A.18,0,11510450,0.191449,1638,11508806,6,11510444,0,-6
III,+,11524328,0.0,1.79366e-43,142,142,0,0,31,gene,Y66D12A.16,1,11524389,0.512927,12980,11511348,61,11524319,-9,-70
III,+,11526176,0.0,0.5,1,1,0,0,2,gene,Y66D12A.15,2,11526247,0.614847,1696,11524480,71,11526253,77,6
III,+,11526185,0.0,0.00195312,9,9,0,0,4,gene,Y66D12A.15,2,11526247,0.614847,1705,11524480,62,11526253,68,6
III,+,11526538,0.903226,9.71206e-17,93,9,84,64,25,gene,Y66D12A.15,2,11526562,0.614847,95,11526443,24,11526501,-37,-61
III,+,11548257,0.166667,0.0161133,12,10,2,1,40,gene,Y66D12A.13,0,11548257,0.262096,1670,11546587,0,11548258,1,1
III,+,11561033,0.00390625,0.0,768,765,3,3,1,gene,Y66D12A.12,0,11561051,0.912125,8753,11552280,18,11561032,-1,-19
III,+,11561247,1.0,0.5,1,0,1,0,143,gene,Y66D12A.12,0,11561336,0.912125,8967,11552280,89,11561032,-215,-304
III,+,11565789,0.00816326,0.0,245,243,2,1,298,gene,Y66D12A.10,1,11565792,0.86267,348,11565441,3,11565715,-74,-77
III,+,11568018,0.819383,0.0,681,123,558,373,0,gene,Y66D12A.9,2,11568021,1.91099,132,11567886,3,11568018,0,-3
III,+,11574102,0.94186,0.0,516,30,486,347,2,gene,Y66D12A.8,3,11574102,1.14866,223,11573879,0,11574103,1,1
III,+,11616639,0.00581395,0.0,172,171,1,1,12,gene,Y66A7A.5,0,11616639,0.213145,964,11615675,0,11616640,1,1
III,+,11624871,0.0,0.03125,5,5,0,0,0,gene,Y66A7A.6,0,11624925,1.77345,999,11623872,54,11624872,1,-53
III,+,11625123,0.00243754,0.0,1641,1637,4,4,20,gene,Y66A7A.6,0,11625123,1.77345,1251,11623872,0,11625123,0,0
III,+,11641297,0.0,0.25,2,2,0,0,4,gene,Y41C4A.17,0,11641341,3.40771,13180,11628117,44,11641342,45,1
III,+,11657619,0.00163666,0.0,611,610,1,1,2,gene,Y41C4A.4,0,11657647,1.34318,1481,11656138,28,11657619,0,-28
III,+,11675443,0.0232558,4.72398e-23,86,84,2,2,0,gene,Y41C4A.4,0,11675542,1.34318,19305,11656138,99,11675443,0,-99
III,+,11696143,0.411765,0.148376,17,10,7,5,1,gene,Y41C4A.6,0,11696241,0.320229,1095,11695048,98,11696570,427,329
III,+,11696502,0.0,0.03125,5,5,0,0,97,gene,Y41C4A.6,0,11696503,0.320229,166,11696336,1,11696570,68,67
III,+,11746925,0.0169492,2.0773e-32,118,116,2,2,6,gene,Y41C4A.14,0,11746929,0.35494,14271,11732654,4,11746925,0,-4
III,+,11774831,0.00352113,0.0,284,283,1,0,0,gene,C24H11.6,1,11774844,0.485659,24779,11750052,13,11774997,166,153
III,+,11777508,0.907173,2.5875e-41,237,22,215,139,2,gene,C24H11.9,2,11777524,0.44178,952,11776556,16,11777525,17,1
III,+,11780116,0.844225,0.0,1316,205,1111,771,26,gene,C24H11.5,3,11780418,2.59023,987,11779129,302,11780116,0,-302
III,+,11795629,0.0,0.00012207,13,13,0,0,0,gene,C24H11.8,0,11795651,0.0891099,6272,11789357,22,11795677,48,26
III,+,11816452,0.00685871,0.0,729,724,5,2,0,gene,C18D11.1,0,11816458,2.66404,3889,11812563,6,11816459,7,1
III,+,11823445,0.0,0.0625,4,4,0,0,66,gene,C18D11.3,1,11823502,0.752175,3758,11819687,57,11823491,46,-11
III,+,11823671,0.0,0.00195312,9,9,0,0,1,gene,C18D11.3,1,11823672,0.752175,3984,11819687,1,11823671,0,-1
III,+,11826299,0.428044,6.058e-06,813,465,348,283,3,gene,C18D11.4,2,11826311,2.84013,1448,11824851,12,11826299,0,-12
III,+,11848033,0.0,0.0,1259,1259,0,0,3,gene,Y56A3A.3,0,11848035,1.48561,17179,11830854,2,11848033,0,-2
III,+,11915809,0.0,1.11022e-16,53,53,0,0,134,gene,Y56A3A.17,0,11915815,1.03973,5969,11909840,6,11915816,7,1
III,+,11920616,0.00315482,0.0,12996,12955,41,33,6,gene,Y56A3A.21,1,11920621,13.7281,2861,11917755,5,11920616,0,-5
III,+,11921555,1.0,0.000488281,11,0,11,10,4,gene,Y56A3A.22,2,11921577,0.985013,56,11921499,22,11921573,18,-4
III,+,11921573,0.905391,0.0,1818,172,1646,1295,37,gene,Y56A3A.22,2,11921577,0.985013,74,11921499,4,11921573,0,-4
III,+,11921638,0.111111,0.0175781,9,8,1,1,46,gene,Y56A3A.22,2,11921720,0.985013,139,11921499,82,11921573,-65,-147
III,+,11923767,0.87152,0.0,467,60,407,286,0,gene,Y56A3A.13,3,11923770,0.928625,61,11923706,3,11923767,0,-3
III,+,11982435,0.0,1.54074e-33,109,109,0,0,1,gene,Y56A3A.31,1,11982446,0.268091,53173,11929262,11,11982435,0,-11
III,+,11990048,0.524096,0.0105686,830,395,435,293,15,gene,Y56A3A.32,2,11990080,1.20029,254,11989794,32,11990048,0,-32
III,+,12020433,0.00127755,0.0,6262,6254,8,8,10,gene,Y79H2A.1,0,12020647,23.6352,21982,11998451,214,12020433,0,-214
III,+,12107654,0.0,1.11022e-16,53,53,0,0,1,gene,Y75B8A.4,0,12107664,0.362503,35482,12072172,10,12107654,0,-10
III,+,12152779,0.00507614,0.0,197,196,1,0,0,gene,Y75B8A.7,1,12152794,0.385267,39419,12113360,15,12152779,0,-15
III,+,12160640,0.942249,0.0,329,19,310,225,3,gene,Y75B8A.8,2,12160767,1.27995,1095,12159545,127,12160768,128,1
III,+,12186293,0.00175285,0.0,1141,1139,2,2,0,gene,Y75B8A.11,0,12186303,0.162287,15057,12171236,10,12186304,11,1
III,+,12218920,0.0,0.000244141,12,12,0,0,81,gene,Y75B8A.16,0,12218939,0.208414,22014,12196906,19,12218903,-17,-36
III,+,12218933,0.0,0.00390625,8,8,0,0,244,gene,Y75B8A.16,0,12218939,0.208414,22027,12196906,6,12218903,-30,-36
III,+,12218956,0.0,0.125,3,3,0,0,172,gene,Y75B8A.16,0,12218970,0.208414,22050,12196906,14,12218903,-53,-67
III,+,12226504,0.0,0.5,1,1,0,0,0,gene,Y75B8A.19,0,12226523,0.177073,2702,12223802,19,12226548,44,25
III,+,12226512,0.0,3.67342e-40,131,131,0,0,6,gene,Y75B8A.19,0,12226523,0.177073,2710,12223802,11,12226548,36,25
III,+,12273920,0.00673401,0.0,297,295,2,0,3,gene,Y75B8A.25,0,12273921,0.415895,23031,12250889,1,12273920,0,-1
III,+,12307577,0.0,0.25,2,2,0,0,0,gene,Y75B8A.27,0,12307673,0.499043,25479,12282098,96,12307661,84,-12
III,+,12307661,0.0,0.0,443,443,0,0,35,gene,Y75B8A.27,0,12307673,0.499043,25563,12282098,12,12307661,0,-12
III,+,12318975,0.00952381,2.58845e-30,105,104,1,1,8,gene,Y75B8A.28,0,12318987,0.188842,3238,12315737,12,12318988,13,1
III,+,12327709,0.0,0.000976562,10,10,0,0,297,gene,Y75B8A.29,0,12327717,0.564725,710,12326999,8,12327686,-23,-31
III,+,12336787,0.0185185,2.9976e-15,54,53,1,0,0,gene,Y75B8A.35,0,12336803,0.407204,4651,12332136,16,12336787,0,-16
III,+,12351522,0.0177936,0.0,281,276,5,4,12,gene,Y75B8A.31,0,12351527,0.645241,6260,12345262,5,12351520,-2,-7
III,+,12370336,0.00381922,0.0,1571,1565,6,4,1,gene,Y49E10.1,0,12370340,3.14843,9208,12361128,4,12370336,0,-4
III,+,12426773,0.00139276,0.0,718,717,1,1,7,gene,Y49E10.14,0,12426802,1.53153,27957,12398816,29,12426773,0,-29
III,+,12430395,0.0060423,0.0,993,987,6,5,301,gene,Y49E10.16,0,12430399,1.2287,1329,12429066,4,12430393,-2,-6
III,+,12457479,0.0,0.0,430,430,0,0,2,gene,Y49E10.21,0,12457515,0.254466,16497,12440982,36,12457479,0,-36
III,+,12457485,0.0,0.00390625,8,8,0,0,85,gene,Y49E10.21,0,12457515,0.254466,16503,12440982,30,12457479,-6,-36
III,+,12466490,0.879121,1.91146e-14,91,11,80,56,0,gene,Y49E10.22,0,12466498,0.0958499,731,12465759,8,12466499,9,1
III,+,12466498,1.0,0.25,2,0,2,2,78,gene,Y49E10.22,0,12466498,0.0958499,739,12465759,0,12466499,1,1
III,+,12472759,0.0229885,2.41756e-23,87,85,2,0,1,gene,Y49E10.23,0,12472771,0.212157,338,12472421,12,12472759,0,-12
III,+,12495966,0.00325873,0.0,11661,11623,38,35,5,gene,Y111B2A.2,1,12495967,4.3994,7743,12488223,1,12495966,0,-1
III,+,12496418,0.904412,0.0,272,26,246,194,13,gene,Y111B2A.3,2,12496423,0.779918,18,12496400,5,12496418,0,-5
III,+,12499441,0.210526,4.14272e-15,171,135,36,33,1,gene,Y111B2A.4,3,12499442,0.430468,222,12499219,1,12499441,0,-1
III,+,12509688,0.0,0.125,3,3,0,0,0,gene,Y111B2A.5,0,12509700,0.355265,3275,12506413,12,12509688,0,-12
III,+,12528167,0.5,0.168188,22,11,11,8,30,gene,Y111B2A.25,2,12528212,None,238,12527929,45,12528167,0,-45
III,+,12609169,0.00361882,0.0,829,826,3,2,2,gene,Y111B2A.12,0,12609173,1.23694,72449,12536720,4,12609169,0,-4
III,+,12619213,0.0,0.5,1,1,0,0,1,gene,Y111B2A.28,1,12619284,0.768101,1274,12617939,71,12619437,224,153
III,+,12624646,0.751397,1.2887e-22,358,89,269,133,16,gene,Y111B2A.13,2,12624653,1.44086,1850,12622796,7,12624646,0,-7
III,+,12626450,0.0928962,0.0,366,332,34,20,0,gene,Y111B2A.14,0,12626454,0.352047,675,12625775,4,12626455,5,1
III,+,12673557,0.0092081,0.0,543,538,5,5,12,gene,Y111B2A.17,0,12673563,0.463665,21918,12651639,6,12673557,0,-6
III,+,12688198,0.0,0.0,257,257,0,0,40,gene,Y111B2A.19,1,12688206,0.454761,2075,12686123,8,12688153,-45,-53
III,+,12699374,0.966942,3.19562e-30,121,4,117,88,1,gene,Y111B2A.24,2,12699378,0.49955,1695,12697679,4,12699379,5,1
III,+,12711440,0.0046729,0.0,642,639,3,3,3,gene,Y111B2A.20,1,12711452,1.13716,613,12710827,12,12711440,0,-12
III,+,12714446,0.0315236,0.0,571,553,18,14,0,gene,Y111B2A.22,2,12714467,1.19027,692,12713754,21,12714446,0,-21
III,+,12746301,0.930233,1.40301e-09,43,3,40,28,0,gene,Y111B2A.21,3,12746330,0.0403969,2310,12743991,29,12746331,30,1
III,+,12785034,0.0,2.52435e-29,95,95,0,0,0,gene,ZC482.5,0,12785040,0.0576756,13822,12771212,6,12785034,0,-6
III,+,12813470,0.0,0.5,1,1,0,0,6,gene,BE10.4,0,12813475,0.0331893,2043,12811427,5,12813395,-75,-80
III,+,12820023,0.0,7.45058e-09,27,27,0,0,6,gene,Y37D8A.2,0,12820137,2.01892,3347,12816676,114,12820021,-2,-116
III,+,12829248,0.0,0.0,780,780,0,0,1,gene,Y37D8A.3,0,12829249,0.817093,3697,12825551,1,12829248,0,-1
III,+,12874911,0.0176887,0.0,848,833,15,12,2,gene,Y37D8A.10,0,12874942,2.04627,7442,12867469,31,12874887,-24,-55
III,+,12905371,0.0074791,0.0,13638,13536,102,87,0,gene,Y37D8A.14,0,12905375,19.8992,24795,12880576,4,12905371,0,-4
III,+,12910299,0.0,3.63798e-12,38,38,0,0,8,gene,Y37D8A.15,0,12910391,3.59048,3802,12906497,92,12910109,-190,-282
III,+,12926439,0.00147493,0.0,1356,1354,2,1,1,gene,Y37D8A.18,0,12926439,1.16382,11632,12914807,0,12926440,1,1
III,+,12934597,0.0136364,0.0,440,434,6,4,2,gene,Y37D8A.22,0,12934598,0.612125,3283,12931314,1,12934597,0,-1
III,+,12979042,0.00267142,0.0,1123,1120,3,2,0,gene,ZK1010.3,0,12979054,1.2533,4039,12975003,12,12979042,0,-12
III,+,13003846,0.0,2.58494e-26,85,85,0,0,0,gene,ZK1010.10,0,13003924,None,11441,12992405,78,13003846,0,-78
III,+,13047422,0.0,0.125,3,3,0,0,0,gene,F54F12.2,0,13047434,0.0865486,11199,13036223,12,13047435,13,1
III,+,13107487,0.00288184,0.0,347,346,1,0,1,gene,Y39E4B.7,0,13107571,0.716051,13944,13093543,84,13107487,0,-84
III,+,13153697,0.0149893,0.0,467,460,7,6,0,gene,Y39E4B.1,0,13153712,2.14782,19879,13133818,15,13153697,0,-15
III,+,13162310,0.166667,0.0161133,12,10,2,0,0,gene,Y39E4B.14,0,13162313,None,2146,13160164,3,13162355,45,42
III,+,13169798,0.0141243,0.0,354,349,5,5,5,gene,Y39E4B.5,0,13169831,0.689445,4960,13164838,33,13169798,0,-33
III,+,13187272,0.00546448,0.0,183,182,1,1,1,gene,Y39E4B.12,0,13187364,1.37046,14286,13172986,92,13187272,0,-92
III,+,13187990,0.0,2.84217e-14,45,45,0,0,1,gene,Y39E4B.12,0,13188015,1.37046,15004,13172986,25,13187990,0,-25
III,+,13204815,0.0,0.25,2,2,0,0,0,gene,Y39E4B.11,0,13204903,0.118271,38,13204777,88,13204862,47,-41
III,+,13212573,0.0181818,1.52656e-15,55,54,1,1,1,gene,Y39E4B.4,0,13212578,0.0701001,5303,13207270,5,13212579,6,1
III,+,13222952,0.0,0.0,228,228,0,0,0,gene,Y43F4A.1,0,13222972,0.425895,8684,13214268,20,13222952,0,-20
III,+,13245463,0.04,7.45058e-07,25,24,1,1,0,gene,Y43F4A.4,0,13245674,0.020928,16123,13229340,211,13245463,0,-211
III,+,13254555,0.00617284,0.0,324,322,2,0,1,gene,F56A8.9,2,13254567,None,977,13253578,12,13254556,1,-11
III,+,13256760,0.279605,2.68859e-15,304,219,85,47,1,gene,F56A8.3,3,13256783,4.33904,413,13256347,23,13256759,-1,-24
III,+,13260471,0.00567721,0.0,1233,1226,7,7,2,gene,F56A8.3,3,13260512,4.33904,4124,13256347,41,13260471,0,-41
III,+,13263167,0.674699,9.76154e-09,249,81,168,131,4,gene,F56A8.4,4,13263177,0.478984,393,13262774,10,13263167,0,-10
III,+,13265751,0.82716,1.83128e-26,243,42,201,115,69,gene,F56A8.5,5,13265751,0.550895,834,13264917,0,13265751,0,0
III,+,13277141,0.00234192,0.0,1281,1278,3,2,0,gene,F56A8.7,0,13277180,1.53876,10334,13266807,39,13277141,0,-39
III,+,13277196,0.0,4.33681e-19,61,61,0,0,176,gene,F56A8.7,0,13277248,1.53876,10389,13266807,52,13277141,-55,-107
III,+,13296733,0.00653595,0.0,459,456,3,3,3,gene,Y43F4B.4,1,13296736,1.7249,10200,13286533,3,13296733,0,-3
III,+,13299258,0.509132,0.0354239,438,215,223,158,0,gene,Y43F4B.5,2,13299258,2.40806,257,13299001,0,13299258,0,0
III,+,13307382,0.0140845,0.0,213,210,3,3,0,gene,Y43F4B.7,1,13307387,0.709415,4742,13302640,5,13307382,0,-5
III,+,13313948,0.662162,3.44843e-21,814,275,539,366,309,gene,Y43F4B.10,2,13313951,2.23887,681,13313267,3,13313948,0,-3
III,+,13314626,1.0,0.25,2,0,2,2,6,gene,Y43F4B.9,3,13314819,0.49656,31,13314595,193,13314968,342,149
III,+,13315003,0.666667,0.0279816,30,10,20,13,21,gene,Y43F4B.9,3,13315013,0.49656,408,13314595,10,13315003,0,-10
III,+,13315005,0.980519,0.0,462,9,453,329,20,gene,Y43F4B.9,3,13315013,0.49656,410,13314595,8,13315005,0,-8
III,+,13317264,0.15,3.49099e-06,40,34,6,4,12,gene,Y43F4B.13,4,13317349,None,2669,13314595,85,13317266,2,-83
III,+,13341407,0.0102389,0.0,586,580,6,4,0,gene,F53A2.4,1,13341409,1.31033,5105,13336302,2,13341407,0,-2
III,+,13342590,0.942857,0.0,455,26,429,304,4,gene,F53A2.5,2,13342602,1.40545,103,13342487,12,13342564,-26,-38
III,+,13343704,0.88018,0.0,3547,425,3122,2458,11,gene,F53A2.6,3,13343705,4.29993,113,13343591,1,13343704,0,-1
III,+,13344817,0.138095,0.0,4200,3620,580,460,4,gene,F53A2.7,4,13344838,5.08708,323,13344494,21,13344817,0,-21
III,+,13346965,0.731818,1.28755e-12,220,59,161,131,0,gene,F53A2.8,5,13346984,0.667555,228,13346737,19,13346965,0,-19
III,+,13351273,0.0,1.46937e-39,129,129,0,0,6,gene,F53A2.8,5,13351279,0.667555,4536,13346737,6,13351273,0,-6
III,+,13386030,0.0,0.0,151,151,0,0,1,gene,T03F6.4,0,13386067,0.476077,27945,13358085,37,13386030,0,-37
III,+,13389281,0.00342857,0.0,875,872,3,3,10,gene,T03F6.3,0,13389286,1.94497,997,13388284,5,13389262,-19,-24
III,+,13393790,0.00579374,0.0,863,858,5,3,222,gene,T03F6.1,0,13393798,3.88222,3044,13390746,8,13393783,-7,-15
III,+,13406423,0.0,0.0625,4,4,0,0,0,gene,F45G2.1,0,13406429,0.157735,759,13405664,6,13406423,0,-6
III,+,13420065,0.0,0.0625,4,4,0,0,0,gene,F45G2.2,0,13420082,0.317745,10893,13409172,17,13420065,0,-17
III,+,13420530,0.0,0.03125,5,5,0,0,6,gene,F45G2.2,0,13420619,0.317745,11358,13409172,89,13420530,0,-89
III,+,13430439,0.0,0.5,1,1,0,0,0,gene,F45G2.6,0,13430481,0.03706,2870,13427569,42,13430342,-97,-139
III,+,13464709,0.642857,0.122192,14,5,9,7,210,gene,T27E9.4,2,13464727,0.623372,103,13464606,18,13464709,0,-18
III,+,13466458,0.0674847,0.0,326,304,22,18,2,gene,T27E9.4,2,13466458,0.623372,1852,13464606,0,13466458,0,0
III,+,13471753,0.00595238,0.0,168,167,1,1,33,gene,T27E9.5,0,13471765,0.337542,525,13471228,12,13471588,-165,-177
III,+,13499079,0.0144928,1.16891e-19,69,68,1,1,0,gene,T28A8.6,1,13499104,0.249759,10728,13488351,25,13499084,5,-20
III,+,13501476,0.75,0.25,4,1,3,3,10,gene,T28A8.5,2,13501509,0.262297,83,13501393,33,13501510,34,1
III,+,13501491,0.926175,0.0,298,22,276,209,14,gene,T28A8.5,2,13501509,0.262297,98,13501393,18,13501510,19,1
III,+,13503559,1.0,0.25,2,0,2,2,0,gene,T28A8.4,3,13503562,0.296833,97,13503462,3,13503570,11,8
III,+,13506047,0.939024,5.64248e-18,82,5,77,64,1,gene,T28A8.3,4,13506053,0.309005,551,13505496,6,13506047,0,-6
III,+,13527318,0.0,2.27374e-13,42,42,0,0,0,gene,Y76A2B.2,0,13527346,0.0900556,18877,13508441,28,13527318,0,-28
III,+,13576068,0.00323625,0.0,309,308,1,0,0,gene,T05D4.4,0,13576083,0.65954,3665,13572403,15,13576068,0,-15
III,+,13607902,0.0,0.000244141,12,12,0,0,0,gene,T25C8.1,0,13607951,0.0216517,24378,13583524,49,13607952,50,1
III,+,13623194,0.0101466,0.0,887,878,9,7,35,gene,T12D8.6,1,13623202,5.13159,1875,13621319,8,13623194,0,-8
III,+,13624156,0.94704,0.0,321,17,304,202,4,gene,T12D8.7,2,13624163,1.4392,83,13624073,7,13624164,8,1
III,+,13643798,0.00995025,0.0,201,199,2,2,11,gene,T12D8.1,0,13643846,0.955764,17911,13625887,48,13643798,0,-48
III,+,13673160,0.0,0.0,801,801,0,0,4,gene,ZK525.2,0,13673169,1.7023,16496,13656664,9,13673158,-2,-11
III,+,13673168,0.0,4.65661e-10,31,31,0,0,739,gene,ZK525.2,0,13673169,1.7023,16504,13656664,1,13673158,-10,-11
III,+,13679325,0.0,4.81482e-35,114,114,0,0,0,gene,ZK520.2,0,13679327,0.431485,4701,13674624,2,13679325,0,-2
III,+,13687179,0.0,0.125,3,3,0,0,399,gene,ZK520.4,0,13687329,2.173,4849,13682330,150,13687079,-100,-250
III,+,13687611,0.00997506,0.0,401,397,4,2,1,gene,ZK520.4,0,13687632,2.173,5281,13682330,21,13687611,0,-21
III,+,13701873,0.0,7.34684e-40,130,130,0,0,0,gene,W06F12.1,0,13702071,2.3606,8220,13693653,198,13701873,0,-198
III,+,13702065,0.0,0.5,1,1,0,0,29,gene,W06F12.1,0,13702071,2.3606,8412,13693653,6,13702025,-40,-46
III,+,13714452,0.0,0.0,883,883,0,0,10,gene,W06F12.1,0,13714596,2.3606,12212,13702240,144,13714452,0,-144
III,+,13715378,0.00881057,0.0,227,225,2,1,7,gene,W06F12.1,0,13715563,2.3606,13138,13702240,185,13715378,0,-185
III,+,13715630,0.0,0.0625,4,4,0,0,4,gene,W06F12.1,0,13715809,2.3606,14,13715616,179,13715630,0,-179
III,+,13717845,0.0,4.33681e-19,61,61,0,0,20,gene,W06F12.1,0,13717891,2.3606,2229,13715616,46,13717733,-112,-158
III,+,13718234,0.0,0.125,3,3,0,0,3,gene,W06F12.1,0,13718238,2.3606,2618,13715616,4,13718234,0,-4
III,+,13744102,0.0,5.87747e-39,127,127,0,0,0,gene,K08E3.1,0,13744106,0.903609,7681,13736421,4,13744102,0,-4
III,+,13771399,0.0,0.0,174,174,0,0,4,gene,K08E3.7,1,13771403,0.968675,12085,13759314,4,13771399,0,-4
III,+,13773336,0.908507,0.0,623,57,566,397,12,gene,K08E3.8,2,13773349,1.17849,115,13773221,13,13773336,0,-13
III,+,13773348,1.0,0.25,2,0,2,1,1812,gene,K08E3.8,2,13773349,1.17849,127,13773221,1,13773336,-12,-13
III,+,13780102,0.92623,2.29393e-24,122,9,113,97,5,gene,3R5.1,3,13780107,0.235752,1318,13778784,5,13780102,0,-5
IV,+,91986,0.0,2.71051e-20,65,65,0,0,0,gene,B0545.1,0,92051,0.96944,52872,39114,65,92016,30,-35
IV,+,98788,0.0625,0.000244141,16,15,1,1,0,gene,B0545.1,0,98801,0.96944,59674,39114,13,98788,0,-13
IV,+,103933,0.0103093,6.12156e-28,97,96,1,1,0,gene,B0545.1,0,103935,0.96944,64819,39114,2,103933,0,-2
IV,+,126731,0.00508767,0.0,11007,10951,56,48,2,gene,F29C4.2,0,126731,17.1343,14869,111862,0,126731,0,0
IV,+,132416,0.0,0.0,326,326,0,0,0,gene,F29C4.1,0,132423,0.618499,4782,127634,7,132416,0,-7
IV,+,162830,0.0816327,3.76367e-10,49,45,4,1,0,gene,Y38C1AA.6,0,162851,0.0864459,1199,161631,21,162631,-199,-220
IV,+,179008,0.0,0.0,244,244,0,0,4,gene,Y38C1AA.4,0,179082,0.324365,9033,169975,74,179008,0,-74
IV,+,194745,0.00847458,0.0,708,702,6,4,1,gene,Y38C1AA.2,2,194777,0.88539,1,194744,32,194745,0,-32
IV,+,203609,0.6,0.3125,5,2,3,2,13,gene,Y38C1AA.13,1,203881,None,1023,202586,272,203882,273,1
IV,+,208175,1.0,1.90735e-06,19,0,19,16,2,gene,Y38C1AA.1,2,208200,0.65157,94,208081,25,208208,33,8
IV,+,208189,0.897638,7.64128e-42,254,26,228,144,41,gene,Y38C1AA.1,2,208200,0.65157,108,208081,11,208189,0,-11
IV,+,218552,0.889202,0.0,1065,118,947,660,0,gene,Y38C1AA.11,3,218566,0.959784,1153,217399,14,218551,-1,-15
IV,+,266448,0.0,0.0,1866,1866,0,0,1,gene,T21D12.12,0,266450,1.75046,14525,251923,2,266448,0,-2
IV,+,274595,0.0,9.53674e-07,20,20,0,0,4,gene,T21D12.9,0,274617,0.454802,2496,272099,22,274602,7,-15
IV,+,274602,0.0333333,2.79397e-08,30,29,1,1,34,gene,T21D12.9,0,274617,0.454802,2503,272099,15,274602,0,-15
IV,+,283647,0.0196078,2.26485e-14,51,50,1,1,0,gene,T21D12.9,0,283714,0.454802,3708,279939,67,283647,0,-67
IV,+,307505,0.0,0.0,242,242,0,0,0,gene,K02D7.5,0,307536,0.643501,20293,287212,31,307505,0,-31
IV,+,385894,0.00645849,0.0,31896,31690,206,193,7,gene,T07A9.11,1,385908,86.7163,26606,359288,14,385894,0,-14
IV,+,386716,0.903315,0.0,362,35,327,222,2,gene,T07A9.14,2,387008,1.53775,113,386603,292,386699,-17,-309
IV,+,387956,1.0,0.000244141,12,0,12,12,0,gene,T07A9.13,3,388063,1.01314,9,387947,107,388074,118,11
IV,+,388084,0.888469,0.0,529,59,470,364,4,gene,T07A9.13,3,388091,1.01314,137,387947,7,388084,0,-7
IV,+,393380,0.5,0.5,2,1,1,0,0,gene,T07A9.9,1,393459,9.62236,222,393158,79,393880,500,421
IV,+,393880,0.0120482,8.582e-24,83,82,1,1,3,gene,T07A9.9,1,393887,9.62236,722,393158,7,393880,0,-7
IV,+,394017,0.00379726,0.0,6057,6034,23,19,9,gene,T07A9.9,1,394054,9.62236,859,393158,37,394017,0,-37
IV,+,396545,0.912114,0.0,421,37,384,288,1,gene,T07A9.8,2,396569,0.790766,108,396437,24,396545,0,-24
IV,+,401695,0.0714286,0.000854492,14,13,1,1,1,gene,T07A9.7,0,401733,0.112635,2600,399095,38,401695,0,-38
IV,+,413737,0.0,0.0625,4,4,0,0,6,gene,T07A9.12,0,413765,0.442218,8370,405367,28,414250,513,485
IV,+,413801,0.0,9.31323e-10,30,30,0,0,7,gene,T07A9.12,0,413843,0.442218,8434,405367,42,414250,449,407
IV,+,414241,0.0,2.84217e-14,45,45,0,0,7,gene,T07A9.12,0,414249,0.442218,8874,405367,8,414250,9,1
IV,+,414249,0.0,0.000244141,12,12,0,0,308,gene,T07A9.12,0,414249,0.442218,8882,405367,0,414250,1,1
IV,+,426168,0.00977199,0.0,921,912,9,9,0,gene,Y66H1A.4,0,426169,3.36883,10515,415653,1,426168,0,-1
IV,+,443997,0.00198676,0.0,1510,1507,3,3,19,gene,Y66H1A.3,1,444014,2.07869,16793,427204,17,443985,-12,-29
IV,+,445677,0.915493,0.0,426,36,390,248,3,gene,Y66H1A.2,2,445682,1.47767,896,444781,5,445677,0,-5
IV,+,532149,0.0,7.62939e-06,17,17,0,0,0,gene,W03G1.1,0,532149,0.0478922,5670,526479,0,532135,-14,-14
IV,+,548302,0.0,0.000488281,11,11,0,0,0,gene,F56A11.4,0,548321,0.0551672,12599,535703,19,548152,-150,-169
IV,+,559234,0.0,0.0,228,228,0,0,1,gene,F56A11.3,0,559237,0.393609,5934,553300,3,559238,4,1
IV,+,572769,0.00399202,0.0,501,499,2,2,177,gene,F56A11.1,0,572775,0.608296,4624,568145,6,572723,-46,-52
IV,+,627537,0.00917431,1.67941e-31,109,108,1,1,0,gene,C05G6.1,0,627549,0.152025,6609,620928,12,627537,0,-12
IV,+,649665,0.0,0.0,203,203,0,0,1,gene,K11H12.9,0,649665,0.245616,15699,633966,0,649665,0,0
IV,+,655390,0.00332779,0.0,601,599,2,2,74,gene,K11H12.8,0,655396,1.97385,3205,652185,6,655397,7,1
IV,+,665525,0.0165094,0.0,424,417,7,4,0,gene,K11H12.7,0,665624,2.00864,6922,658603,99,665525,0,-99
IV,+,677611,0.0,1.46937e-39,129,129,0,0,0,gene,K11H12.5,0,677615,0.15454,9002,668609,4,677588,-23,-27
IV,+,684497,0.0,0.0,158,158,0,0,1,gene,F41A4.1,0,684499,0.230954,5272,679225,2,684497,0,-2
IV,+,736740,0.0555556,6.86646e-05,18,17,1,1,1,gene,Y55F3C.4,0,736746,0.0740017,18975,717765,6,736747,7,1
IV,+,742129,0.0588235,0.0001297,17,16,1,0,1,gene,Y55F3C.3,0,742309,0.457516,4002,738127,180,742083,-46,-226
IV,+,760602,0.0,5.42101e-20,64,64,0,0,11,gene,F56B3.10,0,760617,0.185052,1714,758888,15,760610,8,-7
IV,+,773236,0.017341,0.0,173,170,3,2,211,gene,F56B3.8,0,773236,1.11771,629,772607,0,773237,1,1
IV,+,778802,0.0,1.65436e-24,79,79,0,0,0,gene,F56B3.7,0,778816,0.249911,2152,776650,14,778784,-18,-32
IV,+,797023,0.00584112,0.0,856,851,5,3,3,gene,F56B3.5,1,797023,0.570772,6192,790831,0,797023,0,0
IV,+,800818,1.0,0.0,181,0,181,149,60,gene,Y55F3BL.1,2,800870,0.248768,1310,799508,52,800818,0,-52
IV,+,805117,0.933333,4.56852e-16,75,5,70,46,2,gene,Y55F3BL.4,3,805132,None,371,804746,15,805133,16,1
IV,+,832314,0.0,0.00012207,13,13,0,0,1,gene,Y55F3BR.10,0,832331,0.0847224,26082,806232,17,832436,122,105
IV,+,845500,0.0,3.46945e-18,58,58,0,0,0,gene,Y55F3BR.4,0,845673,0.103865,12151,833349,173,845881,381,208
IV,+,855547,0.0,1.90735e-06,19,19,0,0,1,gene,Y55F3BR.11,0,855611,0.203113,6688,848859,64,855708,161,97
IV,+,858930,0.0,0.000488281,11,11,0,0,0,gene,Y55F3BR.2,0,858931,0.138427,1667,857263,1,858930,0,-1
IV,+,885346,0.00153139,0.0,653,652,1,0,0,gene,C44C8.6,0,885554,1.74188,3436,881910,208,885346,0,-208
IV,+,919979,0.0,0.00195312,9,9,0,0,0,gene,F58H7.5,0,919989,0.0469408,738,919241,10,919990,11,1
IV,+,924889,0.04,7.45058e-07,25,24,1,0,0,gene,F58H7.3,0,924935,0.0638467,3644,921245,46,924936,47,1
IV,+,959452,0.0134228,1.54507e-41,149,147,2,2,0,gene,Y55F3AL.1,0,959498,0.522593,19785,939667,46,959452,0,-46
IV,+,992289,0.0,0.000976562,10,10,0,0,0,gene,Y55F3AM.6,1,992291,0.511567,7899,984390,2,992289,0,-2
IV,+,999214,0.914062,7.15124e-24,128,11,117,76,1,gene,Y55F3AM.5,2,999229,0.31941,785,998429,15,999230,16,1
IV,+,1010488,0.00295567,0.0,1015,1012,3,3,3,gene,Y55F3AM.4,0,1010505,0.917924,6859,1003629,17,1010492,4,-13
IV,+,1012734,0.027027,2.6921e-10,37,36,1,1,515,gene,Y55F3AM.3,0,1012787,1.47308,234,1012500,53,1012704,-30,-83
IV,+,1014237,0.0,0.5,1,1,0,0,4,gene,Y55F3AM.3,0,1014333,1.47308,1117,1013120,96,1014235,-2,-98
IV,+,1015443,0.0,0.5,1,1,0,0,1,gene,Y55F3AM.3,0,1015474,1.47308,2323,1013120,31,1015443,0,-31
IV,+,1056892,0.004,0.0,500,498,2,2,0,gene,Y55F3AM.1,0,1056904,1.25328,7386,1049506,12,1056892,0,-12
IV,+,1094547,0.00923077,0.0,325,322,3,2,0,gene,Y55F3AR.2,1,1094549,0.811921,36931,1057616,2,1094550,3,1
IV,+,1097453,0.967871,0.0,249,8,241,146,4,gene,Y55F3AR.1,2,1097461,0.479778,770,1096683,8,1097453,0,-8
IV,+,1126562,0.0,0.5,1,1,0,0,0,gene,C44B12.1,0,1126585,18.3486,15704,1110858,23,1126791,229,206
IV,+,1170672,0.0,1.61559e-27,89,89,0,0,1,gene,C50A2.2,0,1170709,0.380657,5941,1164731,37,1170706,34,-3
IV,+,1178020,0.00114155,0.0,876,875,1,1,12,gene,Y104H12D.2,1,1178038,0.641041,248,1177772,18,1178022,2,-16
IV,+,1178022,0.0,1.12104e-44,146,146,0,0,13,gene,Y104H12D.2,1,1178038,0.641041,250,1177772,16,1178022,0,-16
IV,+,1178030,0.0136364,0.0,220,217,3,2,1563,gene,Y104H12D.2,1,1178038,0.641041,258,1177772,8,1178022,-8,-16
IV,+,1182972,0.904372,0.0,366,35,331,238,49,gene,Y104H12D.4,2,1182974,0.680622,106,1182866,2,1182592,-380,-382
IV,+,1187692,1.0,0.0078125,7,0,7,3,0,gene,Y104H12D.1,3,1187816,0.727074,1065,1186627,124,1187802,110,-14
IV,+,1187801,0.851942,0.0,412,61,351,253,1,gene,Y104H12D.1,3,1187816,0.727074,1174,1186627,15,1187802,1,-14
IV,+,1193065,0.982759,0.0,174,3,171,102,11,gene,Y104H12D.3,4,1193075,0.683587,88,1192977,10,1193076,11,1
IV,+,1193076,0.979167,5.75553e-26,96,2,94,47,534,gene,Y104H12D.3,4,1193160,0.683587,99,1192977,84,1193076,0,-84
IV,+,1216590,0.37415,0.000613054,147,92,55,52,3,gene,W09G12.9,0,1216602,0.377514,14695,1201895,12,1216627,37,25
IV,+,1251858,0.0,0.0625,4,4,0,0,0,gene,F38A1.6,0,1251860,0.00223126,2577,1249281,2,1251861,3,1
IV,+,1261157,0.0,0.25,2,2,0,0,0,gene,F38A1.14,0,1261201,0.0923377,1813,1259344,44,1261326,169,125
IV,+,1261163,0.0,0.03125,5,5,0,0,4,gene,F38A1.14,0,1261201,0.0923377,1819,1259344,38,1261326,163,125
IV,+,1266866,0.0,4.44089e-16,51,51,0,0,1,gene,F38A1.1,0,1266875,0.141996,1020,1265846,9,1266866,0,-9
IV,+,1275897,0.0016,0.0,1250,1248,2,1,6,gene,C09E9.1,0,1275933,0.853275,1543,1274354,36,1275865,-32,-68
IV,+,1289629,0.0,0.25,2,2,0,0,1,gene,Y104H12BR.1,0,1289689,1.16258,12575,1277054,60,1289297,-332,-392
IV,+,1310166,0.00305344,0.0,655,653,2,2,19,gene,F53H1.4,0,1310223,0.751694,13326,1296840,57,1310166,0,-57
IV,+,1310598,0.0,2.71051e-20,65,65,0,0,58,gene,F53H1.4,0,1310634,0.751694,13758,1296840,36,1310598,0,-36
IV,+,1329162,0.0,0.0,151,151,0,0,0,gene,F53H1.3,0,1329162,0.430849,921,1328241,0,1329162,0,0
IV,+,1347316,0.0031746,0.0,945,942,3,2,2,gene,F58F6.4,0,1347317,1.08109,2518,1344798,1,1347316,0,-1
IV,+,1386214,0.0,1.46937e-39,129,129,0,0,5,gene,Y104H12A.1,0,1386287,0.477441,33240,1352974,73,1386162,-52,-125
IV,+,1407467,0.0,0.25,2,2,0,0,1,gene,Y77E11A.14,0,1407484,0.368587,7998,1399469,17,1407467,0,-17
IV,+,1420980,0.00177778,0.0,1125,1123,2,2,27,gene,Y77E11A.4,0,1420986,0.716531,12818,1408162,6,1420973,-7,-13
IV,+,1457074,0.0,0.0,300,300,0,0,7,gene,Y77E11A.2,0,1457082,1.33006,35297,1421777,8,1457074,0,-8
IV,+,1485428,0.0,0.00195312,9,9,0,0,0,gene,Y77E11A.16,0,1485479,0.0410495,25908,1459520,51,1485480,52,1
IV,+,1497631,0.0,1.11022e-16,53,53,0,0,0,gene,Y77E11A.1,0,1498070,1.53779,7827,1489804,439,1497629,-2,-441
IV,+,1499861,0.0,0.0,989,989,0,0,0,gene,Y77E11A.1,0,1499874,1.53779,10057,1489804,13,1499861,0,-13
IV,+,1510545,0.00257069,0.0,389,388,1,1,10,gene,K03H6.2,0,1510562,0.73385,580,1509965,17,1510563,18,1
IV,+,1559958,0.4,0.3125,5,3,2,1,0,gene,Y41D4B.17,0,1559974,0.120952,329,1559629,16,1560228,270,254
IV,+,1564308,1.0,0.5,1,0,1,1,0,gene,Y41D4B.15,0,1564377,0.017982,96,1564212,69,1564079,-229,-298
IV,+,1597316,0.0071599,0.0,419,416,3,2,0,gene,Y41D4B.13,1,1597317,1.02729,18425,1578891,1,1597314,-2,-3
IV,+,1602983,0.844156,2.43186e-10,77,12,65,50,1,gene,Y41D4B.12,2,1602985,0.301563,1365,1601618,2,1602983,0,-2
IV,+,1605710,0.898438,0.0,384,39,345,239,1,gene,Y41D4B.11,3,1605785,0.94984,109,1605601,75,1605710,0,-75
IV,+,1624063,0.0,9.53674e-07,20,20,0,0,8,gene,Y41D4B.7,0,1624072,0.166266,331,1623732,9,1624046,-17,-26
IV,+,1659689,0.00394539,0.0,168551,167886,665,617,2,gene,Y41D4B.5,1,1659701,460.115,22278,1637411,12,1659689,0,-12
IV,+,1660110,0.899582,6.66577e-40,239,24,215,172,0,gene,Y41D4B.4,2,1660112,0.404572,92,1660018,2,1660110,0,-2
IV,+,1672702,0.0,0.000488281,11,11,0,0,3,gene,Y41D4B.1,0,1672703,0.0290478,2468,1670234,1,1672704,2,1
IV,+,1699326,0.0,2.38419e-07,22,22,0,0,1,gene,K08D12.5,0,1699445,0.0409708,23046,1676280,119,1699897,571,452
IV,+,1707294,0.0,1.05879e-22,73,73,0,0,0,gene,K08D12.4,0,1707294,0.330712,4476,1702818,0,1707295,1,1
IV,+,1710263,0.00399177,0.0,8267,8234,33,26,3,gene,K08D12.3,0,1710264,17.9934,1574,1708689,1,1710263,0,-1
IV,+,1745999,0.00176991,0.0,2260,2256,4,4,44,gene,Y41D4A.4,0,1746000,2.39939,17788,1728211,1,1745999,0,-1
IV,+,1834626,0.0,7.45058e-09,27,27,0,0,0,gene,K07A9.3,0,1834628,0.00342711,580,1834046,2,1834624,-2,-4
IV,+,1839771,0.0,3.63798e-12,38,38,0,0,1,gene,K07A9.4,0,1840009,0.180224,5725,1834046,238,1839782,11,-227
IV,+,1846706,0.0,0.000488281,11,11,0,0,0,gene,K07A9.4,0,1846781,0.180224,12660,1834046,75,1846706,0,-75
IV,+,1847966,0.00148038,0.0,1351,1349,2,2,0,gene,F55A8.2,0,1848068,3.34926,754,1847212,102,1847966,0,-102
IV,+,1858522,0.0,0.0,173,173,0,0,5,gene,F55A8.2,0,1858554,3.34926,11310,1847212,32,1858522,0,-32
IV,+,1870995,0.0,0.0,161,161,0,0,1,gene,F55A8.2,0,1871009,3.34926,23783,1847212,14,1871010,15,1
IV,+,1902321,0.0,2.1684e-19,62,62,0,0,1,gene,F55A8.1,1,1902440,1.89127,21735,1880586,119,1902322,1,-118
IV,+,1913453,0.00144092,0.0,1388,1386,2,1,1,gene,F55A8.1,1,1913470,1.89127,2184,1911269,17,1913453,0,-17
IV,+,1917853,0.0,1.49012e-08,26,26,0,0,2,gene,F52C12.5,2,1917975,0.385905,16,1917837,122,1917853,0,-122
IV,+,1917976,0.057554,4.0395e-30,139,131,8,4,10,gene,F52C12.5,2,1917996,0.385905,139,1917837,20,1917976,0,-20
IV,+,1923988,0.0,0.00012207,13,13,0,0,3,gene,F52C12.4,1,1924006,0.337736,2345,1921643,18,1923570,-418,-436
IV,+,1948190,0.876712,1.0279e-11,73,9,64,49,0,gene,F52C12.3,2,1948196,0.121697,115,1948075,6,1948197,7,1
IV,+,1953578,0.336245,2.05379e-07,229,152,77,58,0,gene,F52C12.2,3,1953594,0.55253,257,1953321,16,1953578,0,-16
IV,+,1956710,0.0175439,3.10123e-31,114,112,2,1,7,gene,F52C12.6,4,1956723,None,1,1956709,13,1956724,14,1
IV,+,1959853,0.872549,2.05106e-29,204,26,178,133,1,gene,F52C12.1,5,1959855,0.416602,107,1959746,2,1959853,0,-2
IV,+,1963635,0.841629,1.89028e-26,221,35,186,112,0,gene,Y48A5A.2,6,1963662,0.644377,396,1963239,27,1963637,2,-25
IV,+,1965480,0.850746,1.4788e-17,134,20,114,85,1,gene,Y48A5A.1,7,1965570,0.433755,757,1964723,90,1965480,0,-90
IV,+,1969738,0.797386,4.14421e-27,306,62,244,173,2,gene,Y48A5A.3,8,1969781,0.902304,104,1969634,43,1969738,0,-43
IV,+,1973703,0.00472255,0.0,847,843,4,3,4,gene,Y76B12C.3,0,1973706,2.34883,3422,1970281,3,1973705,2,-1
IV,+,1979987,0.0015186,0.0,1317,1315,2,2,0,gene,Y76B12C.8,0,1980093,1.73817,4315,1975672,106,1979987,0,-106
IV,+,1981407,0.0075,0.0,400,397,3,3,0,gene,Y76B12C.6,1,1981411,0.547087,1055,1980352,4,1981405,-2,-6
IV,+,1993088,0.848485,3.50325e-44,363,55,308,251,0,gene,Y76B12C.2,2,1993089,0.402787,60,1993028,1,1993090,2,1
IV,+,2051494,0.0,1.20371e-35,116,116,0,0,1,gene,R05C11.4,0,2051498,0.46322,8239,2043255,4,2051499,5,1
IV,+,2084033,0.0041841,0.0,239,238,1,1,0,gene,R05C11.3,0,2084049,1.17273,12172,2071861,16,2084033,0,-16
IV,+,2114659,0.0,0.125,3,3,0,0,38,gene,C23H5.3,0,2114671,0.102018,22738,2091921,12,2114625,-34,-46
IV,+,2122795,0.0,6.93889e-18,57,57,0,0,2,gene,C23H5.2,0,2122795,0.088413,6978,2115817,0,2122796,1,1
IV,+,2136950,0.0,7.45058e-09,27,27,0,0,234,gene,C54E4.2,0,2136960,4.54536,2243,2134707,10,2136956,6,-4
IV,+,2136956,0.00716479,0.0,977,970,7,6,192,gene,C54E4.2,0,2136960,4.54536,2249,2134707,4,2136956,0,-4
IV,+,2175589,0.0,0.25,2,2,0,0,0,gene,C54E4.1,0,2175604,0.0370452,29130,2146459,15,2175605,16,1
IV,+,2177901,0.00266667,0.0,375,374,1,0,1,gene,Y71G10AL.1,1,2177928,1.32839,322,2177579,27,2177906,5,-22
IV,+,2199040,0.682975,2.33313e-17,511,162,349,206,1,gene,Y71G10AR.4,2,2199077,1.21699,106,2198934,37,2198996,-44,-81
IV,+,2222829,0.00662252,5.32493e-44,151,150,1,0,0,gene,T04C4.1,0,2222963,0.983125,13178,2209651,134,2222829,0,-134
IV,+,2223716,0.00101112,0.0,989,988,1,1,0,gene,T04C4.1,0,2223846,0.983125,14065,2209651,130,2223716,0,-130
IV,+,2324057,0.0,0.0,233,233,0,0,0,gene,Y38F2AL.1,0,2324062,1.96636,5417,2318640,5,2324057,0,-5
IV,+,2349270,0.00626305,0.0,479,476,3,2,0,gene,Y38F2AR.6,0,2349387,0.234541,22532,2326738,117,2349270,0,-117
IV,+,2384011,0.872937,0.0,606,77,529,321,1,gene,Y38F2AR.3,2,2384018,0.913301,975,2383036,7,2384009,-2,-9
IV,+,2389429,0.0,0.00195312,9,9,0,0,2,gene,Y38F2AR.2,3,2389456,11.932,1376,2388053,27,2389441,12,-15
IV,+,2389443,0.00645399,0.0,5423,5388,35,27,11,gene,Y38F2AR.2,3,2389456,11.932,1390,2388053,13,2389443,0,-13
IV,+,2390819,0.79562,6.53601e-13,137,28,109,84,1,gene,Y38F2AR.1,4,2390960,0.241978,520,2390299,141,2390819,0,-141
IV,+,2432991,0.0,0.0,171,171,0,0,2,gene,C45G7.4,0,2432997,0.188147,36730,2396261,6,2432991,0,-6
IV,+,2476683,0.0,1.86265e-09,29,29,0,0,1,gene,Y69A2AL.1,0,2476697,0.0422733,5236,2471447,14,2476698,15,1
IV,+,2482238,0.0,5.68434e-14,44,44,0,0,2,gene,Y69A2AL.2,0,2482254,1.97372,2012,2480226,16,2482255,17,1
IV,+,2482253,0.00651891,0.0,767,762,5,5,116,gene,Y69A2AL.2,0,2482254,1.97372,2027,2480226,1,2482255,2,1
IV,+,2495740,0.00340522,0.0,5286,5268,18,17,96,gene,Y69A2AR.18,1,2495746,20.3521,1598,2494142,6,2495740,0,-6
IV,+,2497801,0.862559,1.15951e-28,211,29,182,142,1,gene,Y69A2AR.17,2,2497814,0.435031,133,2497668,13,2497815,14,1
IV,+,2504310,0.0,0.0625,4,4,0,0,0,gene,Y69A2AR.16,0,2504336,0.735866,6642,2497668,26,2504325,15,-11
IV,+,2542304,0.0,0.00012207,13,13,0,0,0,gene,Y69A2AR.15,0,2542314,0.0300971,12010,2530294,10,2542323,19,9
IV,+,2601138,0.015444,0.0,259,255,4,2,0,gene,Y69A2AR.7,1,2601141,1.37506,3186,2597952,3,2601138,0,-3
IV,+,2603211,0.0,7.45058e-09,27,27,0,0,1,gene,Y69A2AR.7,1,2603223,1.37506,5259,2597952,12,2603211,0,-12
IV,+,2604828,0.0,0.5,1,1,0,0,2,gene,Y69A2AR.7,1,2604854,1.37506,906,2603922,26,2604828,0,-26
IV,+,2608048,0.270796,6.41008e-29,565,412,153,78,1,gene,Y69A2AR.6,2,2608057,0.694212,586,2607462,9,2608058,10,1
IV,+,2610405,0.333333,0.375,3,2,1,1,0,gene,Y69A2AR.32,0,2610432,0.42957,200,2610205,27,2610419,14,-13
IV,+,2611233,0.0,9.86076e-32,103,103,0,0,11,gene,Y69A2AR.32,0,2611342,0.42957,1028,2610205,109,2611233,0,-109
IV,+,2614197,0.0,6.61744e-24,77,77,0,0,0,gene,Y69A2AR.5,0,2614198,0.197833,1769,2612428,1,2614197,0,-1
IV,+,2641307,0.00738689,0.0,4332,4300,32,27,2,gene,Y69A2AR.3,1,2641308,11.9528,15805,2625502,1,2641307,0,-1
IV,+,2642976,0.731579,4.13584e-11,190,51,139,89,1,gene,Y69A2AR.2,2,2642983,0.558638,867,2642109,7,2642976,0,-7
IV,+,2667047,0.0096463,0.0,311,308,3,3,2,gene,Y69A2AR.1,0,2667061,1.28156,17027,2650020,14,2667047,0,-14
IV,+,2743000,0.0,3.05176e-05,15,15,0,0,0,gene,Y94H6A.1,0,2743003,0.0329717,10599,2732401,3,2743004,4,1
IV,+,2751865,0.00623053,0.0,321,319,2,0,7,gene,Y54G2A.41,0,2751878,0.353719,4392,2747473,13,2751865,0,-13
IV,+,2788689,0.00541638,0.0,1477,1469,8,6,0,gene,Y54G2A.2,0,2788697,1.86639,8026,2780663,8,2788689,0,-8
IV,+,2801870,0.0,0.125,3,3,0,0,0,gene,Y54G2A.44,0,2801898,0.0310107,887,2800983,28,2802028,158,130
IV,+,2804005,0.00246305,0.0,406,405,1,1,26,gene,Y54G2A.32,0,2804101,0.845802,744,2803261,96,2804005,0,-96
IV,+,2809578,0.0,0.5,1,1,0,0,0,gene,Y54G2A.37,1,2809635,0.230152,551,2809027,57,2809578,0,-57
IV,+,2842471,0.000656599,0.0,1523,1522,1,1,25,gene,Y54G2A.33,0,2842471,1.51292,3047,2839424,0,2842471,0,0
IV,+,2887337,0.0,0.25,2,2,0,0,3,gene,Y54G2A.5,0,2887414,2.50486,31884,2855453,77,2887049,-288,-365
IV,+,2897693,0.0042735,0.0,234,233,1,1,1,gene,Y54G2A.36,0,2897696,0.328986,6150,2891543,3,2897772,79,76
IV,+,2918438,0.0921053,2.8934e-14,76,69,7,7,1,gene,Y54G2A.50,0,2918447,0.451299,16793,2901645,9,2918730,292,283
IV,+,2931425,0.0149254,4.5401e-19,67,66,1,1,100,gene,Y54G2A.4,0,2931476,0.733483,11653,2919772,51,2931406,-19,-70
IV,+,2960099,0.0,7.45058e-09,27,27,0,0,0,gene,Y54G2A.35,0,2960119,0.0794271,23272,2936827,20,2960120,21,1
IV,+,3012586,0.0,0.000244141,12,12,0,0,0,gene,Y54G2A.3,0,3012664,2.2432,39123,2973463,78,3012651,65,-13
IV,+,3019735,0.0,1.86265e-09,29,29,0,0,0,gene,Y54G2A.1,0,3019736,0.0841748,5298,3014437,1,3019737,2,1
IV,+,3053310,0.2,0.15625,5,4,1,1,0,gene,Y67D8C.4,1,3053361,0.00944547,30924,3022386,51,3053727,417,366
IV,+,3055711,0.00657895,2.66247e-44,152,151,1,1,1,gene,Y67D8C.3,2,3055753,0.270077,292,3055419,42,3055711,0,-42
IV,+,3056159,0.015625,3.46945e-18,64,63,1,1,54,gene,Y67D8C.3,2,3056164,0.270077,740,3055419,5,3056159,0,-5
IV,+,3213762,0.0,1.05879e-22,73,73,0,0,0,gene,M4.1,0,3213767,0.626416,9905,3203857,5,3213768,6,1
IV,+,3222438,0.717391,1.04289e-07,138,39,99,60,0,gene,Y67D8A.2,1,3222439,0.600599,2148,3220290,1,3222438,0,-1
IV,+,3258906,0.322543,1.90077e-26,865,586,279,204,13,gene,T26C12.1,0,3258916,1.82359,6312,3252594,10,3258906,0,-10
IV,+,3292165,0.0,0.5,1,1,0,0,0,gene,W08E12.8,0,3292224,0.236401,28688,3263477,59,3292116,-49,-108
IV,+,3292445,0.0,2.84217e-14,45,45,0,0,8,gene,W08E12.8,0,3292471,0.236401,28968,3263477,26,3292445,0,-26
IV,+,3295131,0.00920245,0.0,1630,1615,15,12,0,gene,W08E12.7,0,3295140,9.96537,498,3294633,9,3295131,0,-9
IV,+,3295135,0.0,3.05176e-05,15,15,0,0,217,gene,W08E12.7,0,3295140,9.96537,502,3294633,5,3295135,0,-5
IV,+,3298411,0.0,0.5,1,1,0,0,0,gene,W08E12.6,0,3298427,0.187912,1390,3297021,16,3298625,214,198
IV,+,3298635,1.0,0.125,3,0,3,3,50,gene,W08E12.6,0,3298698,0.187912,1614,3297021,63,3298625,-10,-73
IV,+,3311547,0.0,0.00390625,8,8,0,0,237,gene,W08E12.1,0,3311563,0.4783,4914,3306633,16,3311272,-275,-291
IV,+,3369193,0.00810446,0.0,2221,2203,18,15,0,gene,Y55H10A.1,0,3369193,5.78906,3118,3366075,0,3369193,0,0
IV,+,3385907,0.00587816,0.0,5614,5581,33,29,7,gene,B0546.1,0,3385907,13.8084,11104,3374803,0,3385907,0,0
IV,+,3399669,0.0169014,0.0,710,698,12,11,0,gene,C04C3.3,0,3399684,3.98661,3120,3396549,15,3399669,0,-15
IV,+,3415680,0.0,7.62939e-06,17,17,0,0,0,gene,C04C3.2,0,3415685,0.0302057,11779,3403901,5,3415680,0,-5
IV,+,3438354,0.00415225,0.0,1445,1439,6,6,103,gene,W05E7.3,0,3438358,2.84048,479,3437875,4,3438309,-45,-49
IV,+,3441156,0.0,6.10352e-05,14,14,0,0,72,gene,F09D12.1,0,3441174,4.67517,707,3440449,18,3441088,-68,-86
IV,+,3467427,0.047619,1.00136e-05,21,20,1,1,1,gene,F58E2.3,2,3467432,0.0426619,1123,3466304,5,3467427,0,-5
IV,+,3470124,1.0,0.5,1,0,1,0,0,gene,F58E2.2,0,3470195,0.00394716,300,3469824,71,3470039,-85,-156
IV,+,3516818,0.0,0.0,426,426,0,0,0,gene,Y37E11C.1,1,3516882,0.543296,10988,3505830,64,3516818,0,-64
IV,+,3527350,0.428044,0.000123964,542,310,232,180,3,gene,M57.2,2,3527354,0.845523,755,3526595,4,3527350,0,-4
IV,+,3533637,0.357143,0.122192,14,9,5,5,3,gene,M57.1,0,3533647,0.165771,1168,3532469,10,3533637,0,-10
IV,+,3540173,0.0,6.93889e-18,57,57,0,0,6,gene,B0212.3,0,3540183,0.107233,1115,3539058,10,3540184,11,1
IV,+,3565197,0.0833333,0.00292969,12,11,1,1,1,gene,B0212.2,0,3565206,0.0128216,21598,3543599,9,3565197,0,-9
IV,+,3570715,0.0,0.03125,5,5,0,0,0,gene,B0212.6,0,3570939,0.0167461,1504,3569211,224,3570715,0,-224
IV,+,3579618,0.918367,3.76367e-10,49,4,45,24,1,gene,Y37E11B.1,2,3579627,0.323659,89,3579529,9,3579618,0,-9
IV,+,3606781,0.0,1.81899e-12,39,39,0,0,1,gene,ZC416.4,0,3606790,0.0836142,25795,3580986,9,3606791,10,1
IV,+,3633614,0.00323102,0.0,619,617,2,0,1,gene,ZC416.2,0,3633616,0.701976,24392,3609222,2,3633617,3,1
IV,+,3637074,0.0033557,0.0,298,297,1,0,5,gene,ZC416.1,0,3637074,0.446167,1606,3635468,0,3637075,1,1
IV,+,3694932,0.00324939,0.0,1231,1227,4,3,553,gene,Y37E11AL.3,0,3694937,1.47991,30493,3664439,5,3694932,0,-5
IV,+,3709501,0.1,0.00976562,10,9,1,0,12,gene,Y37E11AL.1,0,3709503,0.0403862,9784,3699717,2,3709510,9,7
IV,+,3726122,0.0,2.1684e-19,62,62,0,0,8,gene,Y37E11AM.1,0,3726158,0.400744,10609,3715513,36,3726415,293,257
IV,+,3744043,0.00334728,0.0,2390,2382,8,6,2,gene,Y37E11AR.2,0,3744131,2.70616,8553,3735490,88,3744051,8,-80
IV,+,3756222,0.0,0.000488281,11,11,0,0,3,gene,Y37E11AR.1,0,3756236,0.101835,8509,3747713,14,3755775,-447,-461
IV,+,3791583,0.0232558,4.88853e-12,43,42,1,1,0,gene,W07G9.2,0,3791665,0.350435,31650,3759933,82,3791583,0,-82
IV,+,3803576,0.0,0.0,175,175,0,0,30,gene,M02B7.2,1,3803583,0.123585,7268,3796308,7,3803584,8,1
IV,+,3805514,0.233677,7.11902e-21,291,223,68,50,2,gene,M02B7.1,2,3805546,0.318331,570,3804944,32,3805547,33,1
IV,+,3855839,0.00227273,0.0,440,439,1,1,2,gene,F28F9.1,0,3855843,0.642793,14151,3841688,4,3855843,4,0
IV,+,3868139,1.0,0.25,2,0,2,0,3,gene,F37C4.4,0,3868215,0.553468,6576,3861563,76,3868139,0,-76
IV,+,3869545,0.0,0.0,169,169,0,0,1,gene,F37C4.4,0,3869556,0.553468,7982,3861563,11,3869545,0,-11
IV,+,3885659,0.0,0.0625,4,4,0,0,0,gene,F37C4.2,0,3885662,0.00615168,982,3884677,3,3885659,0,-3
IV,+,3900325,0.8,0.15625,5,1,4,3,0,gene,F56D6.7,0,3900365,0.000498211,401,3899924,40,3900565,240,200
IV,+,3929644,0.0,0.125,3,3,0,0,0,gene,F56D6.15,0,3929710,0.00851753,659,3928985,66,3929644,0,-66
IV,+,3932695,0.0,0.125,3,3,0,0,0,gene,Y46C8AL.3,0,3932726,0.0383934,1052,3931643,31,3932727,32,1
IV,+,3932727,0.0,2.32831e-10,32,32,0,0,3,gene,Y46C8AL.3,0,3932796,0.0383934,1084,3931643,69,3932727,0,-69
IV,+,3937458,0.0,6.93889e-18,57,57,0,0,1,gene,Y46C8AL.4,0,3937503,0.0705339,1160,3936298,45,3937458,0,-45
IV,+,3944810,0.0136986,7.72918e-21,73,72,1,1,38,gene,Y46C8AL.5,0,3944876,0.445742,1072,3943738,66,3944810,0,-66
IV,+,3960728,0.0,3.05176e-05,15,15,0,0,9,gene,Y46C8AL.9,0,3960773,0.08131,577,3960151,45,3960728,0,-45
IV,+,3965326,0.0,1.90735e-06,19,19,0,0,17,gene,Y46C8AR.1,0,3965395,0.107079,661,3964665,69,3965326,0,-69
IV,+,3989103,0.0,7.10543e-15,47,47,0,0,0,gene,F47C12.2,0,3989125,0.349913,7904,3981199,22,3989096,-7,-29
IV,+,4042568,0.00416667,0.0,240,239,1,1,7,gene,F35F11.1,0,4042571,0.829691,1037,4041531,3,4042568,0,-3
IV,+,4086205,0.00613497,0.0,163,162,1,1,0,gene,C35B1.2,1,4086217,0.487847,4903,4081302,12,4086205,0,-12
IV,+,4103013,0.88521,0.0,453,52,401,201,0,gene,C35B1.1,2,4103028,1.09391,113,4102900,15,4103013,0,-15
IV,+,4109060,0.0,0.0,196,196,0,0,0,gene,C35B1.7,0,4109090,0.332899,2807,4106253,30,4109058,-2,-32
IV,+,4109140,0.0,0.5,1,1,0,0,37,gene,C35B1.7,0,4109154,0.332899,2887,4106253,14,4109058,-82,-96
IV,+,4117760,0.0,0.0625,4,4,0,0,2,gene,F49F1.1,0,4117795,0.673257,7296,4110464,35,4117781,21,-14
IV,+,4148315,0.1,0.00976562,10,9,1,1,53,gene,R07C12.2,0,4148324,0.719286,1254,4147061,9,4148128,-187,-196
IV,+,4150632,0.0,0.125,3,3,0,0,0,gene,R07C12.4,0,4150641,0.0292253,564,4150068,9,4150746,114,105
IV,+,4172095,0.00588235,0.0,1190,1183,7,5,2,gene,K08D10.4,1,4172100,1.25946,4334,4167761,5,4172095,0,-5
IV,+,4174082,0.94213,0.0,864,50,814,593,6,gene,K08D10.3,2,4174087,1.35635,100,4173982,5,4174080,-2,-7
IV,+,4176381,0.864035,0.0,456,62,394,265,4,gene,K08D10.2,3,4176468,0.568592,109,4176272,87,4176796,415,328
IV,+,4177041,0.944444,6.86646e-05,18,1,17,12,2,gene,K08D10.2,3,4177043,0.568592,769,4176272,2,4176796,-245,-247
IV,+,4178456,0.962963,3.91042e-39,162,6,156,123,4,gene,K08D10.12,4,4178462,0.344175,102,4178354,6,4178456,0,-6
IV,+,4207250,0.0,0.25,2,2,0,0,0,gene,F30B5.4,0,4207348,0.914134,8892,4198358,98,4207250,0,-98
IV,+,4213570,0.00105932,0.0,944,943,1,1,1,gene,F30B5.4,0,4213654,0.914134,15212,4198358,84,4213570,0,-84
IV,+,4248063,0.0162866,0.0,307,302,5,5,0,gene,F36A4.7,0,4248180,2.0868,584,4247479,117,4248063,0,-117
IV,+,4265782,0.0,0.015625,6,6,0,0,5,gene,F36A4.5,0,4265798,0.0301265,571,4265211,16,4266278,496,480
IV,+,4265989,0.0,0.0625,4,4,0,0,2,gene,F36A4.5,0,4266067,0.0301265,778,4265211,78,4266278,289,211
IV,+,4266318,0.0,0.00390625,8,8,0,0,0,gene,F36A4.5,0,4266333,0.0301265,1107,4265211,15,4266278,-40,-55
IV,+,4301301,0.0,0.0,647,647,0,0,0,gene,F15E6.2,0,4301301,1.59562,5619,4295682,0,4301301,0,0
IV,+,4357626,0.00714286,1.00445e-40,140,139,1,0,0,gene,W03B1.4,0,4357633,0.82338,5770,4351856,7,4357629,3,-4
IV,+,4360830,0.0,9.53674e-07,20,20,0,0,0,gene,F55F10.1,1,4360842,0.487126,185,4360645,12,4360828,-2,-14
IV,+,4386644,0.665081,0.0,2732,915,1817,1247,260,gene,Y24D9A.8,2,4386650,3.00531,116,4386528,6,4386644,0,-6
IV,+,4387426,0.0,0.5,1,1,0,0,0,gene,Y24D9A.8,2,4387449,3.00531,898,4386528,23,4387426,0,-23
IV,+,4390835,0.0,0.000244141,12,12,0,0,0,gene,Y24D9A.2,0,4390860,0.182982,1968,4388867,25,4390846,11,-14
IV,+,4390843,0.0,0.03125,5,5,0,0,9,gene,Y24D9A.2,0,4390860,0.182982,1976,4388867,17,4390846,3,-14
IV,+,4408599,0.0238837,0.0,963,940,23,21,2,gene,Y24D9A.1,0,4408827,2.11716,15151,4393448,228,4408599,0,-228
IV,+,4446209,0.00784226,0.0,4463,4428,35,30,1,gene,R08C7.3,1,4446228,17.4845,8883,4437326,19,4446209,0,-19
IV,+,4447315,0.428571,0.273438,7,4,3,2,17,gene,R08C7.2,2,4447324,2.6823,326,4446989,9,4447324,9,0
IV,+,4447324,0.146288,0.0,916,782,134,114,17,gene,R08C7.2,2,4447324,2.6823,335,4446989,0,4447324,0,0
IV,+,4447712,0.0,5.42101e-20,64,64,0,0,1,gene,R08C7.2,2,4447742,2.6823,723,4446989,30,4447712,0,-30
IV,+,4448321,0.0,1.52588e-05,16,16,0,0,2,gene,R08C7.2,2,4448364,2.6823,1332,4446989,43,4448321,0,-43
IV,+,4457652,0.00680272,8.23963e-43,147,146,1,0,0,gene,R08C7.12,0,4457658,0.798716,5640,4452012,6,4457659,7,1
IV,+,4465477,0.0,0.00195312,9,9,0,0,3,gene,M01H9.5,0,4465482,0.067004,5352,4460125,5,4465249,-228,-233
IV,+,4487046,0.0,0.0,212,212,0,0,15,gene,M01H9.1,0,4487051,0.982417,18544,4468502,5,4487052,6,1
IV,+,4536546,0.2,0.15625,5,4,1,0,0,gene,ZK185.2,0,4536552,0.125468,41029,4495517,6,4536546,0,-6
IV,+,4548546,0.00961538,5.1276e-30,104,103,1,1,0,gene,ZK185.1,0,4548547,0.176514,6787,4541759,1,4548546,0,-1
IV,+,4572236,0.0,2.98023e-08,25,25,0,0,0,gene,F28E10.1,0,4572239,0.396957,6351,4565885,3,4572236,0,-3
IV,+,4577911,0.0,0.5,1,1,0,0,1,gene,F28E10.1,0,4577977,0.396957,12026,4565885,66,4577911,0,-66
IV,+,4578373,0.0,0.5,1,1,0,0,0,gene,F28E10.1,0,4578444,0.396957,12488,4565885,71,4578373,0,-71
IV,+,4580084,0.0,9.53674e-07,20,20,0,0,0,gene,F28E10.1,0,4580137,0.396957,14199,4565885,53,4580084,0,-53
IV,+,4594056,0.0,8.88178e-16,50,50,0,0,3,gene,F28E10.5,0,4594103,0.0283891,1337,4592719,47,4594048,-8,-55
IV,+,4599945,0.0,0.0,518,518,0,0,0,gene,F19C7.2,0,4599945,0.338293,952,4598993,0,4599945,0,0
IV,+,4603097,0.0,0.00012207,13,13,0,0,0,gene,F19C7.4,0,4603097,0.0536408,328,4602769,0,4603098,1,1
IV,+,4647676,0.00188324,0.0,1593,1590,3,3,1,gene,F29B9.8,0,4647676,1.79623,10792,4636884,0,4647676,0,0
IV,+,4647684,0.0,0.125,3,3,0,0,2176,gene,F29B9.8,0,4647709,1.79623,10800,4636884,25,4647676,-8,-33
IV,+,4651035,0.00862813,0.0,3477,3447,30,26,55,gene,F29B9.6,1,4651049,6.80545,390,4650645,14,4651035,0,-14
IV,+,4652439,0.0,1.49012e-08,26,26,0,0,35,gene,F29B9.5,2,4652449,0.18366,3,4652436,10,4652366,-73,-83
IV,+,4653376,0.945687,0.0,313,17,296,216,0,gene,F29B9.4,3,4653384,1.02869,222,4653154,8,4653376,0,-8
IV,+,4660984,0.00648298,0.0,617,613,4,4,0,gene,F29B9.2,1,4660999,1.08425,5145,4655839,15,4660984,0,-15
IV,+,4665370,0.938095,1.03696e-43,210,13,197,149,0,gene,F29B9.1,2,4665414,0.428899,175,4665195,44,4665242,-128,-172
IV,+,4669533,0.016129,1.34441e-17,62,61,1,1,1,gene,F29B9.12,0,4669533,0.122583,1722,4667811,0,4669534,1,1
IV,+,4679009,0.012987,5.09543e-22,77,76,1,1,0,gene,T22B11.4,0,4679033,0.659493,6928,4672081,24,4679009,0,-24
IV,+,4688260,0.00854701,7.04168e-34,117,116,1,1,0,gene,T22B11.2,0,4688312,0.350994,2945,4685315,52,4688543,283,231
IV,+,4688591,0.0,0.5,1,1,0,0,2,gene,T22B11.2,0,4688614,0.350994,3276,4685315,23,4688543,-48,-71
IV,+,4716145,0.0,0.5,1,1,0,0,1,gene,K08F11.2,0,4716371,0,19328,4696817,226,4716173,28,-198
IV,+,4724545,0.0,0.25,2,2,0,0,0,gene,K08F11.1,0,4724711,0.107213,4026,4720519,166,4724853,308,142
IV,+,4724839,0.0,0.03125,5,5,0,0,9,gene,K08F11.1,0,4724852,0.107213,4320,4720519,13,4724853,14,1
IV,+,4750231,0.00290698,0.0,1032,1029,3,3,0,gene,Y17G9B.5,0,4750236,0.855935,11437,4738794,5,4750231,0,-5
IV,+,4761040,0.0,0.25,2,2,0,0,2,gene,Y17G9B.3,0,4761050,0.279339,3803,4757237,10,4761051,11,1
IV,+,4764319,0.030303,3.84171e-09,33,32,1,1,15,gene,Y17G9B.2,1,4764354,1.7547,1473,4762846,35,4764192,-127,-162
IV,+,4764715,0.909091,0.00537109,11,1,10,6,0,gene,Y17G9B.1,2,4764738,0.0416692,105,4764610,23,4764739,24,1
IV,+,4789777,0.0,0.5,1,1,0,0,30,gene,R11E3.1,0,4789824,0.152639,14597,4775180,47,4789726,-51,-98
IV,+,4810924,0.0125687,0.0,1273,1257,16,14,0,gene,H06H21.3,0,4810925,6.77992,18950,4791974,1,4810924,0,-1
IV,+,4814370,0.0,0.0625,4,4,0,0,0,gene,H06H21.1,0,4814414,0.00237747,351,4814019,44,4814475,105,61
IV,+,4884273,0.0,0.0078125,7,7,0,0,0,gene,T08B6.6,0,4884285,0.00584042,4103,4880170,12,4884286,13,1
IV,+,4889905,0.0,0.0,167,167,0,0,2,gene,T08B6.5,0,4889918,0.223551,2882,4887023,13,4889908,3,-10
IV,+,4906033,0.0,0.25,2,2,0,0,1,gene,T08B6.4,0,4906053,0.410509,11958,4894075,20,4906033,0,-20
IV,+,5002742,0.0,1.00974e-28,93,93,0,0,0,gene,T28H11.4,0,5002763,0.0936569,5200,4997542,21,5002742,0,-21
IV,+,5012537,0.0,0.03125,5,5,0,0,2,gene,T28H11.2,0,5012538,0.0346137,1758,5010779,1,5012539,2,1
IV,+,5037785,0.0,0.0625,4,4,0,0,0,gene,C09B9.1,0,5037804,0.0408183,6749,5031036,19,5037805,20,1
IV,+,5083293,0.00496278,0.0,403,401,2,1,1,gene,C02B10.5,0,5083308,1.44926,11055,5072238,15,5083293,0,-15
IV,+,5083533,0.0,1.90735e-06,19,19,0,0,2,gene,C02B10.5,0,5083536,1.44926,11295,5072238,3,5083533,0,-3
IV,+,5091576,0.00190658,0.0,3147,3141,6,5,0,gene,C02B10.4,0,5091588,3.10016,4662,5086914,12,5091576,0,-12
IV,+,5160512,0.00419287,0.0,954,950,4,3,0,gene,C24D10.4,0,5160512,1.06044,9309,5151203,0,5160513,1,1
IV,+,5173272,0.004329,0.0,462,460,2,2,1,gene,W03F8.5,0,5173321,1.60332,4847,5168425,49,5173322,50,1
IV,+,5184113,0.0686164,0.0,889,828,61,36,1,gene,W03F8.4,2,5184131,2.57071,382,5183731,18,5184113,0,-18
IV,+,5185316,0.9,0.00976562,10,1,9,8,3,gene,W03F8.3,3,5185541,0.412038,86,5185230,225,5185323,7,-218
IV,+,5185323,0.965517,0.0,261,9,252,184,8,gene,W03F8.3,3,5185541,0.412038,93,5185230,218,5185323,0,-218
IV,+,5204581,0.0016835,0.0,594,593,1,1,4,gene,W03F8.1,0,5204596,2.86204,12014,5192567,15,5204581,0,-15
IV,+,5209659,0.0,5.04871e-29,94,94,0,0,2466,gene,Y59E9AL.7,0,5209693,3.9761,2557,5207102,34,5209490,-169,-203
IV,+,5209668,0.0166667,5.20417e-17,60,59,1,1,6154,gene,Y59E9AL.7,0,5209693,3.9761,2566,5207102,25,5209490,-178,-203
IV,+,5265577,0.0,0.25,2,2,0,0,0,gene,F36H12.6,0,5265676,None,4616,5260961,99,5265581,4,-95
IV,+,5274505,0.0128205,1.31722e-43,156,154,2,2,0,gene,F36H12.2,0,5274521,0.0249088,362,5274143,16,5274665,160,144
IV,+,5290836,0.00114025,0.0,877,876,1,0,1,gene,F36H12.1,0,5290839,1.09373,14737,5276099,3,5290836,0,-3
IV,+,5310259,0.0,0.0625,4,4,0,0,10,gene,ZK354.3,0,5310425,0.0886945,11925,5298334,166,5310223,-36,-202
IV,+,5319242,0.0,1.97215e-31,102,102,0,0,0,gene,Y4C6B.5,0,5319242,0.279123,2347,5316895,0,5319242,0,0
IV,+,5326433,0.0909091,0.00537109,11,10,1,1,1,gene,Y4C6B.4,0,5326436,0.0783972,1405,5325028,3,5326433,0,-3
IV,+,5340879,0.0,0.0,231,231,0,0,1,gene,Y4C6B.2,0,5340880,0.364588,4100,5336779,1,5340879,0,-1
IV,+,5354477,0.00430108,0.0,930,926,4,4,3,gene,Y4C6B.1,0,5354480,0.927011,10285,5344192,3,5354477,0,-3
IV,+,5360810,0.0,0.5,1,1,0,0,3,gene,F41H10.5,0,5361001,0.145024,4272,5356538,191,5361002,192,1
IV,+,5360989,0.0,9.53674e-07,20,20,0,0,4,gene,F41H10.5,0,5361001,0.145024,4451,5356538,12,5361002,13,1
IV,+,5364548,0.00881057,0.0,227,225,2,2,0,gene,F41H10.4,1,5364548,0.45779,2397,5362151,0,5364548,0,0
IV,+,5366856,0.97619,8.54792e-44,168,4,164,119,2,gene,F41H10.11,2,5366856,0.837187,117,5366739,0,5366856,0,0
IV,+,5369788,0.0186916,0.0,428,420,8,8,6,gene,F41H10.3,0,5369794,1.51302,935,5368853,6,5369795,7,1
IV,+,5392161,0.0,0.5,1,1,0,0,5,gene,ZK616.5,0,5392249,0.64446,6092,5386069,88,5392161,0,-88
IV,+,5395022,0.0132275,0.0,378,373,5,4,6,gene,ZK616.4,0,5395029,1.4389,1461,5393561,7,5395022,0,-7
IV,+,5395028,0.0,0.5,1,1,0,0,169,gene,ZK616.4,0,5395029,1.4389,1467,5393561,1,5395022,-6,-7
IV,+,5397828,0.950704,3.56532e-32,142,7,135,97,3,gene,ZK616.2,2,5397853,0.521902,91,5397737,25,5397854,26,1
IV,+,5402925,0.0,0.0078125,7,7,0,0,2,gene,ZK616.1,0,5402987,0.0937766,1849,5401076,62,5403114,189,127
IV,+,5438994,0.0,3.72529e-09,28,28,0,0,0,gene,Y4C6A.2,0,5439061,0.0529621,31631,5407363,67,5439062,68,1
IV,+,5494218,0.0,0.5,1,1,0,0,0,gene,B0273.1,0,5494220,0.271071,3916,5490302,2,5494218,0,-2
IV,+,5538477,0.00135135,0.0,740,739,1,0,0,gene,T12E12.4,1,5538513,1.36562,43240,5495237,36,5538477,0,-36
IV,+,5541614,0.666667,0.00246904,66,22,44,30,2,gene,T12E12.3,2,5541623,0.279957,257,5541357,9,5541620,6,-3
IV,+,5544847,0.917293,3.46502e-25,133,11,122,93,1,gene,T12E12.2,3,5544853,0.403007,118,5544729,6,5544847,0,-6
IV,+,5550624,0.4,0.3125,5,3,2,2,0,gene,T12E12.1,4,5550662,0.850421,2178,5548446,38,5551121,497,459
IV,+,5551121,0.497908,0.0363233,478,240,238,195,0,gene,T12E12.1,4,5551131,0.850421,2675,5548446,10,5551121,0,-10
IV,+,5584647,0.0,2.35099e-38,125,125,0,0,0,gene,F26D12.1,0,5584669,1.87056,25840,5558807,22,5584647,0,-22
IV,+,5601636,0.00106838,0.0,936,935,1,0,0,gene,F26D12.1,0,5601692,1.87056,42829,5558807,56,5601636,0,-56
IV,+,5649518,0.00662252,0.0,1057,1050,7,7,0,gene,B0547.1,0,5649520,1.34967,16154,5633364,2,5649518,0,-2
IV,+,5685280,0.0,0.5,1,1,0,0,0,gene,C55C3.3,0,5685321,0.156912,569,5684711,41,5685278,-2,-43
IV,+,5709083,0.0,7.27596e-12,37,37,0,0,0,gene,C55C3.1,0,5709088,0.0826997,14448,5694635,5,5709081,-2,-7
IV,+,5725585,0.00224215,0.0,446,445,1,1,1,gene,H35B03.1,0,5725631,0.564826,11143,5714442,46,5725585,0,-46
IV,+,5744388,0.0,2.06795e-25,82,82,0,0,64,gene,C45E5.1,0,5744394,0.227392,2537,5741851,6,5744388,0,-6
IV,+,5824778,0.0017762,0.0,563,562,1,1,0,gene,C10G6.1,0,5824874,1.16062,24585,5800193,96,5824778,0,-96
IV,+,5839463,0.0188679,5.88418e-15,53,52,1,1,5,gene,C06E7.2,0,5839494,0.356545,9279,5830184,31,5839463,0,-31
IV,+,5848642,0.00510204,0.0,784,780,4,4,18,gene,C06E7.1,0,5848672,1.07985,4654,5843988,30,5848642,0,-30
IV,+,5885819,0.0,0.0,889,889,0,0,5,gene,H04M03.4,0,5885819,1.93,34989,5850830,0,5885819,0,0
IV,+,5930587,0.0,0.00195312,9,9,0,0,0,gene,H32C10.2,0,5930637,0.763063,9009,5921578,50,5930629,42,-8
IV,+,5930629,0.00374766,0.0,1601,1595,6,5,6,gene,H32C10.2,0,5930637,0.763063,9051,5921578,8,5930629,0,-8
IV,+,5941910,0.00116822,0.0,856,855,1,1,1,gene,K02B2.1,0,5941915,1.0311,4481,5937429,5,5941910,0,-5
IV,+,5966640,0.0,0.0,208,208,0,0,0,gene,B0350.2,0,5966673,3.88034,22642,5943998,33,5966640,0,-33
IV,+,5975541,0.00078064,0.0,1281,1280,1,0,0,gene,B0350.2,0,5975559,3.88034,31543,5943998,18,5975541,0,-18
IV,+,5979855,0.0,0.125,3,3,0,0,0,gene,B0350.2,0,5979995,3.88034,35857,5943998,140,5979855,0,-140
IV,+,5981054,0.0,2.84217e-14,45,45,0,0,1,gene,B0350.2,0,5981116,3.88034,37056,5943998,62,5981054,0,-62
IV,+,6015178,0.0,0.0,1095,1095,0,0,0,gene,C46G7.2,1,6015180,5.11104,10337,6004841,2,6015181,3,1
IV,+,6017986,0.00140121,0.0,2141,2138,3,2,8,gene,C46G7.1,2,6018000,3.11856,49,6017937,14,6017986,0,-14
IV,+,6040959,0.0,3.8147e-06,18,18,0,0,0,gene,H16O14.1,0,6041154,0.882733,21243,6019716,195,6040959,0,-195
IV,+,6061637,0.0,1.81899e-12,39,39,0,0,25,gene,H16O14.1,0,6061781,0.882733,41921,6019716,144,6061637,0,-144
IV,+,6061680,0.0,0.25,2,2,0,0,134,gene,H16O14.1,0,6061781,0.882733,41964,6019716,101,6061637,-43,-144
IV,+,6062078,0.0,0.03125,5,5,0,0,0,gene,H16O14.1,0,6062131,0.882733,42362,6019716,53,6062078,0,-53
IV,+,6064327,0.0,0.0078125,7,7,0,0,0,gene,H16O14.1,0,6064333,0.882733,44611,6019716,6,6064327,0,-6
IV,+,6095387,0.0,1.19209e-07,23,23,0,0,1,gene,K08B4.1,0,6095398,1.1294,20897,6074490,11,6095396,9,-2
IV,+,6095396,0.0,0.0,867,867,0,0,55,gene,K08B4.1,0,6095398,1.1294,20906,6074490,2,6095396,0,-2
IV,+,6118205,0.00424929,0.0,706,703,3,2,2,gene,M03D4.1,0,6118207,1.64979,7582,6110623,2,6118208,3,1
IV,+,6210920,0.0135135,3.91753e-21,74,73,1,1,0,gene,C49A9.6,0,6210983,0.40489,5213,6205707,63,6210984,64,1
IV,+,6213806,0.0,3.67342e-40,131,131,0,0,1,gene,C49A9.5,0,6213867,0.27591,641,6213165,61,6213806,0,-61
IV,+,6217356,0.0,5.42101e-20,64,64,0,0,10,gene,C49A9.9,0,6217418,0.34383,996,6216360,62,6217356,0,-62
IV,+,6222383,0.333333,0.375,3,2,1,0,0,gene,C49A9.3,0,6222390,0.146701,39,6222344,7,6222383,0,-7
IV,+,6225427,0.0434783,1.47082e-11,46,44,2,1,0,gene,C49A9.2,0,6225434,0.291412,439,6224988,7,6225435,8,1
IV,+,6231007,0.0,1.69407e-21,69,69,0,0,0,gene,F58F9.4,0,6231027,0.105224,998,6230009,20,6231028,21,1
IV,+,6233230,0.0,0.000488281,11,11,0,0,1,gene,F58F9.3,0,6233236,0.376436,731,6232499,6,6233237,7,1
IV,+,6321829,0.0,0.03125,5,5,0,0,3,gene,Y73B6BL.29,1,6321832,0.329553,6128,6315701,3,6321932,103,100
IV,+,6324165,0.0103567,0.0,869,860,9,8,30,gene,Y73B6BL.6,2,6324290,16.6382,2,6324163,125,6324165,0,-125
IV,+,6324177,0.0,0.5,1,1,0,0,4594,gene,Y73B6BL.6,2,6324290,16.6382,14,6324163,113,6324176,-1,-114
IV,+,6324317,0.333333,0.375,3,2,1,1,5,gene,Y73B6BL.6,2,6324328,16.6382,154,6324163,11,6324317,0,-11
IV,+,6324342,0.125,0.03125,8,7,1,1,1488,gene,Y73B6BL.6,2,6324383,16.6382,179,6324163,41,6324324,-18,-59
IV,+,6326496,1.0,0.25,2,0,2,2,5,gene,Y73B6BL.32,3,6326516,6.61602,54,6326442,20,6326510,14,-6
IV,+,6326510,0.938401,0.0,763,47,716,524,24,gene,Y73B6BL.32,3,6326516,6.61602,68,6326442,6,6326510,0,-6
IV,+,6329558,0.928571,0.000854492,14,1,13,11,2,gene,Y73B6BL.5,4,6329622,1.48772,108,6329450,64,6329624,66,2
IV,+,6329572,0.703364,3.88652e-14,327,97,230,167,36,gene,Y73B6BL.5,4,6329622,1.48772,122,6329450,50,6329572,0,-50
IV,+,6329584,0.636364,0.161133,11,4,7,3,1288,gene,Y73B6BL.5,4,6329622,1.48772,134,6329450,38,6329624,40,2
IV,+,6331491,0.0396825,2.87082e-30,126,121,5,2,8,gene,Y73B6BL.5,4,6331517,1.48772,653,6330838,26,6331491,0,-26
IV,+,6334148,1.0,0.5,1,0,1,1,0,gene,Y73B6BL.30,5,6334202,1.20509,606,6333542,54,6334199,51,-3
IV,+,6334199,0.722851,9.31443e-42,884,245,639,463,3,gene,Y73B6BL.30,5,6334202,1.20509,657,6333542,3,6334199,0,-3
IV,+,6337637,0.281716,4.31874e-25,536,385,151,113,4,gene,Y73B6BL.4,0,6337638,0.751263,2380,6335257,1,6337637,0,-1
IV,+,6353997,0.00862069,1.3963e-33,116,115,1,1,1,gene,Y73B6BL.269,0,6354007,None,6138,6347859,10,6353995,-2,-12
IV,+,6361960,0.0238095,9.54969e-12,42,41,1,1,0,gene,Y73B6BL.47,0,6362039,None,4732,6357228,79,6362040,80,1
IV,+,6415469,0.00618557,0.0,485,482,3,2,3,gene,Y73B6BL.3,0,6415486,0.675084,7281,6408188,17,6415474,5,-12
IV,+,6419513,0.0,0.0,829,829,0,0,13,gene,Y73B6BL.2,0,6419561,0.39103,2074,6417439,48,6419491,-22,-70
IV,+,6421575,0.0666667,4.05125e-07,30,28,2,1,0,gene,Y73B6BL.38,0,6421591,2.03307,690,6420885,16,6421588,13,-3
IV,+,6421579,0.0,0.000976562,10,10,0,0,41,gene,Y73B6BL.38,0,6421591,2.03307,694,6420885,12,6421588,9,-3
IV,+,6438190,0.0,0.03125,5,5,0,0,2,gene,Y73B6BL.43,0,6438206,0.0696564,14710,6423480,16,6438207,17,1
IV,+,6443484,0.0,0.0,314,314,0,0,0,gene,Y73B6BL.31,0,6443484,0.351117,3469,6440015,0,6443484,0,0
IV,+,6464296,0.0,0.125,3,3,0,0,1,gene,Y73B6BL.42,0,6464328,0.0435771,17761,6446535,32,6464336,40,8
IV,+,6480505,0.0,1.73472e-18,59,59,0,0,0,gene,Y73B6BL.1,0,6480511,0.335326,12155,6468350,6,6480505,0,-6
IV,+,6493694,0.0,0.0,540,540,0,0,2,gene,Y73B6BL.44,0,6493694,0.238205,4620,6489074,0,6493684,-10,-10
IV,+,6506710,0.0027933,0.0,1432,1428,4,2,0,gene,Y73B6BR.1,0,6506710,1.384,9368,6497342,0,6506710,0,0
IV,+,6518149,0.0,7.27596e-12,37,37,0,0,1,gene,C01G5.7,0,6518157,0.0857718,7184,6510965,8,6518158,9,1
IV,+,6522858,0.0334347,0.0,329,318,11,9,7,gene,C01G5.6,1,6522888,1.34928,573,6522285,30,6522858,0,-30
IV,+,6524583,0.911765,3.48315e-07,34,3,31,30,6,gene,C01G5.5,2,6524623,0.32914,30,6524553,40,6524624,41,1
IV,+,6524594,0.953368,6.72623e-44,193,9,184,140,75,gene,C01G5.5,2,6524623,0.32914,41,6524553,29,6524624,30,1
IV,+,6557242,0.0,0.0078125,7,7,0,0,20,gene,C43G2.5,0,6557245,0.0723404,4747,6552495,3,6557214,-28,-31
IV,+,6560720,0.0,0.25,2,2,0,0,1,gene,C43G2.4,0,6560743,0.134895,8225,6552495,23,6560720,0,-23
IV,+,6562680,0.0,2.98023e-08,25,25,0,0,0,gene,C43G2.4,0,6562681,0.134895,1745,6560935,1,6562680,0,-1
IV,+,6585855,0.00593824,0.0,842,837,5,4,2,gene,F38A5.13,0,6585885,1.67988,6467,6579388,30,6585855,0,-30
IV,+,6601664,0.00176991,0.0,2825,2820,5,4,3,gene,F38A5.7,0,6601689,2.87073,1154,6600510,25,6601667,3,-22
IV,+,6632206,0.0,8.47033e-22,70,70,0,0,0,gene,C01B10.9,1,6632228,0.632892,7721,6624485,22,6632206,0,-22
IV,+,6632213,0.0,0.015625,6,6,0,0,68,gene,C01B10.9,1,6632228,0.632892,7728,6624485,15,6632206,-7,-22
IV,+,6635073,0.97786,0.0,271,6,265,191,22,gene,C01B10.8,2,6635075,0.768747,104,6634969,2,6635073,0,-2
IV,+,6640164,0.00145349,0.0,1376,1374,2,1,6,gene,C01B10.6,0,6640301,4.95261,916,6639248,137,6640164,0,-137
IV,+,6657965,0.00423729,0.0,944,940,4,2,0,gene,C01B10.11,0,6657981,3.18051,11045,6646920,16,6657982,17,1
IV,+,6757295,0.00440529,0.0,454,452,2,2,4,gene,H34C03.2,1,6757326,1.2073,51577,6705718,31,6757295,0,-31
IV,+,6762700,0.894737,0.000326157,19,2,17,12,2,gene,H34C03.1,2,6762712,0.10962,63,6762637,12,6762700,0,-12
IV,+,6770794,0.0,4.48416e-44,144,144,0,0,0,gene,C17H12.13,0,6770816,1.76008,5610,6765184,22,6770794,0,-22
IV,+,6778137,0.00791557,0.0,379,376,3,3,6,gene,C17H12.13,0,6778138,1.76008,12953,6765184,1,6778137,0,-1
IV,+,6791058,0.00324706,0.0,10471,10437,34,33,1,gene,C17H12.14,0,6791081,15.5645,11286,6779772,23,6791058,0,-23
IV,+,6804763,0.0052356,0.0,191,190,1,0,6,gene,C17H12.11,0,6804836,0.270223,5999,6798764,73,6804763,0,-73
IV,+,6812092,0.016129,1.34441e-17,62,61,1,0,0,gene,C17H12.9,0,6812108,0.316812,2478,6809614,16,6812092,0,-16
IV,+,6842948,0.00452489,0.0,663,660,3,3,2,gene,C05B10.1,0,6842978,0.951811,9500,6833448,30,6842948,0,-30
IV,+,6873279,0.0,0.0625,4,4,0,0,0,gene,T05A12.1,0,6873308,0.00441826,27397,6845882,29,6873242,-37,-66
IV,+,6888955,0.0,0.0,223,223,0,0,1,gene,T05A12.4,0,6888964,0.245697,14175,6874780,9,6888955,0,-9
IV,+,6903920,0.0,0.125,3,3,0,0,4,gene,T22D1.5,0,6903961,1.63137,6176,6897744,41,6903934,14,-27
IV,+,6903934,0.00318725,0.0,1255,1251,4,4,19,gene,T22D1.5,0,6903961,1.63137,6190,6897744,27,6903934,0,-27
IV,+,6910667,0.00433767,0.0,2997,2984,13,9,2,gene,T22D1.4,1,6910733,7.02564,4273,6906394,66,6910667,0,-66
IV,+,6913522,0.625646,1.04751e-15,967,362,605,451,1,gene,T22D1.3,2,6913525,2.21752,673,6912849,3,6913522,0,-3
IV,+,6957625,0.0,1.42109e-14,46,46,0,0,0,gene,B0478.1,0,6957660,0.315748,32739,6924886,35,6957625,0,-35
IV,+,6960193,0.0,7.27596e-12,37,37,0,0,0,gene,B0478.1,0,6960300,0.315748,35307,6924886,107,6960193,0,-107
IV,+,6965592,0.0,0.5,1,1,0,0,1,gene,ZK381.2,0,6965690,0.0517318,1892,6963700,98,6965476,-116,-214
IV,+,6977494,0.0,1.90735e-06,19,19,0,0,0,gene,ZK381.1,0,6977509,0.932305,9860,6967634,15,6977510,16,1
IV,+,6977503,0.00983607,0.0,305,302,3,3,31,gene,ZK381.1,0,6977509,0.932305,9869,6967634,6,6977503,0,-6
IV,+,7003607,0.00218579,0.0,915,913,2,0,0,gene,C25A8.4,0,7003608,0.8755,2097,7001510,1,7003609,2,1
IV,+,7003609,0.0,0.000244141,12,12,0,0,0,gene,C25A8.4,0,7003672,0.8755,2099,7001510,63,7003609,0,-63
IV,+,7012009,0.00222222,0.0,450,449,1,1,18,gene,C06G3.7,0,7012013,0.817032,777,7011232,4,7011987,-22,-26
IV,+,7017610,0.00215517,0.0,464,463,1,1,2,gene,C06G3.6,0,7017648,1.03846,1040,7016570,38,7017610,0,-38
IV,+,7024195,0.0138889,0.0,288,284,4,4,3,gene,C06G3.5,0,7024226,2.52048,4001,7020194,31,7024195,0,-31
IV,+,7026456,0.00719424,0.0,278,276,2,2,0,gene,C06G3.5,0,7026498,2.52048,6262,7020194,42,7026456,0,-42
IV,+,7040195,0.00634921,0.0,315,313,2,2,1,gene,C06G3.2,0,7040195,0.876057,3286,7036909,0,7040195,0,0
IV,+,7050140,0.0016129,0.0,620,619,1,1,79,gene,C06G3.1,0,7050146,0.623273,6642,7043498,6,7050140,0,-6
IV,+,7065211,0.0,0.25,2,2,0,0,2,gene,Y43B11AL.1,0,7065219,0.141286,5316,7059895,8,7065380,169,161
IV,+,7081498,0.00229709,0.0,1306,1303,3,2,0,gene,Y43B11AR.1,0,7081522,3.00057,7889,7073609,24,7081498,0,-24
IV,+,7115587,0.0,0.25,2,2,0,0,0,gene,C34D4.9,0,7115601,0.233216,2743,7112844,14,7115587,0,-14
IV,+,7121996,0.0,0.5,1,1,0,0,0,gene,C34D4.8,0,7122055,0.00254716,2095,7119901,59,7122177,181,122
IV,+,7153630,0.0,0.25,2,2,0,0,6,gene,C34D4.3,0,7153649,1.10702,2967,7150663,19,7153645,15,-4
IV,+,7156708,0.0,0.25,2,2,0,0,11,gene,C34D4.1,0,7156844,0.0503736,716,7155992,136,7156883,175,39
IV,+,7156866,0.0,0.0625,4,4,0,0,5,gene,C34D4.1,0,7156873,0.0503736,874,7155992,7,7156883,17,10
IV,+,7156883,0.0,0.000976562,10,10,0,0,11,gene,C34D4.1,0,7156886,0.0503736,891,7155992,3,7156883,0,-3
IV,+,7168693,0.0,8.47033e-22,70,70,0,0,2,gene,C42D4.6,0,7168765,0.769082,780,7167913,72,7168693,0,-72
IV,+,7180619,0.0,0.5,1,1,0,0,4,gene,C42D4.2,0,7180642,0.119729,221,7180398,23,7180527,-92,-115
IV,+,7189270,0.00220334,0.0,3177,3170,7,6,24,gene,C42D4.1,0,7189270,6.92782,6294,7182976,0,7189174,-96,-96
IV,+,7213168,0.0,0.0,392,392,0,0,5,gene,R13A1.2,0,7213264,1.25762,7889,7205279,96,7213701,533,437
IV,+,7237708,0.00728155,0.0,824,818,6,5,1,gene,D2024.3,0,7237711,3.55579,4902,7232806,3,7237712,4,1
IV,+,7282271,0.00645161,2.8026e-45,155,154,1,0,1,gene,C06E4.2,0,7282275,1.0114,20255,7262016,4,7282271,0,-4
IV,+,7375131,0.0,4.44089e-16,51,51,0,0,0,gene,T12B3.3,0,7375155,1.69295,66722,7308409,24,7375156,25,1
IV,+,7377262,0.0,0.5,1,1,0,0,35,gene,T12B3.2,0,7377303,0.188451,646,7376616,41,7376881,-381,-422
IV,+,7393205,0.00847458,0.0,708,702,6,4,3,gene,C48A7.2,0,7393367,2.72615,8451,7384754,162,7393205,0,-162
IV,+,7394068,0.0,0.0,160,160,0,0,3,gene,C48A7.2,0,7394080,2.72615,9314,7384754,12,7394068,0,-12
IV,+,7405444,0.00423729,0.0,236,235,1,1,0,gene,C48A7.1,0,7405539,0.455499,7886,7397558,95,7405444,0,-95
IV,+,7424482,0.0,1.86265e-09,29,29,0,0,1,gene,B0496.4,0,7424483,0.0523583,1827,7422655,1,7424482,0,-1
IV,+,7428910,0.0181818,1.52656e-15,55,54,1,1,0,gene,B0496.3,0,7428917,0.695296,6255,7422655,7,7428910,0,-7
IV,+,7440738,0.0,0.125,3,3,0,0,1,gene,B0496.3,0,7440772,0.695296,7210,7433528,34,7440738,0,-34
IV,+,7442018,0.5,0.5,2,1,1,1,7,gene,B0496.3,0,7442034,0.695296,8490,7433528,16,7442018,0,-16
IV,+,7456734,0.0185185,2.9976e-15,54,53,1,0,0,gene,F13B6.1,0,7456776,0.234425,7172,7449562,42,7456777,43,1
IV,+,7475025,0.97,1.27559e-25,100,3,97,83,0,gene,F55G1.5,2,7475032,0.258154,88,7474937,7,7475033,8,1
IV,+,7478436,0.00455581,0.0,439,437,2,2,0,gene,F55G1.4,0,7478436,0.835717,2238,7476198,0,7478436,0,0
IV,+,7491746,0.0,1.90735e-06,19,19,0,0,12,gene,F55G1.1,0,7491754,0.0965841,2984,7488762,8,7491755,9,1
IV,+,7503606,0.0,0.00195312,9,9,0,0,1,gene,R05G6.6,0,7503616,4.66763,9866,7493740,10,7503606,0,-10
IV,+,7513217,0.00180505,0.0,554,553,1,1,0,gene,R05G6.4,0,7513219,0.713398,3758,7509459,2,7513159,-58,-60
IV,+,7556621,0.0,0.0,226,226,0,0,0,gene,F49E8.1,0,7556632,1.24894,5126,7551495,11,7556652,31,20
IV,+,7556802,0.0,1.00974e-28,93,93,0,0,1,gene,F49E8.1,0,7557022,1.24894,5307,7551495,220,7556802,0,-220
IV,+,7557070,0.0,0.5,1,1,0,0,1,gene,F49E8.1,0,7557192,1.24894,5575,7551495,122,7557070,0,-122
IV,+,7575518,0.0,6.10352e-05,14,14,0,0,17,gene,F32E10.2,0,7575724,1.39779,1773,7573745,206,7576165,647,441
IV,+,7576156,0.0,3.05176e-05,15,15,0,0,0,gene,F32E10.2,0,7576170,1.39779,227,7575929,14,7576165,9,-5
IV,+,7576165,0.00330579,0.0,605,603,2,2,1,gene,F32E10.2,0,7576170,1.39779,236,7575929,5,7576165,0,-5
IV,+,7580581,0.0152284,0.0,197,194,3,3,5,gene,F32E10.1,0,7580587,0.737686,3274,7577307,6,7580581,0,-6
IV,+,7633344,0.00767219,0.0,5735,5691,44,34,2,gene,F45E4.2,0,7633413,10.296,5120,7628224,69,7633344,0,-69
IV,+,7658878,0.0043956,0.0,455,453,2,2,165,gene,C08G9.1,0,7658921,1.20435,4599,7654279,43,7658718,-160,-203
IV,+,7675157,0.0,6.10352e-05,14,14,0,0,0,gene,F33D4.2,0,7675157,0.531698,11007,7664150,0,7675158,1,1
IV,+,7681343,0.0,1.29247e-26,86,86,0,0,9,gene,F33D4.2,0,7681382,0.531698,17193,7664150,39,7681409,66,27
IV,+,7681361,0.0,0.000488281,11,11,0,0,131,gene,F33D4.2,0,7681382,0.531698,17211,7664150,21,7681409,48,27
IV,+,7710029,0.0094919,0.0,1791,1774,17,15,2,gene,F33D4.8,0,7710030,1.54755,13125,7696904,1,7710029,0,-1
IV,+,7726702,0.00265957,0.0,1128,1125,3,2,9,gene,C50F7.5,0,7726702,2.04702,12520,7714182,0,7726702,0,0
IV,+,7728896,0.027027,0.0,259,252,7,7,0,gene,C50F7.4,0,7728902,1.28956,1187,7727709,6,7728903,7,1
IV,+,7734630,0.0,6.10352e-05,14,14,0,0,1,gene,C50F7.2,0,7734630,0.0190198,419,7734211,0,7734630,0,0
IV,+,7743828,0.0,3.55271e-15,48,48,0,0,0,gene,C50F7.1,0,7743846,0.0662814,7436,7736392,18,7743889,61,43
IV,+,7753501,0.0,4.76837e-07,21,21,0,0,9,gene,C46A5.3,0,7753504,8.2912,7425,7746076,3,7753505,4,1
IV,+,7774499,0.0,7.62939e-06,17,17,0,0,810,gene,C33H5.7,1,7774523,1.23391,7404,7767095,24,7774431,-68,-92
IV,+,7774510,0.00524934,0.0,381,379,2,2,332,gene,C33H5.7,1,7774523,1.23391,7415,7767095,13,7774431,-79,-92
IV,+,7776008,0.928,3.59472e-25,125,9,116,92,6,gene,C33H5.6,2,7776014,0.393219,71,7775937,6,7776008,0,-6
IV,+,7776166,1.0,0.5,1,0,1,1,35,gene,C33H5.6,2,7776168,0.393219,229,7775937,2,7776008,-158,-160
IV,+,7818234,0.00460829,0.0,434,432,2,1,43,gene,T14A8.1,0,7818245,0.606245,7551,7810683,11,7818234,0,-11
IV,+,7830545,0.00496278,0.0,403,401,2,1,21,gene,C06A6.3,0,7830555,1.17594,9369,7821176,10,7830545,0,-10
IV,+,7846613,0.0,1.12104e-44,146,146,0,0,1,gene,C06A6.2,0,7846624,0.511826,14190,7832423,11,7846625,12,1
IV,+,7868890,0.0,0.0,993,993,0,0,2,gene,T06C10.4,0,7868912,1.75277,14726,7854164,22,7868890,0,-22
IV,+,7882011,0.0,0.0,766,766,0,0,7,gene,C55F2.1,0,7882049,0.933643,2014,7879997,38,7882011,0,-38
IV,+,7891302,0.0,1.77636e-15,49,49,0,0,3,gene,C55F2.1,0,7891338,0.933643,11305,7879997,36,7891339,37,1
IV,+,7892648,0.0,3.63798e-12,38,38,0,0,0,gene,C55F2.1,0,7892668,0.933643,12651,7879997,20,7892648,0,-20
IV,+,7903723,0.0107527,9.3906e-27,93,92,1,0,0,gene,C49H3.6,0,7903759,0.575442,3492,7900231,36,7903723,0,-36
IV,+,7910583,0.00220751,0.0,906,904,2,2,47,gene,C49H3.5,1,7910628,2.92091,3527,7907056,45,7910583,0,-45
IV,+,7910729,0.0,0.0625,4,4,0,0,2,gene,C49H3.5,1,7910740,2.92091,3673,7907056,11,7910729,0,-11
IV,+,7915274,0.934211,2.44512e-16,76,5,71,55,3,gene,C49H3.4,2,7915294,0.248818,107,7915167,20,7915283,9,-11
IV,+,7924370,0.0196657,0.0,1017,997,20,14,3177,gene,C49H3.3,0,7924374,5.68285,2373,7921997,4,7924336,-34,-38
IV,+,7948657,0.0107239,0.0,373,369,4,3,1,gene,F20D12.2,0,7948659,0.629001,602,7948055,2,7948657,0,-2
IV,+,7957557,0.0,2.1684e-19,62,62,0,0,0,gene,F20D12.1,0,7957562,1.97653,3931,7953626,5,7957563,6,1
IV,+,7958582,0.0157658,0.0,444,437,7,7,4,gene,F20D12.1,0,7958595,1.97653,4956,7953626,13,7958596,14,1
IV,+,7967372,0.5,0.375,4,2,2,1,21,gene,F57H12.5,0,7967440,0.0305692,5261,7962111,68,7967441,69,1
IV,+,7982509,0.0102264,0.0,2738,2710,28,20,0,gene,F57H12.1,0,7982527,9.73686,523,7981986,18,7982509,0,-18
IV,+,7988668,0.0,1.20371e-35,116,116,0,0,4,gene,Y42H9B.1,0,7988670,0.575071,4762,7983906,2,7988671,3,1
IV,+,8016262,0.0,1.0842e-19,63,63,0,0,122,gene,C26B2.7,1,8016370,1.00704,581,8015681,108,8016195,-67,-175
IV,+,8016976,0.904,4.14145e-22,125,12,113,88,6,gene,C26B2.6,2,8016985,0.593236,105,8016871,9,8016986,10,1
IV,+,8016985,0.983221,0.0,298,5,293,208,273,gene,C26B2.6,2,8016985,0.593236,114,8016871,0,8016986,1,1
IV,+,8062650,0.0133136,0.0,676,667,9,9,4,gene,C18F3.2,0,8062712,2.0645,15349,8047301,62,8062650,0,-62
IV,+,8067054,0.0,1.11022e-16,53,53,0,0,55,gene,C18F3.2,0,8067082,2.0645,19753,8047301,28,8067083,29,1
IV,+,8099893,0.0,0.00012207,13,13,0,0,152,gene,Y42H9AR.2,0,8099898,0.119376,16249,8083644,5,8099899,6,1
IV,+,8102341,0.0,0.000488281,11,11,0,0,10,gene,Y42H9AR.5,0,8102517,0.342235,886,8101455,176,8102497,156,-20
IV,+,8113476,0.00858369,0.0,233,231,2,2,0,gene,Y42H9AR.1,0,8113486,2.43044,9173,8104303,10,8113476,0,-10
IV,+,8130593,0.0215827,6.28483e-37,139,136,3,3,325,gene,F42G8.6,0,8130599,0.3979,1703,8128890,6,8130548,-45,-51
IV,+,8139200,0.796703,9.74633e-17,182,37,145,59,6,gene,F42G8.4,2,8139364,0.544778,124,8139076,164,8139200,0,-164
IV,+,8139250,0.285714,0.164062,7,5,2,1,136,gene,F42G8.4,2,8139364,0.544778,174,8139076,114,8139200,-50,-164
IV,+,8143481,0.740741,1.87064e-07,108,28,80,41,1,gene,F42G8.3,3,8143491,0.379143,351,8143130,10,8143481,0,-10
IV,+,8148775,0.72766,6.12743e-13,235,64,171,81,2,gene,B0218.3,4,8148786,0.906654,147,8148628,11,8148775,0,-11
IV,+,8152426,0.0441176,0.0,408,390,18,10,0,gene,B0218.2,5,8152431,0.721988,1166,8151260,5,8152426,0,-5
IV,+,8159368,0.0,1.92593e-34,112,112,0,0,55,gene,B0218.1,0,8159402,1.14999,4530,8154838,34,8159368,0,-34
IV,+,8159388,0.0,3.55271e-15,48,48,0,0,491,gene,B0218.1,0,8159402,1.14999,4550,8154838,14,8159388,0,-14
IV,+,8159397,0.0,0.000976562,10,10,0,0,395,gene,B0218.1,0,8159402,1.14999,4559,8154838,5,8159397,0,-5
IV,+,8176462,0.00675676,4.14784e-43,148,147,1,1,0,gene,C07G1.3,0,8176517,1.41233,14417,8162045,55,8176466,4,-51
IV,+,8184676,0.0,1.05879e-22,73,73,0,0,1,gene,C07G1.3,0,8184690,1.41233,22631,8162045,14,8184676,0,-14
IV,+,8225643,0.0,1.11022e-16,53,53,0,0,84,gene,T09A12.5,0,8225657,2.63727,2203,8223440,14,8225657,14,0
IV,+,8225657,0.00484607,0.0,7016,6982,34,25,170,gene,T09A12.5,0,8225657,2.63727,2217,8223440,0,8225657,0,0
IV,+,8290255,0.00734754,0.0,1361,1351,10,6,0,gene,K07H8.3,1,8290258,2.52537,17774,8272481,3,8290255,0,-3
IV,+,8290258,0.0,0.03125,5,5,0,0,0,gene,K07H8.3,1,8290258,2.52537,17777,8272481,0,8290255,-3,-3
IV,+,8290329,0.0,0.5,1,1,0,0,66,gene,K07H8.3,1,8290339,2.52537,17848,8272481,10,8290255,-74,-84
IV,+,8291567,0.981374,0.0,859,16,843,632,16,gene,K07H8.2,2,8291591,1.8307,89,8291478,24,8291567,0,-24
IV,+,8292747,0.0,0.03125,5,5,0,0,1,gene,K07H8.2,2,8292816,1.8307,1269,8291478,69,8292747,0,-69
IV,+,8292759,0.0,5.82077e-11,34,34,0,0,26,gene,K07H8.2,2,8292816,1.8307,1281,8291478,57,8292759,0,-57
IV,+,8294672,0.858182,6.48826e-36,275,39,236,162,0,gene,K07H8.1,3,8294738,0.40963,87,8294585,66,8294672,0,-66
IV,+,8297474,0.740088,8.58337e-26,454,118,336,246,111,gene,F35H10.7,4,8297474,0.503931,115,8297359,0,8297474,0,0
IV,+,8299918,0.931655,0.0,278,19,259,199,1,gene,F35H10.6,5,8299922,0.667312,95,8299823,4,8299918,0,-4
IV,+,8300750,0.892086,0.0,1946,210,1736,1324,289,gene,F35H10.5,6,8300759,3.44201,111,8300639,9,8300760,10,1
IV,+,8303950,0.0119522,0.0,251,248,3,3,1,gene,F35H10.4,0,8303976,2.1222,2803,8301147,26,8303950,0,-26
IV,+,8303954,0.0,0.03125,5,5,0,0,36,gene,F35H10.4,0,8303976,2.1222,2807,8301147,22,8303954,0,-22
IV,+,8303958,0.0,0.125,3,3,0,0,356,gene,F35H10.4,0,8303976,2.1222,2811,8301147,18,8303954,-4,-22
IV,+,8326077,0.0149254,4.5401e-19,67,66,1,0,4,gene,F35H10.3,0,8326082,0.125825,18696,8307381,5,8325949,-128,-133
IV,+,8326219,0.0,0.25,2,2,0,0,1,gene,F35H10.3,0,8326229,0.125825,18838,8307381,10,8325949,-270,-280
IV,+,8329197,0.0,3.46945e-18,58,58,0,0,1,gene,F35H10.2,0,8329206,0.197827,2158,8327039,9,8329207,10,1
IV,+,8356798,0.5,0.5,2,1,1,0,4,gene,F17E9.1,0,8356816,0.0596505,278,8356520,18,8356748,-50,-68
IV,+,8361071,0.00443262,0.0,1128,1123,5,3,0,gene,D2096.4,1,8361078,0.990356,3169,8357902,7,8361071,0,-7
IV,+,8363445,0.933333,7.17579e-28,135,9,126,96,1,gene,D2096.12,2,8363446,0.273318,132,8363313,1,8363445,0,-1
IV,+,8366404,1.0,0.5,1,0,1,1,0,gene,D2096.3,0,8366523,0.960326,46,8366358,119,8366521,117,-2
IV,+,8366732,0.0,3.30872e-24,78,78,0,0,0,gene,D2096.3,0,8366735,0.960326,374,8366358,3,8366732,0,-3
IV,+,8379966,0.00715746,0.0,978,971,7,6,2,gene,D2096.2,0,8379971,3.86338,4613,8375353,5,8379972,6,1
IV,+,8380865,0.0434783,2.74181e-06,23,22,1,0,2,gene,D2096.2,0,8380985,3.86338,5512,8375353,120,8380865,0,-120
IV,+,8396481,0.0,1.16415e-10,33,33,0,0,0,gene,D2096.1,1,8396498,0.850313,14556,8381925,17,8396645,164,147
IV,+,8398845,0.439024,0.0919102,41,23,18,16,0,gene,M116.2,2,8398904,0.176845,913,8397932,59,8398845,0,-59
IV,+,8399229,0.0,0.5,1,1,0,0,24,gene,M116.2,2,8399259,0.176845,1297,8397932,30,8398996,-233,-263
IV,+,8433102,0.00278164,0.0,719,717,2,1,76,gene,T26A8.1,0,8433123,0.938297,4542,8428560,21,8433102,0,-21
IV,+,8447186,0.0,0.00195312,9,9,0,0,0,gene,T01B11.1,0,8447187,0.0274398,9204,8437982,1,8447186,0,-1
IV,+,8457262,0.00665188,0.0,451,448,3,2,3,gene,T01B11.3,0,8457262,0.45016,8241,8449021,0,8457263,1,1
IV,+,8477164,0.00193798,0.0,1548,1545,3,1,3,gene,C28C12.7,0,8477164,7.63084,1903,8475261,0,8477164,0,0
IV,+,8481646,0.000728863,0.0,1372,1371,1,1,6,gene,C28C12.5,0,8481647,2.99349,1008,8480638,1,8481646,0,-1
IV,+,8490203,0.0,1.57772e-30,99,99,0,0,3,gene,C28C12.3,0,8490256,1.42451,934,8489269,53,8490203,0,-53
IV,+,8492521,0.0,0.125,3,3,0,0,0,gene,C28C12.13,0,8492523,0.0114775,1652,8490869,2,8492524,3,1
IV,+,8499292,0.00538329,0.0,4644,4619,25,23,11,gene,C28C12.2,0,8499324,3.29051,4823,8494469,32,8499301,9,-23
IV,+,8511525,0.0,0.25,2,2,0,0,108,gene,C09G4.5,1,8511546,1.00745,8560,8502965,21,8511266,-259,-280
IV,+,8513399,0.0,0.0,511,511,0,0,170,gene,C09G4.4,2,8513404,1.54889,1,8513398,5,8513405,6,1
IV,+,8513903,0.00602929,0.0,3483,3462,21,19,19,gene,C09G4.3,3,8513931,4.47953,2,8513901,28,8513910,7,-21
IV,+,8520876,0.0,5.55112e-17,54,54,0,0,1,gene,C09G4.2,0,8520877,3.0223,6121,8514755,1,8520876,0,-1
IV,+,8535838,0.00156863,0.0,1275,1273,2,1,7,gene,C09G4.2,0,8535889,3.0223,3701,8532137,51,8535838,0,-51
IV,+,8540584,0.00961538,5.1276e-30,104,103,1,0,39,gene,C09G4.1,0,8540644,1.29696,2420,8538164,60,8540584,0,-60
IV,+,8540599,0.0,0.5,1,1,0,0,113,gene,C09G4.1,0,8540644,1.29696,2435,8538164,45,8540584,-15,-60
IV,+,8559416,0.0,1.16415e-10,33,33,0,0,1,gene,Y59H11AL.1,0,8559449,0.0936818,15030,8544386,33,8559416,0,-33
IV,+,8585895,0.0,0.125,3,3,0,0,1,gene,Y59H11AR.2,0,8585964,1.31241,14092,8571803,69,8585895,0,-69
IV,+,8589886,0.0,0.0,333,333,0,0,2,gene,Y59H11AR.2,0,8589900,1.31241,18083,8571803,14,8589886,0,-14
IV,+,8609223,0.0180723,8.40779e-45,166,163,3,3,2,gene,F42A9.6,0,8609226,0.657094,1403,8607820,3,8609476,253,250
IV,+,8609408,0.0,7.62939e-06,17,17,0,0,0,gene,F42A9.6,0,8609475,0.657094,1588,8607820,67,8609476,68,1
IV,+,8612561,0.0606061,6.14673e-08,33,31,2,2,0,gene,F42A9.5,0,8612561,0.134672,973,8611588,0,8612561,0,0
IV,+,8620665,0.0,0.0,197,197,0,0,0,gene,F42A9.2,0,8620743,0.648785,2494,8618171,78,8620665,0,-78
IV,+,8631322,0.397222,2.02363e-05,360,217,143,119,0,gene,F42A9.1,1,8631414,0.713071,3471,8627851,92,8631415,93,1
IV,+,8644714,0.761905,0.000334567,42,10,32,30,0,gene,C49C8.3,2,8644722,0.0719148,716,8643998,8,8644723,9,1
IV,+,8666181,0.00344828,0.0,290,289,1,1,0,gene,F08B4.3,0,8666233,0.324053,9370,8656811,52,8666234,53,1
IV,+,8668925,0.0,2.64698e-23,75,75,0,0,0,gene,F08B4.2,0,8668944,0.410362,1776,8667149,19,8669124,199,180
IV,+,8692070,0.00970874,1.01566e-29,103,102,1,1,1,gene,F08B4.1,0,8692090,0.353903,15479,8676591,20,8692081,11,-9
IV,+,8697686,0.25,0.25,4,3,1,1,1,gene,H23L24.3,0,8697711,0.0466428,1249,8696437,25,8697718,32,7
IV,+,8724002,0.0,1.90735e-06,19,19,0,0,1,gene,F21D5.9,0,8724029,0.285303,4802,8719200,27,8724002,0,-27
IV,+,8725704,0.0108932,0.0,459,454,5,5,0,gene,F21D5.1,1,8725705,1.45406,847,8724857,1,8725704,0,-1
IV,+,8728159,0.897619,0.0,420,43,377,287,0,gene,F21D5.2,2,8728189,1.18691,117,8728042,30,8728159,0,-30
IV,+,8730797,0.0,3.46945e-18,58,58,0,0,5,gene,F21D5.3,0,8730808,0.538679,305,8730492,11,8730797,0,-11
IV,+,8738056,0.0,0.5,1,1,0,0,6,gene,F21D5.4,0,8738070,0.191216,2378,8735678,14,8737843,-213,-227
IV,+,8738069,0.00854701,7.04168e-34,117,116,1,0,6,gene,F21D5.4,0,8738070,0.191216,2391,8735678,1,8737843,-226,-227
IV,+,8746236,0.00478469,0.0,836,832,4,3,0,gene,F20C5.1,0,8746273,0.662679,7033,8739203,37,8746236,0,-37
IV,+,8764849,0.00847458,3.55093e-34,118,117,1,0,0,gene,F20C5.4,0,8764861,0.27043,4369,8760480,12,8764862,13,1
IV,+,8816317,0.00134589,0.0,743,742,1,1,0,gene,T28C6.1,0,8816329,1.6313,48885,8767432,12,8816317,0,-12
IV,+,8820325,0.0,7.17465e-43,140,140,0,0,1,gene,T28C6.3,0,8820337,0.162225,933,8819392,12,8820338,13,1
IV,+,8827784,0.0238095,3.82623e-33,126,123,3,2,0,gene,T28C6.7,0,8827785,0.674564,1738,8826046,1,8827786,2,1
IV,+,8840701,0.0,3.00927e-36,118,118,0,0,2,gene,T11B7.1,0,8840706,0.154929,50,8840651,5,8840707,6,1
IV,+,8852482,0.0,0.0,275,275,0,0,0,gene,T11B7.4,0,8852495,2.15304,2831,8849651,13,8852482,0,-13
IV,+,8854517,0.0,2.52435e-29,95,95,0,0,3,gene,T11B7.4,0,8854527,2.15304,4866,8849651,10,8854519,2,-8
IV,+,8886510,0.0,8.27181e-25,80,80,0,0,1,gene,C09G9.5,0,8886551,0.138696,4113,8882397,41,8886510,0,-41
IV,+,8888958,0.00394011,0.0,2538,2528,10,10,72,gene,C09G9.6,1,8889067,2.43048,400,8888558,109,8888958,0,-109
IV,+,8888967,0.0416667,1.43051e-06,24,23,1,1,3315,gene,C09G9.6,1,8889067,2.43048,409,8888558,100,8888958,-9,-109
IV,+,8891450,0.701418,1.4013e-45,1199,358,841,670,6,gene,C27B7.1,2,8891456,1.54671,469,8890981,6,8891457,7,1
IV,+,8892840,0.930818,0.0,795,55,740,514,2,gene,C27B7.2,3,8892850,0.567991,111,8892729,10,8892840,0,-10
IV,+,8894065,0.05,2.91093e-40,180,171,9,8,0,gene,C27B7.4,0,8894087,0.800199,246,8893819,22,8894088,23,1
IV,+,8901628,0.0121766,0.0,657,649,8,8,13,gene,C27B7.5,0,8901642,0.774734,260,8901368,14,8901627,-1,-15
IV,+,8907031,0.0,4.33681e-19,61,61,0,0,0,gene,C27B7.7,0,8907127,0.101377,3872,8903159,96,8907029,-2,-98
IV,+,8926317,0.16,6.91494e-10,75,63,12,9,6,gene,D1046.1,1,8926321,1.75053,3414,8922903,4,8926317,0,-4
IV,+,8930424,0.969512,3.97548e-41,164,5,159,112,1,gene,D1046.3,2,8930424,0.408402,100,8930324,0,8930424,0,0
IV,+,8933932,0.0,0.0625,4,4,0,0,5,gene,D1046.4,0,8933947,0.0458057,1159,8932773,15,8933979,47,32
IV,+,8956470,0.0,0.0,157,157,0,0,0,gene,D1046.5,0,8956485,0.716439,19088,8937382,15,8956470,0,-15
IV,+,8975512,0.00487805,0.0,410,408,2,2,0,gene,C53B4.4,1,8975616,0.903551,4967,8970545,104,8975512,0,-104
IV,+,8984846,0.903846,1.28688e-18,104,10,94,57,0,gene,C53B4.6,2,8984851,0.315856,297,8984549,5,8984846,0,-5
IV,+,8987248,0.0,0.0,207,207,0,0,28,gene,C53B4.7,0,8987254,1.72117,494,8986754,6,8987248,0,-6
IV,+,8987593,0.0,0.25,2,2,0,0,6,gene,C53B4.7,0,8987613,1.72117,839,8986754,20,8987593,0,-20
IV,+,8988750,0.0,5.55112e-17,54,54,0,0,3,gene,C53B4.7,0,8988770,1.72117,1996,8986754,20,8988750,0,-20
IV,+,9010613,0.0,0.000488281,11,11,0,0,7,gene,C53D6.11,0,9010613,0.0950725,9864,9000749,0,9010564,-49,-49
IV,+,9016768,0.0,3.8147e-06,18,18,0,0,1,gene,C53D6.3,0,9017081,0.0261015,4450,9012318,313,9016768,0,-313
IV,+,9069990,0.0238095,9.54969e-12,42,41,1,1,3,gene,ZC410.1,0,9070051,0.26168,42414,9027576,61,9069990,0,-61
IV,+,9074653,0.0189873,1.76564e-42,158,155,3,1,1,gene,ZC410.2,0,9074656,0.762119,1063,9073590,3,9074653,0,-3
IV,+,9082341,0.0,3.38813e-21,68,68,0,0,0,gene,ZC410.4,0,9082342,0.388286,5792,9076549,1,9082343,2,1
IV,+,9096822,0.00524659,0.0,953,948,5,5,4,gene,C01F6.1,0,9096830,0.57119,4018,9092804,8,9096822,0,-8
IV,+,9104946,0.00201613,0.0,496,495,1,1,1,gene,C01F6.4,0,9105136,0.3116,3380,9101566,190,9104946,0,-190
IV,+,9108911,0.00938967,0.0,639,633,6,4,4,gene,C01F6.5,0,9108925,2.3009,1323,9107588,14,9108911,0,-14
IV,+,9119079,0.00407056,0.0,737,734,3,3,0,gene,C01F6.6,0,9119080,3.88569,9348,9109731,1,9119079,0,-1
IV,+,9120176,0.0,0.5,1,1,0,0,0,gene,C01F6.6,0,9120452,3.88569,10445,9109731,276,9120176,0,-276
IV,+,9127176,0.00242718,0.0,412,411,1,1,3,gene,C01F6.6,0,9127226,3.88569,17445,9109731,50,9127176,0,-50
IV,+,9147449,0.00634737,0.0,3466,3444,22,21,0,gene,F23B2.6,0,9147455,4.58344,1252,9146197,6,9147451,2,-4
IV,+,9184829,0.0,0.000976562,10,10,0,0,0,gene,C07C7.1,0,9185019,0.00970774,32804,9152025,190,9185044,215,25
IV,+,9194805,0.0,0.000976562,10,10,0,0,0,gene,C46C2.7,0,9194919,0.315101,8802,9186003,114,9194835,30,-84
IV,+,9195573,0.0,0.5,1,1,0,0,0,gene,C46C2.7,0,9195609,0.315101,9570,9186003,36,9195573,0,-36
IV,+,9200087,0.0123457,3.35008e-23,81,80,1,1,1,gene,C46C2.1,0,9200138,1.88272,4043,9196044,51,9200094,7,-44
IV,+,9200094,0.0,0.0,207,207,0,0,14,gene,C46C2.1,0,9200138,1.88272,4050,9196044,44,9200094,0,-44
IV,+,9213574,0.0,0.5,1,1,0,0,0,gene,C46C2.6,0,9213606,0.0248754,1364,9212210,32,9213611,37,5
IV,+,9216930,0.0,0.0078125,7,7,0,0,0,gene,C46C2.2,0,9216974,2.40342,2654,9214276,44,9216930,0,-44
IV,+,9217704,0.00597015,0.0,1340,1332,8,4,4,gene,C46C2.2,0,9217731,2.40342,584,9217120,27,9217704,0,-27
IV,+,9236511,0.0,0.0625,4,4,0,0,2,gene,Y11D7A.3,0,9236526,0.671429,8597,9227914,15,9236941,430,415
IV,+,9249503,0.0441176,9.02116e-32,136,130,6,5,0,gene,Y11D7A.7,0,9249506,0.493082,1389,9248114,3,9249507,4,1
IV,+,9270073,0.00680272,0.0,441,438,3,3,1,gene,Y11D7A.13,0,9270073,0.56411,16077,9253996,0,9270074,1,1
IV,+,9274516,0.0,0.125,3,3,0,0,23,gene,Y11D7A.14,0,9274523,0.175178,2604,9271912,7,9274456,-60,-67
IV,+,9316492,0.0,0.125,3,3,0,0,1,gene,F49C12.8,0,9316499,4.87508,9350,9307142,7,9316616,124,117
IV,+,9316616,0.00439422,0.0,1593,1586,7,6,8,gene,F49C12.8,0,9316619,4.87508,9474,9307142,3,9316616,0,-3
IV,+,9319357,0.887578,0.0,7374,829,6545,4315,4,gene,F49C12.11,0,9319368,16.1053,1164,9318193,11,9319357,0,-11
IV,+,9321778,0.0036846,0.0,2714,2704,10,7,1,gene,F49C12.13,0,9321783,11.2979,1657,9320121,5,9321778,0,-5
IV,+,9371485,0.0,6.10352e-05,14,14,0,0,2,gene,C10C5.2,0,9371485,0.0973005,32957,9338528,0,9371485,0,0
IV,+,9385095,0.0,3.85186e-34,111,111,0,0,0,gene,C10C5.7,0,9385102,0.835572,1949,9383146,7,9385103,8,1
IV,+,9385103,0.0,1.46937e-39,129,129,0,0,129,gene,C10C5.7,0,9385201,0.835572,1957,9383146,98,9385103,0,-98
IV,+,9386434,0.0153257,0.0,261,257,4,3,2,gene,C10C5.6,0,9386440,0.946717,744,9385690,6,9386434,0,-6
IV,+,9399630,0.0,7.45058e-09,27,27,0,0,2,gene,F56D5.3,0,9399674,0.0835705,4723,9394907,44,9399675,45,1
IV,+,9436687,0.0166667,5.20417e-17,60,59,1,1,0,gene,F59B8.1,0,9436692,0.140556,12295,9424392,5,9436687,0,-5
IV,+,9451317,0.0,4.33681e-19,61,61,0,0,2,gene,F38E11.3,0,9451341,0.303939,2268,9449049,24,9451317,0,-24
IV,+,9459697,0.0,0.03125,5,5,0,0,0,gene,F38E11.5,0,9459713,2.20835,6171,9453526,16,9459708,11,-5
IV,+,9459708,0.00566038,0.0,530,527,3,2,4,gene,F38E11.5,0,9459713,2.20835,6182,9453526,5,9459708,0,-5
IV,+,9488489,0.0,0.125,3,3,0,0,0,gene,C33A12.14,0,9488505,0.00597358,881,9487608,16,9488647,158,142
IV,+,9517119,0.0,0.000976562,10,10,0,0,56,gene,C33A12.19,0,9517168,0.496271,14575,9502544,49,9516974,-145,-194
IV,+,9526343,0.00841969,0.0,1544,1531,13,10,37,gene,F56H11.4,0,9526363,13.3695,7820,9518523,20,9526343,0,-20
IV,+,9540785,0.0,2.58494e-26,85,85,0,0,0,gene,F56H11.1,0,9540828,0.456477,9409,9531376,43,9540785,0,-43
IV,+,9615974,0.0,0.0,152,152,0,0,0,gene,W09C2.1,0,9615982,0.928605,17206,9598768,8,9615974,0,-8
IV,+,9615977,0.0,1.52588e-05,16,16,0,0,1,gene,W09C2.1,0,9615982,0.928605,17209,9598768,5,9615974,-3,-8
IV,+,9651623,0.0,0.00195312,9,9,0,0,5,gene,F58G6.9,0,9651660,0.709411,1144,9650479,37,9651661,38,1
IV,+,9651654,0.00454545,0.0,440,438,2,2,12,gene,F58G6.9,0,9651660,0.709411,1175,9650479,6,9651654,0,-6
IV,+,9653514,0.00238095,0.0,420,419,1,0,4,gene,F58G6.3,1,9653522,0.650171,1064,9652450,8,9653523,9,1
IV,+,9654294,0.903361,1.33873e-40,238,23,215,137,5,gene,F58G6.7,2,9654327,0.627524,95,9654199,33,9654294,0,-33
IV,+,9658030,0.0,0.00012207,13,13,0,0,0,gene,F58G6.4,0,9658041,0.0662238,2465,9655565,11,9658030,0,-11
IV,+,9690911,0.0,1.13687e-13,43,43,0,0,0,gene,ZK1251.7,0,9690920,0.0333703,1536,9689375,9,9690921,10,1
IV,+,9693157,0.0,0.0078125,7,7,0,0,0,gene,ZK1251.8,0,9693159,0.045301,1731,9691426,2,9693179,22,20
IV,+,9725226,0.008,2.93874e-36,125,124,1,0,0,gene,C28D4.9,1,9725254,0.469189,10364,9714862,28,9725226,0,-28
IV,+,9728651,0.954023,1.43845e-20,87,4,83,39,1,gene,C28D4.1,2,9728659,0.612041,100,9728551,8,9728651,0,-8
IV,+,9728656,0.943396,2.60081e-12,53,3,50,28,2,gene,C28D4.1,2,9728659,0.612041,105,9728551,3,9728651,-5,-8
IV,+,9757622,0.00125786,0.0,1590,1588,2,2,0,gene,H27C11.1,0,9757777,2.64448,18334,9739288,155,9757622,0,-155
IV,+,9760128,0.0,8.88178e-16,50,50,0,0,3,gene,H27C11.1,0,9760180,2.64448,20840,9739288,52,9760128,0,-52
IV,+,9761105,0.0,0.5,1,1,0,0,2,gene,H27C11.1,0,9761157,2.64448,21817,9739288,52,9761105,0,-52
IV,+,9772484,0.0026503,0.0,14338,14300,38,34,1,gene,T13F2.8,0,9772505,15.0394,2081,9770403,21,9772484,0,-21
IV,+,9778297,0.00666667,1.05097e-43,150,149,1,1,127,gene,T13F2.6,0,9778350,0.809756,4853,9773444,53,9778262,-35,-88
IV,+,9799404,0.0,6.10352e-05,14,14,0,0,8,gene,T13F2.1,0,9799444,5.28372,7471,9791933,40,9799404,0,-40
IV,+,9825668,0.0142349,0.0,281,277,4,1,0,gene,W08D2.7,0,9825672,0.886231,2541,9823127,4,9825672,4,0
IV,+,9855985,0.0,2.1684e-19,62,62,0,0,0,gene,K07F5.12,0,9855990,0.157736,2403,9853582,5,9855991,6,1
IV,+,9858461,0.0106789,0.0,1311,1297,14,13,1,gene,K07F5.13,1,9858464,1.09383,421,9858040,3,9858461,0,-3
IV,+,9862194,0.885906,1.4013e-45,298,34,264,191,2,gene,K07F5.14,2,9862196,0.531635,103,9862091,2,9862194,0,-2
IV,+,9864154,0.944805,0.0,308,17,291,144,0,gene,K07F5.16,3,9864167,0.578987,101,9864053,13,9864168,14,1
IV,+,9864164,1.0,7.62939e-06,17,0,17,13,703,gene,K07F5.16,3,9864167,0.578987,111,9864053,3,9864168,4,1
IV,+,9865051,0.949538,0.0,1625,82,1543,832,10,gene,K07F5.15,4,9865086,5.99447,95,9864956,35,9865051,0,-35
IV,+,9865105,1.0,0.5,1,0,1,0,3,gene,K07F5.15,4,9865110,5.99447,149,9864956,5,9865051,-54,-59
IV,+,9879301,0.0,6.01853e-36,117,117,0,0,0,gene,F32B6.1,0,9879305,0.408664,13181,9866120,4,9879301,0,-4
IV,+,9884542,0.00985222,0.0,609,603,6,5,2,gene,F32B6.2,0,9884564,1.48091,2368,9882174,22,9884542,0,-22
IV,+,9898984,0.0,2.98023e-08,25,25,0,0,0,gene,F32B6.8,0,9899062,1.39106,2864,9896120,78,9898984,0,-78
IV,+,9899536,0.00884956,0.0,226,224,2,2,336,gene,F32B6.8,0,9899548,1.39106,3416,9896120,12,9899536,0,-12
IV,+,9903880,0.0447761,3.24617e-16,67,64,3,2,1,gene,F32B6.9,0,9903883,0.389593,1409,9902471,3,9903884,4,1
IV,+,9916502,0.0,1.43493e-42,139,139,0,0,2,gene,F25H8.6,0,9916518,0.628838,10655,9905847,16,9916519,17,1
IV,+,9932282,0.0,7.27596e-12,37,37,0,0,37,gene,F25H8.2,0,9932324,0.776377,10346,9921936,42,9932207,-75,-117
IV,+,9978156,0.00282486,0.0,354,353,1,1,6,gene,C47E12.8,0,9978157,0.575778,2700,9975456,1,9978158,2,1
IV,+,9983262,0.0,0.015625,6,6,0,0,25,gene,C47E12.6,0,9983372,0.178331,2520,9980742,110,9983262,0,-110
IV,+,10003698,0.0170778,0.0,527,518,9,8,49,gene,C47E12.1,0,10003725,4.10806,14048,9989650,27,10003698,0,-27
IV,+,10009780,0.015625,3.46945e-18,64,63,1,0,0,gene,F44D12.1,0,10009787,0.399431,4223,10005557,7,10009938,158,151
IV,+,10009795,0.0,0.5,1,1,0,0,211,gene,F44D12.1,0,10009833,0.399431,4238,10005557,38,10009938,143,105
IV,+,10019235,0.0,0.0,159,159,0,0,0,gene,F44D12.9,0,10019238,0.249104,5061,10014174,3,10019235,0,-3
IV,+,10047370,0.0,1.38778e-17,56,56,0,0,0,gene,T04B2.3,0,10047379,0.334448,1695,10045675,9,10047380,10,1
IV,+,10048581,0.0,4.93038e-32,104,104,0,0,5,gene,T04B2.3,0,10048657,0.334448,2906,10045675,76,10048658,77,1
IV,+,10048818,0.0,0.5,1,1,0,0,72,gene,T04B2.3,0,10048861,0.334448,3143,10045675,43,10048658,-160,-203
IV,+,10067794,0.0,4.54747e-13,41,41,0,0,0,gene,W01B6.1,0,10067846,0.377198,17268,10050526,52,10067796,2,-50
IV,+,10086109,0.0109091,0.0,550,544,6,6,1,gene,W01B6.9,0,10086118,0.888131,3519,10082590,9,10086109,0,-9
IV,+,10097178,0.00268817,0.0,372,371,1,0,6,gene,C04G2.6,0,10097179,0.607283,1390,10095788,1,10097180,2,1
IV,+,10129329,0.00231481,0.0,432,431,1,1,365,gene,K08F4.3,0,10129364,2.20465,11277,10118052,35,10129246,-83,-118
IV,+,10129352,0.0,3.05176e-05,15,15,0,0,902,gene,K08F4.3,0,10129364,2.20465,11300,10118052,12,10129246,-106,-118
IV,+,10138081,0.0,7.45058e-09,27,27,0,0,2,gene,K08F4.12,0,10138094,0.0795454,4829,10133252,13,10138095,14,1
IV,+,10145220,0.00286123,0.0,699,697,2,1,0,gene,K08F4.9,0,10145221,1.61604,2152,10143068,1,10145220,0,-1
IV,+,10151920,0.0,2.38419e-07,22,22,0,0,5,gene,T14G10.5,0,10151951,2.69072,5729,10146191,31,10151920,0,-31
IV,+,10151974,0.0333333,2.79397e-08,30,29,1,0,3,gene,T14G10.5,0,10152004,2.69072,5783,10146191,30,10151920,-54,-84
IV,+,10152309,0.00122249,0.0,1636,1634,2,2,1,gene,T14G10.5,0,10152322,2.69072,6118,10146191,13,10152309,0,-13
IV,+,10156147,0.00892857,2.15704e-32,112,111,1,1,41,gene,T14G10.4,0,10156175,0.52537,541,10155606,28,10156094,-53,-81
IV,+,10156158,0.0,0.0,392,392,0,0,537,gene,T14G10.4,0,10156175,0.52537,552,10155606,17,10156094,-64,-81
IV,+,10158009,0.0951586,0.0,599,542,57,34,2,gene,T14G10.3,0,10158033,1.47486,1271,10156738,24,10158022,13,-11
IV,+,10161979,0.364537,6.08868e-17,908,577,331,244,0,gene,T14G10.1,0,10162000,1.25251,2765,10159214,21,10161979,0,-21
IV,+,10176651,0.0041653,0.0,42734,42556,178,150,5,gene,K04D7.1,1,10176680,87.1901,12291,10164360,29,10176651,0,-29
IV,+,10176654,0.00179147,0.0,11164,11144,20,16,1558,gene,K04D7.1,1,10176680,87.1901,12294,10164360,26,10176654,0,-26
IV,+,10177939,0.971154,0.0,208,6,202,148,1,gene,K04D7.2,2,10177940,0.90713,54,10177885,1,10177939,0,-1
IV,+,10177941,0.978261,1.22984e-36,138,3,135,94,1,gene,K04D7.2,2,10177953,0.90713,56,10177885,12,10177941,0,-12
IV,+,10180631,0.00667302,0.0,2098,2084,14,10,58,gene,K04D7.3,3,10180638,6.81372,330,10180301,7,10180631,0,-7
IV,+,10197790,0.00477327,0.0,419,417,2,1,0,gene,K04D7.5,0,10197790,0.467795,13859,10183931,0,10197791,1,1
IV,+,10243583,0.00179995,0.0,3889,3882,7,5,17,gene,F01G10.1,0,10243586,8.22271,17226,10226357,3,10243582,-1,-4
IV,+,10246131,0.0512821,1.34787e-09,39,37,2,2,2,gene,F01G10.10,0,10246132,0.301252,415,10245716,1,10246133,2,1
IV,+,10253588,0.00315457,0.0,317,316,1,1,1,gene,F01G10.8,0,10253636,0.616961,3832,10249756,48,10253588,0,-48
IV,+,10269854,0.00174825,0.0,1144,1142,2,2,3,gene,Y43C5A.2,0,10269870,3.33145,14039,10255815,16,10269854,0,-16
IV,+,10277237,0.0,5.82077e-11,34,34,0,0,0,gene,Y43C5A.7,0,10277248,1.00996,1859,10275378,11,10277333,96,85
IV,+,10286926,0.0060241,0.0,332,330,2,1,1,gene,R09E10.7,0,10286976,0.680935,7439,10279487,50,10286926,0,-50
IV,+,10353155,0.0,0.00195312,9,9,0,0,21,gene,Y43C5B.3,0,10353221,0.30732,60171,10292984,66,10353140,-15,-81
IV,+,10358089,0.0,7.10543e-15,47,47,0,0,33,gene,R11A8.2,0,10358117,0.626303,2997,10355092,28,10358057,-32,-60
IV,+,10358115,0.0017762,0.0,563,562,1,1,80,gene,R11A8.2,0,10358117,0.626303,3023,10355092,2,10358057,-58,-60
IV,+,10368437,0.0,0.0625,4,4,0,0,0,gene,R11A8.6,0,10368437,1.71419,5149,10363288,0,10368579,142,142
IV,+,10368579,0.00501672,0.0,598,595,3,3,5,gene,R11A8.6,0,10368586,1.71419,5291,10363288,7,10368579,0,-7
IV,+,10374879,0.00729927,0.0,274,272,2,2,4,gene,R11A8.7,1,10374917,1.14289,2056,10372823,38,10374918,39,1
IV,+,10381631,0.0,2.98023e-08,25,25,0,0,7,gene,R11A8.7,1,10381696,1.14289,8808,10372823,65,10381631,0,-65
IV,+,10387385,0.890323,0.0,775,85,690,466,8,gene,R10H10.1,2,10387388,1.34819,101,10387284,3,10387385,0,-3
IV,+,10403986,0.00980392,2.0116e-29,102,101,1,1,1,gene,R10H10.5,0,10403990,0.461931,10717,10393269,4,10403991,5,1
IV,+,10436668,0.0,0.03125,5,5,0,0,6,gene,F13B12.5,0,10436725,0.370202,27953,10408715,57,10436680,12,-45
IV,+,10436680,0.0,0.0,398,398,0,0,32,gene,F13B12.5,0,10436725,0.370202,27965,10408715,45,10436680,0,-45
IV,+,10469831,0.0,0.5,1,1,0,0,31,gene,F01D4.2,0,10469837,0.945978,2570,10467261,6,10469735,-96,-102
IV,+,10484082,0.00854701,7.04168e-34,117,116,1,1,1,gene,C02F4.1,0,10484085,0.370889,5942,10478140,3,10484082,0,-3
IV,+,10529465,0.0,3.00927e-36,118,118,0,0,4,gene,T07G12.1,0,10529478,0.529982,7846,10521619,13,10529479,14,1
IV,+,10533909,0.0,0.25,2,2,0,0,0,gene,T07G12.3,0,10533933,0.0968586,1022,10532887,24,10533889,-20,-44
IV,+,10533917,0.0,0.015625,6,6,0,0,0,gene,T07G12.3,0,10533933,0.0968586,1030,10532887,16,10533889,-28,-44
IV,+,10547060,0.0230769,2.62841e-34,130,127,3,3,0,gene,T07G12.6,1,10547069,0.333087,10639,10536421,9,10547060,0,-9
IV,+,10553328,0.0425532,7.68097e-12,47,45,2,2,0,gene,T07G12.8,3,10553383,0.36747,3412,10549916,55,10553388,60,5
IV,+,10555611,1.0,0.25,2,0,2,1,1,gene,T07G12.10,4,10555620,0.216462,198,10555413,9,10555621,10,1
IV,+,10555621,1.0,0.125,3,0,3,1,10,gene,T07G12.10,4,10555630,0.216462,208,10555413,9,10555621,0,-9
IV,+,10558693,0.5,0.375,4,2,2,1,0,gene,T07G12.11,5,10558702,0.162299,502,10558191,9,10558693,0,-9
IV,+,10561877,0.867257,1.74293e-16,113,15,98,86,2,gene,T07G12.12,6,10561885,0.387626,696,10561181,8,10561886,9,1
IV,+,10576322,0.00220264,0.0,454,453,1,0,5,gene,C43F9.8,0,10576349,1.14583,12378,10563944,27,10576322,0,-27
IV,+,10584500,0.0,0.25,2,2,0,0,0,gene,C43F9.10,0,10584508,0.00773016,2729,10581771,8,10584509,9,1
IV,+,10605232,0.0,8.88178e-16,50,50,0,0,0,gene,R09H10.2,0,10605247,0.107174,3408,10601824,15,10605248,16,1
IV,+,10606989,0.0,0.0,614,614,0,0,111,gene,R09H10.3,0,10607001,3.88147,183,10606806,12,10606992,3,-9
IV,+,10607843,0.0652174,2.15721e-10,46,43,3,3,3,gene,R09H10.3,0,10607850,3.88147,1037,10606806,7,10607844,1,-6
IV,+,10615401,0.0,0.0,344,344,0,0,0,gene,R09H10.4,0,10615472,0.519647,5576,10609825,71,10615473,72,1
IV,+,10620809,0.0,0.5,1,1,0,0,16,gene,R09H10.7,0,10620928,0.140536,674,10620135,119,10621165,356,237
IV,+,10656891,0.0,0.000488281,11,11,0,0,34,gene,K08C7.1,0,10656974,0.155613,14225,10642666,83,10656846,-45,-128
IV,+,10662019,0.0,0.0,210,210,0,0,153,gene,K08C7.2,0,10662085,0.942736,1273,10660746,66,10662019,0,-66
IV,+,10666508,0.0,0.000244141,12,12,0,0,0,gene,K08C7.3,0,10666702,1.28122,852,10665656,194,10666799,291,97
IV,+,10666799,0.0,1.88079e-37,122,122,0,0,2,gene,K08C7.3,0,10666804,1.28122,1143,10665656,5,10666799,0,-5
IV,+,10716620,0.00704225,2.547e-41,142,141,1,1,0,gene,ZC168.1,0,10716627,0.505033,9335,10707285,7,10716628,8,1
IV,+,10728480,1.0,0.5,1,0,1,1,4,gene,ZC168.2,0,10728543,0.173174,6753,10721727,63,10728544,64,1
IV,+,10735298,0.0,0.03125,5,5,0,0,11,gene,ZC168.4,0,10735427,6.50347,5736,10729562,129,10735296,-2,-131
IV,+,10735414,0.00194426,0.0,4629,4620,9,7,15,gene,ZC168.4,0,10735427,6.50347,5852,10729562,13,10735414,0,-13
IV,+,10737529,0.0,0.25,2,2,0,0,84,gene,ZC168.5,0,10737568,1.34069,382,10737147,39,10737449,-80,-119
IV,+,10744753,0.0,1.77636e-15,49,49,0,0,0,gene,T25B9.3,0,10744804,0.0931147,6592,10738161,51,10744753,0,-51
IV,+,10761670,0.0,0.000976562,10,10,0,0,79,gene,T25B9.7,0,10761694,0.177308,903,10760767,24,10761670,0,-24
IV,+,10769625,0.00502793,0.0,1790,1781,9,4,0,gene,T25B9.9,0,10769632,3.86761,3615,10766010,7,10769625,0,-7
IV,+,10790625,0.0035461,0.0,282,281,1,1,27,gene,C06G8.2,0,10790651,0.595272,12901,10777724,26,10790570,-55,-81
IV,+,10790642,0.0,5.42101e-20,64,64,0,0,512,gene,C06G8.2,0,10790651,0.595272,12918,10777724,9,10790570,-72,-81
IV,+,10799648,0.0,0.0,510,510,0,0,2,gene,C06G8.3,0,10799655,0.793438,5111,10794537,7,10799648,0,-7
IV,+,10812381,0.0,2.58494e-26,85,85,0,0,0,gene,R13.4,0,10812399,1.49416,10160,10802221,18,10812381,0,-18
IV,+,10858928,0.00339271,0.0,1179,1175,4,4,16,gene,T11G6.1,1,10858938,1.46707,24041,10834887,10,10858928,0,-10
IV,+,10859288,0.985507,1.16891e-19,69,1,68,51,1,gene,T11G6.1,1,10859291,1.46707,24401,10834887,3,10859288,0,-3
IV,+,10861373,0.89384,0.0,763,81,682,452,3,gene,T11G6.8,2,10861383,2.78198,118,10861255,10,10861373,0,-10
IV,+,10861442,1.0,0.5,1,0,1,1,205,gene,T11G6.8,2,10861463,2.78198,187,10861255,21,10861373,-69,-90
IV,+,10864302,0.971429,4.62125e-27,105,3,102,64,1,gene,F13E9.1,3,10864337,0.447714,104,10864198,35,10864302,0,-35
IV,+,10864323,1.0,0.5,1,0,1,0,195,gene,F13E9.1,3,10864337,0.447714,125,10864198,14,10864302,-21,-35
IV,+,10881522,0.0333333,1.53523e-15,60,58,2,2,1,gene,F13E9.13,0,10881526,0.103536,835,10880687,4,10881527,5,1
IV,+,10909885,0.0,8.07794e-28,90,90,0,0,2,gene,ZK593.1,0,10909915,1.31439,8529,10901356,30,10909885,0,-30
IV,+,10913318,0.0,0.00012207,13,13,0,0,15,gene,ZK593.2,0,10913350,0.538545,270,10913048,32,10913331,13,-19
IV,+,10913333,0.00581395,0.0,172,171,1,1,73,gene,ZK593.2,0,10913350,0.538545,285,10913048,17,10913331,-2,-19
IV,+,10916569,0.0,0.0,273,273,0,0,0,gene,ZK593.3,0,10916584,0.980288,2051,10914518,15,10916585,16,1
IV,+,10920047,0.0,0.0,553,553,0,0,0,gene,ZK593.4,0,10920051,0.829732,2358,10917689,4,10920077,30,26
IV,+,10933472,0.0038999,0.0,3077,3065,12,12,2,gene,ZK593.7,0,10933496,3.81909,6688,10926784,24,10933472,0,-24
IV,+,10937424,0.00943396,0.0,424,420,4,3,5,gene,ZK593.8,0,10937436,0.648398,3248,10934176,12,10937424,0,-12
IV,+,10982038,0.00498753,0.0,401,399,2,0,0,gene,Y43E12A.2,0,10982038,1.43526,13902,10968136,0,10982038,0,0
IV,+,10987872,1.0,0.25,2,0,2,2,3,gene,Y43E12A.3,0,10987877,0.0287047,495,10987377,5,10987876,4,-1
IV,+,10990969,0.0,0.000244141,12,12,0,0,0,gene,F13H10.5,0,10990990,0.205229,1777,10989192,21,10991009,40,19
IV,+,11001902,0.0,1.88079e-37,122,122,0,0,0,gene,F13H10.9,0,11001962,0.0882402,7771,10994131,60,11002089,187,127
IV,+,11004543,0.0,2.32831e-10,32,32,0,0,0,gene,F13H10.1,0,11004554,0.163295,686,11003857,11,11004555,12,1
IV,+,11004550,0.0,1.81899e-12,39,39,0,0,1,gene,F13H10.1,0,11004554,0.163295,693,11003857,4,11004555,5,1
IV,+,11004610,0.0,0.5,1,1,0,0,17,gene,F13H10.1,0,11004613,0.163295,753,11003857,3,11004555,-55,-58
IV,+,11009266,0.00309162,0.0,7116,7094,22,15,3,gene,F13H10.6,0,11009277,9.38818,4160,11005106,11,11009264,-2,-13
IV,+,11020487,0.00543652,0.0,3127,3110,17,15,27,gene,F13H10.8,0,11020494,5.89084,10394,11010093,7,11020452,-35,-42
IV,+,11022573,0.0460405,0.0,543,518,25,21,2,gene,F36H1.6,0,11022574,1.41574,1208,11021365,1,11022573,0,-1
IV,+,11032564,0.0,0.00012207,13,13,0,0,3,gene,F36H1.10,0,11032659,0.16245,6723,11025841,95,11032564,0,-95
IV,+,11032660,0.0,3.72529e-09,28,28,0,0,6,gene,F36H1.10,0,11032665,0.16245,6819,11025841,5,11032564,-96,-101
IV,+,11033158,0.0,0.5,1,1,0,0,1,gene,F36H1.10,0,11033189,0.16245,7317,11025841,31,11033158,0,-31
IV,+,11036552,0.00296248,0.0,6076,6058,18,13,28,gene,F36H1.1,0,11036555,8.55684,2983,11033569,3,11036552,0,-3
IV,+,11038632,0.0193548,1.33277e-41,155,152,3,2,1,gene,F36H1.2,0,11038740,0.590833,506,11038126,108,11038632,0,-108
IV,+,11049144,0.00584795,0.0,171,170,1,1,2,gene,F36H1.11,0,11049156,0.522712,1752,11047392,12,11049157,13,1
IV,+,11054282,0.00268097,0.0,373,372,1,1,0,gene,F36H1.4,0,11054327,3.68184,1814,11052468,45,11054282,0,-45
IV,+,11057642,0.0,3.05176e-05,15,15,0,0,0,gene,F36H1.4,0,11057682,3.68184,5174,11052468,40,11057642,0,-40
IV,+,11084077,0.00768246,0.0,781,775,6,6,10,gene,M7.2,0,11084099,0.976046,19848,11064229,22,11084077,0,-22
IV,+,11113011,0.0,9.53674e-07,20,20,0,0,7,gene,T05E11.2,0,11113214,0.266385,21182,11091829,203,11112971,-40,-243
IV,+,11113063,0.0,0.00390625,8,8,0,0,4,gene,T05E11.2,0,11113214,0.266385,21234,11091829,151,11112971,-92,-243
IV,+,11125996,0.0143885,0.0,278,274,4,3,0,gene,F01G4.1,1,11126045,2.47157,2011,11123985,49,11125996,0,-49
IV,+,11131251,0.540193,4.43273e-05,1866,858,1008,662,0,gene,F01G4.2,2,11131264,4.22132,45,11131206,13,11131251,0,-13
IV,+,11143317,0.0,1.17549e-38,126,126,0,0,0,gene,F01G4.4,0,11143321,0.533801,9538,11133779,4,11143317,0,-4
IV,+,11150085,0.00141643,0.0,5648,5640,8,8,16,gene,C08F8.1,1,11150086,5.73084,4096,11145989,1,11149826,-259,-260
IV,+,11150969,0.993671,0.0,158,1,157,108,9,gene,C08F8.2,2,11151018,0.411341,67,11150902,49,11150969,0,-49
IV,+,11155021,0.00305499,0.0,982,979,3,3,24,gene,C08F8.3,0,11155033,0.748268,715,11154306,12,11155001,-20,-32
IV,+,11177246,0.0,0.0,234,234,0,0,1,gene,C08F8.7,0,11177257,0.248833,2491,11174755,11,11177258,12,1
IV,+,11179617,0.0204778,0.0,293,287,6,5,0,gene,R07H5.2,1,11179668,2.16626,1523,11178094,51,11179617,0,-51
IV,+,11179654,0.0,0.125,3,3,0,0,155,gene,R07H5.2,1,11179668,2.16626,1560,11178094,14,11179617,-37,-51
IV,+,11180370,0.0,2.84217e-14,45,45,0,0,10,gene,R07H5.2,1,11180400,2.16626,2276,11178094,30,11180370,0,-30
IV,+,11183104,0.644628,0.000445033,121,43,78,53,15,gene,R07H5.1,2,11183116,1.49924,131,11182973,12,11183110,6,-6
IV,+,11183110,0.775926,6.69909e-40,540,121,419,296,183,gene,R07H5.1,2,11183116,1.49924,137,11182973,6,11183110,0,-6
IV,+,11184263,0.949468,0.0,376,19,357,243,3,gene,R07H5.3,3,11184267,0.603647,94,11184169,4,11184263,0,-4
IV,+,11184954,0.625,0.21875,8,3,5,3,0,gene,R07H5.3,3,11184962,0.603647,415,11184539,8,11184954,0,-8
IV,+,11202741,0.0,0.25,2,2,0,0,0,gene,R07H5.11,0,11202782,0.10966,14500,11188241,41,11202741,0,-41
IV,+,11273422,0.0,2.38419e-07,22,22,0,0,0,gene,F54D1.5,0,11273437,0.0585363,9087,11264335,15,11273466,44,29
IV,+,11287782,0.00582524,0.0,515,512,3,3,1,gene,F54D1.6,0,11287787,1.04556,5824,11281958,5,11287782,0,-5
IV,+,11299007,0.0,0.0,789,789,0,0,10,gene,B0035.14,0,11299013,1.41326,4212,11294795,6,11299007,0,-6
IV,+,11310943,0.003125,0.0,320,319,1,0,6,gene,B0035.1,0,11310970,3.1603,6160,11304783,27,11310943,0,-27
IV,+,11315178,0.003367,0.0,4455,4440,15,10,281,gene,B0035.4,1,11315178,4.7472,2661,11312517,0,11315178,0,0
IV,+,11317390,0.30236,7.57796e-26,678,473,205,154,0,gene,B0035.5,2,11317391,1.05507,1543,11315847,1,11317390,0,-1
IV,+,11320289,0.0163551,0.0,856,842,14,12,3,gene,B0035.18,3,11320290,1.59468,367,11319922,1,11320291,2,1
IV,+,11320771,0.923729,4.2039e-45,236,18,218,182,1,gene,B0035.6,4,11320776,0.612861,103,11320668,5,11320771,0,-5
IV,+,11354385,0.0148515,0.0,202,199,3,2,0,gene,T01G1.2,0,11354406,0.913091,12191,11342194,21,11354407,22,1
IV,+,11372962,0.00698451,0.0,3293,3270,23,23,6,gene,H02I12.1,0,11372964,6.38878,17590,11355372,2,11372962,0,-2
IV,+,11394514,0.0,0.0,187,187,0,0,1,gene,H02I12.3,0,11394524,0.0872817,16916,11377598,10,11394525,11,1
IV,+,11403932,0.0,0.0078125,7,7,0,0,0,gene,H02I12.8,0,11403942,0.22793,2486,11401446,10,11403932,0,-10
IV,+,11410206,0.0,0.00195312,9,9,0,0,0,gene,F22B3.4,0,11410219,2.40979,2808,11407398,13,11410456,250,237
IV,+,11410456,0.00302725,0.0,991,988,3,3,0,gene,F22B3.4,0,11410483,2.40979,3058,11407398,27,11410456,0,-27
IV,+,11430211,0.0555556,6.86646e-05,18,17,1,1,0,gene,F22B3.9,0,11430247,0.0349766,17240,11412971,36,11430248,37,1
IV,+,11436513,0.00283286,0.0,353,352,1,1,1,gene,C10C6.1,0,11436617,1.42467,23542,11412971,104,11436618,105,1
IV,+,11459955,0.0,5.16988e-26,84,84,0,0,0,gene,C10C6.2,0,11459962,0.137835,12927,11447028,7,11459963,8,1
IV,+,11468367,0.0,0.0625,4,4,0,0,0,gene,C10C6.9,0,11468372,None,5200,11463167,5,11467987,-380,-385
IV,+,11470407,0.0,1.32349e-23,76,76,0,0,37,gene,C10C6.5,0,11470420,0.561913,1657,11468750,13,11470407,0,-13
IV,+,11480817,0.0141509,0.0,212,209,3,3,3,gene,H21P03.2,0,11480823,0.553878,7427,11473390,6,11480824,7,1
IV,+,11504737,0.0,2.71051e-20,65,65,0,0,2,gene,M04B2.5,0,11504746,0.151909,2832,11501905,9,11504747,10,1
IV,+,11521261,0.0143369,0.0,558,550,8,7,4,gene,M04B2.3,0,11521271,0.654595,11567,11509694,10,11521272,11,1
IV,+,11524613,0.0703408,0.0,1379,1282,97,76,7,gene,M04B2.1,1,11524613,2.95974,2434,11522179,0,11524613,0,0
IV,+,11528023,0.884956,3.69712e-18,113,13,100,73,3,gene,M04B2.2,2,11528026,0.251146,98,11527925,3,11528027,4,1
IV,+,11570470,0.00123229,0.0,1623,1621,2,1,0,gene,F12F6.5,1,11570512,1.87425,39865,11530605,42,11570482,12,-30
IV,+,11578762,0.9875,6.61744e-23,80,1,79,58,7,gene,F12F6.3,2,11578771,0.491755,94,11578668,9,11578761,-1,-10
IV,+,11585194,0.146186,0.0,1416,1209,207,166,0,gene,F12F6.1,3,11585194,1.53051,1121,11584073,0,11585194,0,0
IV,+,11594216,0.0,0.0,622,622,0,0,5,gene,F40F11.2,0,11594263,1.23982,5926,11588290,47,11594295,79,32
IV,+,11602611,0.00677509,0.0,60073,59666,407,241,0,gene,F40F11.1,0,11602621,152.15,952,11601659,10,11602610,-1,-11
IV,+,11605231,0.0,0.00012207,13,13,0,0,3,gene,Y24F12A.1,0,11605277,0.59592,1984,11603247,46,11605278,47,1
IV,+,11605276,0.0015361,0.0,651,650,1,1,12,gene,Y24F12A.1,0,11605277,0.59592,2029,11603247,1,11605278,2,1
IV,+,11636618,0.00733496,0.0,409,406,3,3,1,gene,F58B3.6,1,11636634,1.97557,29124,11607494,16,11636618,0,-16
IV,+,11638286,0.862486,0.0,909,125,784,603,3,gene,F58B3.7,2,11638288,0.398561,110,11638176,2,11638286,0,-2
IV,+,11652373,0.00688765,0.0,2323,2307,16,13,0,gene,ZK809.3,0,11652378,6.42488,5587,11646786,5,11652373,0,-5
IV,+,11656707,0.00641026,1.4013e-45,156,155,1,1,0,gene,ZK809.5,1,11656718,0.526551,3265,11653442,11,11656707,0,-11
IV,+,11659544,0.837209,1.08004e-15,129,21,108,61,4,gene,ZK792.1,2,11659573,0.516741,149,11659395,29,11659770,226,197
IV,+,11659814,0.651042,8.23646e-06,192,67,125,56,4,gene,ZK792.1,2,11659882,0.516741,101,11659713,68,11659814,0,-68
IV,+,11659825,1.0,0.25,2,0,2,2,279,gene,ZK792.1,2,11659882,0.516741,112,11659713,57,11659814,-11,-68
IV,+,11668000,0.880952,1.9342e-07,42,5,37,13,9,gene,ZK792.8,3,11668006,0.250778,109,11667891,6,11668005,5,-1
IV,+,11673814,0.00106045,0.0,943,942,1,1,63,gene,ZK792.2,0,11673842,0.627579,2342,11671472,28,11673814,0,-28
IV,+,11676324,0.00395257,0.0,253,252,1,1,0,gene,ZK792.3,0,11676353,0.220688,719,11675605,29,11676354,30,1
IV,+,11694470,0.0,5.82077e-11,34,34,0,0,46,gene,ZK792.7,0,11694519,0.199907,16077,11678393,49,11694383,-87,-136
IV,+,11715011,0.0,0.0,358,358,0,0,0,gene,K01A6.2,0,11715039,0.967713,6782,11708229,28,11715060,49,21
IV,+,11735295,0.0,0.03125,5,5,0,0,6,gene,K01A6.6,0,11735338,0.0424604,6045,11729250,43,11735295,0,-43
IV,+,11745631,0.00735294,1.5612e-39,136,135,1,1,4,gene,T12A7.1,0,11745645,0.27889,1854,11743777,14,11745646,15,1
IV,+,11749190,0.0,1.90735e-06,19,19,0,0,50,gene,T12A7.6,1,11749210,0.163736,531,11748659,20,11749190,0,-20
IV,+,11751545,1.0,0.5,1,0,1,0,0,gene,T12A7.7,2,11751569,0.00934516,554,11750991,24,11751842,297,273
IV,+,11813773,0.0,1.43493e-42,139,139,0,0,0,gene,M117.1,0,11813856,0.579621,26832,11786941,83,11814215,442,359
IV,+,11814217,0.0,1.97215e-31,102,102,0,0,4,gene,M117.1,0,11814290,0.579621,27276,11786941,73,11814217,0,-73
IV,+,11828388,0.0,0.125,3,3,0,0,5,gene,M117.5,0,11828483,None,4480,11823908,95,11828943,555,460
IV,+,11828921,0.0,5.82077e-11,34,34,0,0,2,gene,M117.5,0,11828942,None,5013,11823908,21,11828943,22,1
IV,+,11829421,0.0,0.25,2,2,0,0,3,gene,M117.5,0,11829611,None,5513,11823908,190,11828943,-478,-668
IV,+,11834282,0.0,3.05176e-05,15,15,0,0,2,gene,M117.7,0,11834357,None,3591,11830691,75,11834357,75,0
IV,+,11838928,0.0,8.88178e-16,50,50,0,0,8,gene,F38H4.2,0,11838949,0.0629387,4324,11834604,21,11838950,22,1
IV,+,11844412,0.0,4.33681e-19,61,61,0,0,3,gene,F38H4.3,0,11844416,0.105515,4019,11840393,4,11844417,5,1
IV,+,11858412,0.00597015,0.0,2010,1998,12,10,5,gene,F38H4.9,1,11858415,6.28138,4412,11854000,3,11858412,0,-3
IV,+,11860131,1.0,0.03125,5,0,5,2,1370,gene,F38H4.10,2,11860288,1.22258,6,11860125,157,11860525,394,237
IV,+,11860525,0.798495,0.0,1196,241,955,726,5,gene,F38H4.10,2,11860527,1.22258,97,11860428,2,11860525,0,-2
IV,+,11864502,0.0,1.49012e-08,26,26,0,0,0,gene,C29E6.2,0,11864516,0.145531,2034,11862468,14,11864517,15,1
IV,+,11885585,0.010101,0.0,198,196,2,0,0,gene,C29E6.1,0,11885587,0.565114,2151,11883434,2,11885585,0,-2
IV,+,11899632,0.0,0.0,163,163,0,0,1,gene,C29E6.5,0,11899698,0.435236,8583,11891049,66,11899653,21,-45
IV,+,11911059,0.0,0.25,2,2,0,0,0,gene,VZK822L.2,0,11911159,0.184092,8179,11902880,100,11911621,562,462
IV,+,11911999,0.0131579,1.00585e-21,76,75,1,1,23,gene,VZK822L.2,0,11912051,0.184092,9119,11902880,52,11911621,-378,-430
IV,+,11930842,0.0166667,5.20417e-17,60,59,1,0,0,gene,ZK822.3,0,11930844,0.407859,2443,11928399,2,11930842,0,-2
IV,+,11932451,0.0,0.5,1,1,0,0,5,gene,ZK822.3,0,11932472,0.407859,4052,11928399,21,11932451,0,-21
IV,+,11932832,0.0,0.0625,4,4,0,0,1,gene,ZK822.3,0,11932842,0.407859,4433,11928399,10,11932832,0,-10
IV,+,11937388,0.0,2.58494e-26,85,85,0,0,4,gene,ZK822.5,0,11937388,0.433298,1700,11935688,0,11937388,0,0
IV,+,11950567,0.0144928,1.16891e-19,69,68,1,0,1,gene,ZK829.5,0,11950573,0.149115,9993,11940574,6,11950565,-2,-8
IV,+,11953219,0.00500751,0.0,1997,1987,10,7,3,gene,ZK829.4,0,11953221,23.7083,1045,11952174,2,11953219,0,-2
IV,+,11970510,0.0014245,0.0,1404,1402,2,2,1,gene,ZK829.9,0,11970706,1.11539,15001,11955509,196,11970504,-6,-202
IV,+,12031295,0.00658514,0.0,1063,1056,7,7,47,gene,T12G3.5,0,12031297,2.86772,17280,12014015,2,12031295,0,-2
IV,+,12034253,0.00448682,0.0,1783,1775,8,4,39,gene,T12G3.1,0,12034282,4.82952,2128,12032125,29,12034253,0,-29
IV,+,12048227,0.00591716,0.0,338,336,2,2,28,gene,T12G3.4,0,12048238,0.40981,11363,12036864,11,12048239,12,1
IV,+,12048233,0.0,7.10543e-15,47,47,0,0,101,gene,T12G3.4,0,12048238,0.40981,11369,12036864,5,12048239,6,1
IV,+,12051462,0.0135501,0.0,369,364,5,5,0,gene,K08E4.1,0,12051467,1.92462,1428,12050034,5,12051457,-5,-10
IV,+,12057717,0.246154,1.91537e-09,130,98,32,30,44,gene,K08E4.3,0,12057718,0.472766,1941,12055776,1,12057509,-208,-209
IV,+,12071524,0.0,3.8147e-06,18,18,0,0,0,gene,K08E4.5,0,12071528,0.0268502,11600,12059924,4,12071522,-2,-6
IV,+,12079436,0.0,3.58732e-43,141,141,0,0,1,gene,F11A10.1,1,12079445,1.38701,2516,12076920,9,12079444,8,-1
IV,+,12079444,0.0170648,0.0,293,288,5,5,200,gene,F11A10.1,1,12079445,1.38701,2524,12076920,1,12079444,0,-1
IV,+,12084449,0.962441,0.0,852,32,820,538,0,gene,F11A10.2,2,12084509,1.97736,120,12084329,60,12084449,0,-60
IV,+,12085394,0.964206,0.0,447,16,431,247,6,gene,F11A10.7,3,12085628,1.14766,107,12085287,234,12085394,0,-234
IV,+,12094342,0.00849257,0.0,471,467,4,4,8,gene,F11A10.5,1,12094346,1.09772,7348,12086994,4,12094342,0,-4
IV,+,12096749,0.953333,2.06068e-34,150,7,143,92,0,gene,F11A10.4,2,12096750,0.72567,94,12096655,1,12096749,0,-1
IV,+,12105828,0.929204,4.92767e-23,113,8,105,83,0,gene,M18.3,3,12105828,0.37594,99,12105729,0,12105828,0,0
IV,+,12121363,0.0,0.03125,5,5,0,0,451,gene,M18.6,1,12121368,0.540825,13000,12108363,5,12121347,-16,-21
IV,+,12123259,0.170037,0.0,1088,903,185,135,1,gene,M18.7,2,12123283,3.97003,408,12122851,24,12123259,0,-24
IV,+,12124922,0.949206,0.0,315,16,299,218,2,gene,M18.8,3,12124999,0.924683,151,12124771,77,12124922,0,-77
IV,+,12129474,0.00272109,0.0,735,733,2,2,0,gene,B0001.1,0,12129476,1.65911,2719,12126755,2,12129474,0,-2
IV,+,12159440,0.0,0.0,321,321,0,0,0,gene,B0001.6,0,12159449,2.27345,24374,12135066,9,12159440,0,-9
IV,+,12168214,0.0,1.2326e-32,106,106,0,0,0,gene,F20B10.3,0,12168219,0.385467,3977,12164237,5,12168214,0,-5
IV,+,12203219,0.00643974,0.0,1087,1080,7,7,21,gene,F35G2.1,0,12203219,2.62014,34033,12169186,0,12203219,0,0
IV,+,12205208,0.0,0.0625,4,4,0,0,1,gene,F35G2.1,0,12205283,2.62014,36022,12169186,75,12205208,0,-75
IV,+,12209473,0.0,0.25,2,2,0,0,4,gene,F35G2.3,0,12209501,0.0836369,1527,12207946,28,12209678,205,177
IV,+,12209658,0.0,4.44089e-16,51,51,0,0,9,gene,F35G2.3,0,12209665,0.0836369,1712,12207946,7,12209678,20,13
IV,+,12268965,0.00560237,0.0,42482,42244,238,219,20,gene,C42C1.14,0,12268971,130.595,46101,12222864,6,12268965,0,-6
IV,+,12278878,0.0,3.8147e-06,18,18,0,0,7,gene,C42C1.13,1,12278890,0.399221,9201,12269677,12,12278874,-4,-16
IV,+,12279630,0.765258,1.25641e-15,213,50,163,119,16,gene,C42C1.11,2,12279632,0.705741,115,12279515,2,12279630,0,-2
IV,+,12283144,0.00486224,0.0,617,614,3,3,11,gene,C42C1.10,1,12283154,0.638375,1247,12281897,10,12283144,0,-10
IV,+,12285164,0.0,0.5,1,1,0,0,5,gene,C42C1.16,2,12285181,0.366724,72,12285092,17,12285383,219,202
IV,+,12285230,0.875,0.03125,8,1,7,5,62,gene,C42C1.16,2,12285272,0.366724,138,12285092,42,12285383,153,111
IV,+,12287898,0.840125,4.35188e-37,319,51,268,204,3,gene,C42C1.15,3,12287899,0.390039,94,12287804,1,12287898,0,-1
IV,+,12287953,1.0,0.125,3,0,3,0,39,gene,C42C1.15,3,12287981,0.390039,149,12287804,28,12287898,-55,-83
IV,+,12291016,0.00277008,0.0,361,360,1,1,1,gene,C42C1.8,0,12291021,0.67512,52,12290964,5,12291016,0,-5
IV,+,12337137,0.0,0.0078125,7,7,0,0,7,gene,F19B6.4,0,12337162,0.106295,8266,12328871,25,12337550,413,388
IV,+,12349914,0.0178571,7.77156e-16,56,55,1,1,1,gene,ZC518.1,0,12349940,0.40029,9488,12340426,26,12349914,0,-26
IV,+,12361512,0.00404313,0.0,742,739,3,3,1,gene,ZC518.3,0,12361593,4.00817,5820,12355692,81,12361538,26,-55
IV,+,12361993,0.0,0.0,178,178,0,0,13,gene,ZC518.3,0,12362013,4.00817,6301,12355692,20,12361996,3,-17
IV,+,12363007,0.0,3.8147e-06,18,18,0,0,1,gene,ZC518.3,0,12363008,4.00817,7315,12355692,1,12363007,0,-1
IV,+,12372221,0.0113895,0.0,439,434,5,3,3,gene,F28D1.1,0,12372222,1.05666,408,12371813,1,12372221,0,-1
IV,+,12380063,0.00735294,1.5612e-39,136,135,1,1,0,gene,F28D1.3,0,12380071,0.100925,4381,12375682,8,12380072,9,1
IV,+,12381558,0.0,0.03125,5,5,0,0,1,gene,F28D1.4,0,12381559,0.0741249,733,12380825,1,12381560,2,1
IV,+,12383138,0.00305694,0.0,2617,2609,8,8,16,gene,F28D1.5,0,12383139,0.746313,813,12382325,1,12383140,2,1
IV,+,12391561,0.00810742,0.0,3947,3915,32,26,4,gene,F28D1.11,0,12391561,6.38895,7619,12383942,0,12391562,1,1
IV,+,12404399,0.0,2.58494e-26,85,85,0,0,198,gene,F28D1.10,0,12404402,0.691011,12309,12392090,3,12404399,0,-3
IV,+,12408893,0.00831025,0.0,361,358,3,3,15,gene,F08G5.1,0,12408902,0.784973,236,12408657,9,12408863,-30,-39
IV,+,12408902,0.0,0.125,3,3,0,0,111,gene,F08G5.1,0,12408902,0.784973,245,12408657,0,12408863,-39,-39
IV,+,12408921,0.0,1.17549e-38,126,126,0,0,182,gene,F08G5.1,0,12408993,0.784973,264,12408657,72,12408863,-58,-130
IV,+,12425186,0.0119048,4.3427e-24,84,83,1,1,0,gene,F08G5.5,0,12425197,0.184724,13000,12412186,11,12425186,0,-11
IV,+,12468635,0.00972447,0.0,617,611,6,5,0,gene,C25G4.10,0,12468639,1.24538,10060,12458575,4,12468640,5,1
IV,+,12490761,0.00847458,3.55093e-34,118,117,1,1,0,gene,T04A11.6,0,12490767,0.27081,1173,12489588,6,12490761,0,-6
IV,+,12505658,0.0,0.5,1,1,0,0,0,gene,T04A11.10,0,12505666,0.000224947,2047,12503611,8,12505667,9,1
IV,+,12513075,1.0,0.5,1,0,1,1,0,gene,F53B2.7,0,12513076,None,3802,12509273,1,12513139,64,63
IV,+,12513101,0.463415,0.11126,41,22,19,19,163739,gene,F53B2.7,0,12513138,None,3828,12509273,37,12513139,38,1
IV,+,12542004,0.0,1.11022e-16,53,53,0,0,0,gene,F53B2.6,0,12542185,1.02732,26969,12515035,181,12542004,0,-181
IV,+,12548100,0.0434783,1.47082e-11,46,44,2,0,1,gene,ZK795.1,0,12548101,0.22721,2398,12545702,1,12548102,2,1
IV,+,12559335,0.0144928,0.0,207,204,3,3,2,gene,ZK795.3,1,12559335,1.58511,4871,12554464,0,12559335,0,0
IV,+,12567806,0.0,0.000244141,12,12,0,0,1,gene,K08E7.3,0,12567825,0.343333,6583,12561223,19,12567826,20,1
IV,+,12567812,0.571429,0.273438,7,3,4,4,153,gene,K08E7.3,0,12567825,0.343333,6589,12561223,13,12567826,14,1
IV,+,12573339,0.0,2.71051e-20,65,65,0,0,5,gene,K08E7.5,0,12573349,0.245057,2724,12570615,10,12573339,0,-10
IV,+,12573417,0.0,0.25,2,2,0,0,9,gene,K08E7.5,0,12573467,0.245057,2802,12570615,50,12573473,56,6
IV,+,12640428,0.0114286,0.0,175,173,2,2,0,gene,C26H9A.1,0,12640431,0.444742,61589,12578839,3,12640432,4,1
IV,+,12653373,0.0,2.93874e-39,128,128,0,0,0,gene,C26H9A.2,1,12653433,0.277914,2751,12650622,60,12653459,86,26
IV,+,12675177,0.449102,0.0260466,167,92,75,41,0,gene,T23B5.4,2,12675185,0.438087,446,12674731,8,12675186,9,1
IV,+,12675184,0.5,0.122386,42,21,21,11,59,gene,T23B5.4,2,12675185,0.438087,453,12674731,1,12675186,2,1
IV,+,12688627,0.00378788,0.0,264,263,1,1,0,gene,T23B5.3,1,12688639,1.66318,12657,12675970,12,12688640,13,1
IV,+,12691918,0.0,1.42109e-14,46,46,0,0,0,gene,T23B5.3,1,12691959,1.66318,15948,12675970,41,12691918,0,-41
IV,+,12696834,0.0,6.10352e-05,14,14,0,0,1,gene,T23B5.3,1,12696990,1.66318,20864,12675970,156,12696832,-2,-158
IV,+,12697551,0.0,0.5,1,1,0,0,1,gene,T23B5.3,1,12697632,1.66318,21581,12675970,81,12697551,0,-81
IV,+,12702187,0.00252525,0.0,792,790,2,2,1,gene,T23B5.3,1,12702240,1.66318,26217,12675970,53,12702187,0,-53
IV,+,12704081,0.984848,1.58802e-36,132,2,130,103,1,gene,C27D8.4,2,12704095,0.607056,89,12703992,14,12704096,15,1
IV,+,12724956,0.00375235,0.0,533,531,2,1,35,gene,T23F6.4,0,12724959,0.637762,1988,12722968,3,12724956,0,-3
IV,+,12746554,0.0,3.00927e-36,118,118,0,0,0,gene,C36H8.2,0,12746586,0.31253,16489,12730065,32,12746554,0,-32
IV,+,12773838,0.0,7.27596e-12,37,37,0,0,0,gene,ZK897.1,0,12773854,0.157268,7920,12765918,16,12773726,-112,-128
IV,+,12791140,0.0,1.13687e-13,43,43,0,0,5,gene,F07C6.2,0,12791337,0.248798,704,12790436,197,12791140,0,-197
IV,+,12805900,0.0,0.0,151,151,0,0,1,gene,F07C6.4,0,12805907,1.28887,7703,12798197,7,12805900,0,-7
IV,+,12822960,0.0,0.03125,5,5,0,0,44,gene,F07C6.4,0,12822984,1.28887,9963,12812997,24,12823002,42,18
IV,+,12823002,0.0,0.0,271,271,0,0,5,gene,F07C6.4,0,12823170,1.28887,10005,12812997,168,12823002,0,-168
IV,+,12836479,0.0356013,0.0,1264,1219,45,38,6,gene,M02B1.3,0,12836494,2.61539,6396,12830083,15,12836479,0,-15
IV,+,12845667,0.125,0.00183105,16,14,2,2,2,gene,M02B1.2,0,12845917,0.486972,5257,12840410,250,12845895,228,-22
IV,+,12845868,0.0041841,0.0,478,476,2,1,10,gene,M02B1.2,0,12845917,0.486972,5458,12840410,49,12845895,27,-22
IV,+,12849477,0.0,1.35525e-20,66,66,0,0,5,gene,M02B1.1,1,12849490,0.346882,1079,12848398,13,12849475,-2,-15
IV,+,12855520,0.0559361,0.0,876,827,49,33,1,gene,ZK896.9,2,12855525,1.13668,1092,12854428,5,12855526,6,1
IV,+,12892469,0.0,9.62965e-35,113,113,0,0,0,gene,K08D8.1,0,12892481,0.383845,23420,12869049,12,12892502,33,21
IV,+,12896788,0.0,2.32831e-10,32,32,0,0,0,gene,K08D8.7,0,12896800,None,2006,12894782,12,12896801,13,1
IV,+,12896841,0.0,6.61744e-24,77,77,0,0,7,gene,K08D8.7,0,12896993,None,2059,12894782,152,12896801,-40,-192
IV,+,12896920,0.0,0.00390625,8,8,0,0,13,gene,K08D8.7,0,12896993,None,2138,12894782,73,12896801,-119,-192
IV,+,12903035,0.0,0.125,3,3,0,0,1,gene,K08D8.2,0,12903085,0.00423084,893,12902142,50,12903086,51,1
IV,+,12930854,0.0,0.5,1,1,0,0,0,gene,C32H11.7,0,12930894,0.0397757,7593,12923261,40,12930676,-178,-218
IV,+,12960475,0.0,0.5,1,1,0,0,1,gene,F55G11.7,0,12960504,0.00297663,1366,12959109,29,12960492,17,-12
IV,+,12960492,0.0,0.5,1,1,0,0,1,gene,F55G11.7,0,12960504,0.00297663,1383,12959109,12,12960492,0,-12
IV,+,12962831,0.0,0.00390625,8,8,0,0,179,gene,F55G11.8,0,12962851,0.603454,742,12962089,20,12962777,-54,-74
IV,+,12973615,0.0,0.5,1,1,0,0,2,gene,F55G11.4,0,12973627,1.08534,6272,12967343,12,12973605,-10,-22
IV,+,12976264,0.0,0.03125,5,5,0,0,83,gene,K10D11.1,0,12976276,0.38397,701,12975563,12,12976262,-2,-14
IV,+,13009085,0.0,0.0,354,354,0,0,3,gene,F49E11.1,0,13009126,4.86578,27172,12981913,41,13009127,42,1
IV,+,13031206,0.00413508,0.0,1451,1445,6,5,1,gene,F49E11.1,0,13031302,4.86578,1110,13030096,96,13031210,4,-92
IV,+,13031563,0.0286738,0.0,279,271,8,8,2,gene,F49E11.1,0,13031612,4.86578,1467,13030096,49,13031563,0,-49
IV,+,13042366,0.0,0.00390625,8,8,0,0,0,gene,F49E11.3,0,13042380,0.0335854,6354,13036012,14,13042360,-6,-20
IV,+,13051346,0.00693374,0.0,2596,2578,18,14,130,gene,F49E11.6,0,13051427,6.10031,1542,13049804,81,13051346,0,-81
IV,+,13063710,0.0,0.125,3,3,0,0,0,gene,C39E9.2,0,13063736,0.512885,1088,13062622,26,13063973,263,237
IV,+,13070441,0.0,1.26218e-29,96,96,0,0,392,gene,C39E9.5,0,13070447,1.18605,478,13069963,6,13070448,7,1
IV,+,13071716,0.0,0.0,724,724,0,0,2,gene,C39E9.6,0,13071722,1.75037,480,13071236,6,13071723,7,1
IV,+,13079330,0.0,0.00195312,9,9,0,0,2,gene,C39E9.8,0,13079476,2.31584,6837,13072493,146,13079477,147,1
IV,+,13086974,0.0,1.0842e-19,63,63,0,0,2,gene,C39E9.10,0,13086975,0.179204,4224,13082750,1,13086974,0,-1
IV,+,13093976,0.00386847,0.0,517,515,2,2,11,gene,C39E9.12,1,13093979,1.50619,4392,13089584,3,13093976,0,-3
IV,+,13093987,0.0,0.125,3,3,0,0,1143,gene,C39E9.12,1,13094024,1.50619,4403,13089584,37,13093976,-11,-48
IV,+,13095731,0.875425,0.0,1469,183,1286,1087,7,gene,C39E9.13,2,13095737,1.79832,260,13095471,6,13095731,0,-6
IV,+,13098974,0.0096,0.0,625,619,6,4,13,gene,B0564.1,1,13099004,2.31046,1952,13097022,30,13098974,0,-30
IV,+,13099092,0.0,0.0,248,248,0,0,4,gene,B0564.1,1,13099204,2.31046,2070,13097022,112,13099092,0,-112
IV,+,13100684,0.9,3.7032e-40,240,24,216,156,0,gene,B0564.7,2,13100684,0.643422,107,13100577,0,13100684,0,0
IV,+,13105294,0.863636,4.01261e-07,44,6,38,27,0,gene,B0564.11,3,13105308,0.597131,700,13104594,14,13105306,12,-2
IV,+,13105306,0.58396,0.000142143,399,166,233,173,152,gene,B0564.11,3,13105308,0.597131,712,13104594,2,13105306,0,-2
IV,+,13107628,0.859375,9.57569e-26,192,27,165,117,0,gene,B0564.2,4,13107693,0.385907,740,13106888,65,13107628,0,-65
IV,+,13130403,0.0,0.125,3,3,0,0,0,gene,B0564.6,0,13130408,0,6050,13124353,5,13130409,6,1
IV,+,13149545,0.0125,8.40779e-45,160,158,2,1,0,gene,F09E8.8,0,13149549,0.774661,10603,13138942,4,13149550,5,1
IV,+,13155148,0.0,0.0078125,7,7,0,0,1,gene,F09E8.3,0,13155184,0.196871,4613,13150535,36,13155197,49,13
IV,+,13155156,0.0,3.05176e-05,15,15,0,0,5,gene,F09E8.3,0,13155184,0.196871,4621,13150535,28,13155197,41,13
IV,+,13155197,0.0,3.72529e-09,28,28,0,0,7,gene,F09E8.3,0,13155201,0.196871,4662,13150535,4,13155197,0,-4
IV,+,13170515,0.030303,3.84171e-09,33,32,1,1,0,gene,F09E8.6,0,13170552,0.201003,3740,13166775,37,13170513,-2,-39
IV,+,13241019,0.0112994,0.0,177,175,2,2,0,gene,JC8.6,1,13241035,0.977899,8989,13232030,16,13241020,1,-15
IV,+,13241028,0.00338983,0.0,295,294,1,1,112,gene,JC8.6,1,13241035,0.977899,8998,13232030,7,13241030,2,-5
IV,+,13243641,0.824324,5.54046e-09,74,13,61,52,1,gene,JC8.4,2,13243642,0.360185,272,13243369,1,13243643,2,1
IV,+,13243650,0.785714,0.0222168,14,3,11,5,222,gene,JC8.4,2,13243718,0.360185,281,13243369,68,13243643,-7,-75
IV,+,13244292,0.969925,1.14404e-33,133,4,129,92,0,gene,JC8.5,3,13244308,0.900917,109,13244183,16,13244292,0,-16
IV,+,13247229,0.95082,7.60238e-28,122,6,116,80,2,gene,JC8.7,4,13247243,0.540621,111,13247118,14,13247229,0,-14
IV,+,13254202,0.0299213,0.0,635,616,19,14,689,gene,JC8.14,0,13254204,8.43347,3512,13250690,2,13254205,3,1
IV,+,13256110,1.0,0.5,1,0,1,1,21,gene,JC8.12,0,13256153,0.263246,735,13255375,43,13256053,-57,-100
IV,+,13256805,0.25,0.25,4,3,1,0,0,gene,JC8.12,0,13256805,0.263246,1430,13255375,0,13256805,0,0
IV,+,13298028,0.0,0.015625,6,6,0,0,199,gene,Y67H2A.4,1,13298144,0.780123,2510,13295518,116,13297879,-149,-265
IV,+,13300149,0.94992,0.0,13079,655,12424,7751,8,gene,Y67H2A.5,2,13300155,20.2457,115,13300034,6,13300148,-1,-7
IV,+,13300796,0.945026,0.0,764,42,722,547,4,gene,Y67H2A.6,3,13300797,1.08953,91,13300705,1,13300796,0,-1
IV,+,13303714,0.960784,1.41296e-36,153,6,147,102,3,gene,Y67H2A.7,4,13303719,0.38072,52,13303662,5,13303714,0,-5
IV,+,13315612,0.00214684,0.0,2329,2324,5,5,0,gene,Y67H2A.8,0,13315613,14.1645,4826,13310786,1,13315612,0,-1
IV,+,13323826,0.00051948,0.0,7700,7696,4,4,3,gene,W02A2.1,0,13323847,26.8962,1989,13321837,21,13323826,0,-21
IV,+,13328327,0.000630517,0.0,4758,4755,3,2,3,gene,W02A2.2,0,13328328,2.15279,1966,13326361,1,13328327,0,-1
IV,+,13347633,0.00166238,0.0,6617,6606,11,8,79,gene,W02A2.9,0,13347654,9.10312,1476,13346157,21,13347655,22,1
IV,+,13353691,0.00994318,0.0,2112,2091,21,18,1,gene,W02A2.7,0,13353697,5.89868,5068,13348623,6,13353691,0,-6
IV,+,13365009,0.0,1.49012e-08,26,26,0,0,0,gene,Y62E10A.4,0,13365091,0.0232101,8938,13356071,82,13365137,128,46
IV,+,13370663,0.00979021,0.0,715,708,7,6,29,gene,Y62E10A.2,1,13370731,2.11752,2268,13368395,68,13370663,0,-68
IV,+,13370687,0.0,0.5,1,1,0,0,465,gene,Y62E10A.2,1,13370731,2.11752,2292,13368395,44,13370678,-9,-53
IV,+,13371967,0.855932,4.20468e-16,118,17,101,68,2,gene,Y62E10A.6,2,13372137,0.413282,390,13371577,170,13371967,0,-170
IV,+,13377984,0.897436,0.0,429,44,385,251,0,gene,Y62E10A.8,3,13377992,0.670464,633,13377351,8,13377993,9,1
IV,+,13386321,0.0,0.015625,6,6,0,0,274,gene,Y62E10A.11,1,13386346,1.30467,6028,13380293,25,13386347,26,1
IV,+,13386338,0.0,0.0,158,158,0,0,705,gene,Y62E10A.11,1,13386346,1.30467,6045,13380293,8,13386338,0,-8
IV,+,13387417,1.0,0.015625,6,0,6,4,2,gene,Y62E10A.12,2,13387436,2.93846,92,13387325,19,13387437,20,1
IV,+,13387437,0.89781,0.0,1096,112,984,684,39,gene,Y62E10A.12,2,13387512,2.93846,112,13387325,75,13387437,0,-75
IV,+,13401263,0.00140647,0.0,711,710,1,0,36,gene,Y62E10A.15,0,13401273,None,11592,13389671,10,13401274,11,1
IV,+,13416760,0.0344828,5.735e-15,58,56,2,2,0,gene,K09B11.1,1,13416764,0.250976,12957,13403803,4,13416760,0,-4
IV,+,13422444,0.5,0.3125,6,3,3,3,6,gene,K09B11.2,2,13422469,0.302705,929,13421515,25,13422468,24,-1
IV,+,13422468,0.928571,9.15762e-23,112,8,104,83,14,gene,K09B11.2,2,13422469,0.302705,953,13421515,1,13422468,0,-1
IV,+,13455468,0.0,0.5,1,1,0,0,0,gene,Y38H8A.7,0,13455473,0.0959559,25532,13429936,5,13455285,-183,-188
IV,+,13483367,0.0,7.34684e-40,130,130,0,0,0,gene,Y38H8A.1,0,13483514,0.286973,7178,13476189,147,13483514,147,0
IV,+,13483502,0.0,0.25,2,2,0,0,13,gene,Y38H8A.1,0,13483514,0.286973,7313,13476189,12,13483514,12,0
IV,+,13492539,0.0,3.30872e-24,78,78,0,0,0,gene,Y45F10A.7,0,13492624,0.31138,7056,13485483,85,13492539,0,-85
IV,+,13506047,0.0178571,7.77156e-16,56,55,1,0,2,gene,Y45F10A.4,0,13506092,0.303677,8938,13497109,45,13506047,0,-45
IV,+,13509192,0.0,3.9443e-31,101,101,0,0,9,gene,Y45F10A.3,0,13509192,0.410223,1,13509191,0,13509193,1,1
IV,+,13561830,0.0,0.000488281,11,11,0,0,0,gene,Y45F10B.10,0,13561832,0.0903164,48310,13513520,2,13561841,11,9
IV,+,13603203,0.0,0.5,1,1,0,0,0,gene,Y45F10B.15,0,13603285,0.00230553,6984,13596219,82,13603517,314,232
IV,+,13619478,0.0,2.98023e-08,25,25,0,0,10,gene,C08F11.15,0,13619481,None,15315,13604163,3,13619325,-153,-156
IV,+,13633427,0.0,0.03125,5,5,0,0,52,gene,C08F11.5,0,13633466,0.105046,756,13632671,39,13633407,-20,-59
IV,+,13653919,0.0,1.38778e-17,56,56,0,0,0,gene,Y45F10C.6,0,13653922,0.0502664,9561,13644358,3,13653923,4,1
IV,+,13673757,0.0,0.25,2,2,0,0,0,gene,T23G4.4,0,13673771,0.00961389,17938,13655819,14,13673772,15,1
IV,+,13678919,0.0,1.19209e-07,23,23,0,0,0,gene,T23G4.5,0,13679057,0.172181,1128,13677791,138,13678919,0,-138
IV,+,13726898,0.0,1.11022e-16,53,53,0,0,2,gene,C47A4.2,0,13726936,0.284354,46567,13680331,38,13726898,0,-38
IV,+,13728267,0.0,4.76837e-07,21,21,0,0,0,gene,C47A4.2,0,13728345,0.284354,47936,13680331,78,13728267,0,-78
IV,+,13750302,0.00473934,0.0,211,210,1,1,0,gene,F56F12.1,0,13750303,0.305417,4367,13745935,1,13750304,2,1
IV,+,13777833,0.0027379,0.0,52595,52451,144,122,19,gene,Y45F10D.12,1,13777858,95.6558,726,13777107,25,13777833,0,-25
IV,+,13779304,0.643791,1.26961e-07,306,109,197,166,2,gene,Y45F10D.3,2,13779306,0.914968,529,13778775,2,13779304,0,-2
IV,+,13783929,0.00373648,0.0,5085,5066,19,17,0,gene,Y45F10D.4,0,13783941,3.30751,1525,13782404,12,13783927,-2,-14
IV,+,13788903,0.0,1.86265e-09,29,29,0,0,7,gene,Y45F10D.7,0,13789074,0.607997,4256,13784647,171,13788903,0,-171
IV,+,13789054,0.0,0.0,311,311,0,0,1,gene,Y45F10D.7,0,13789074,0.607997,4407,13784647,20,13789054,0,-20
IV,+,13789063,0.0,1.77636e-15,49,49,0,0,429,gene,Y45F10D.7,0,13789074,0.607997,4416,13784647,11,13789054,-9,-20
IV,+,13827854,0.025,3.63798e-11,40,39,1,1,0,gene,H08M01.2,0,13827854,0.191292,31662,13796192,0,13827854,0,0
IV,+,13882193,0.0044505,0.0,202449,201548,901,729,67,gene,B0513.3,1,13882209,505.027,679,13881514,16,13882162,-31,-47
IV,+,13882702,0.878519,0.0,675,82,593,450,3,gene,B0513.2,2,13882756,1.23962,73,13882629,54,13882702,0,-54
IV,+,13888057,0.00188324,0.0,1593,1590,3,3,41,gene,B0513.1,0,13888178,2.49943,3916,13884141,121,13888057,0,-121
IV,+,13934355,0.0,6.10352e-05,14,14,0,0,0,gene,Y37A1A.4,0,13934407,0.0539097,40402,13893953,52,13934413,58,6
IV,+,13938402,0.0,0.25,2,2,0,0,11,gene,Y37A1A.4,0,13938435,0.0539097,1933,13936469,33,13938436,34,1
IV,+,13943579,0.0,1.90735e-06,19,19,0,0,0,gene,C27H2.2,0,13943639,0.353856,7110,13936469,60,13943579,0,-60
IV,+,13952683,0.0,7.88861e-31,100,100,0,0,0,gene,C27H2.2,0,13952718,0.353856,8987,13943696,35,13952683,0,-35
IV,+,14003550,0.0,0.00390625,8,8,0,0,2,gene,Y37A1B.11,0,14003556,0.168332,39583,13963967,6,14003661,111,105
IV,+,14051168,0.00199203,0.0,502,501,1,1,2,gene,Y37A1B.5,0,14051189,0.821635,26572,14024596,21,14051168,0,-21
IV,+,14071518,0.00508475,0.0,1180,1174,6,3,4,gene,Y37A1B.1,1,14071552,2.75724,14883,14056635,34,14071518,0,-34
IV,+,14077409,0.936709,0.0,237,15,222,159,0,gene,F52B11.1,2,14077417,1.0391,692,14076717,8,14077409,0,-8
IV,+,14083536,0.206522,2.13583e-31,368,292,76,62,24,gene,F52B11.2,3,14083581,1.39659,16,14083520,45,14083772,236,191
IV,+,14083757,0.0,0.00390625,8,8,0,0,52,gene,F52B11.2,3,14083771,1.39659,150,14083607,14,14083772,15,1
IV,+,14091222,0.000830565,0.0,1204,1203,1,1,3,gene,F52B11.3,0,14091236,6.68924,6562,14084660,14,14091222,0,-14
IV,+,14106554,0.0,0.0,528,528,0,0,0,gene,F52B11.6,0,14106801,1.02921,9970,14096584,247,14106552,-2,-249
IV,+,14177241,0.0025974,0.0,385,384,1,1,101,gene,R05A10.2,0,14177248,1.0001,4047,14173194,7,14177193,-48,-55
IV,+,14182345,0.00119617,0.0,836,835,1,1,0,gene,R05A10.1,0,14182346,1.07609,3437,14178908,1,14182345,0,-1
IV,+,14193468,0.0,5.96046e-08,24,24,0,0,1,gene,K01G12.3,0,14193493,0.0369971,826,14192642,25,14193466,-2,-27
IV,+,14196446,0.0,9.62965e-35,113,113,0,0,6,gene,F02H6.2,0,14196464,0.193191,316,14196130,18,14196417,-29,-47
IV,+,14199171,1.0,0.25,2,0,2,2,1,gene,F02H6.1,0,14199230,0.00935547,379,14198792,59,14199231,60,1
IV,+,14203438,0.0122951,0.0,244,241,3,3,21,gene,F02H6.3,0,14203453,0.221172,1690,14201748,15,14203438,0,-15
IV,+,14216065,0.00612245,0.0,490,487,3,3,9,gene,F02H6.4,0,14216080,0.213205,8056,14208009,15,14216081,16,1
IV,+,14219839,1.0,0.5,1,0,1,0,7,gene,F02H6.5,0,14219870,0.458451,720,14219119,31,14219843,4,-27
IV,+,14220947,0.7,0.117188,10,3,7,5,0,gene,F02H6.5,0,14221104,0.458451,1828,14219119,157,14220947,0,-157
IV,+,14276433,0.0,0.0,255,255,0,0,0,gene,Y64G10A.6,0,14276536,0.281231,52028,14224405,103,14276433,0,-103
IV,+,14291869,0.00813008,1.15669e-35,123,122,1,1,0,gene,Y64G10A.7,0,14291882,0.233502,6386,14285483,13,14291937,68,55
IV,+,14361220,0.0,3.8147e-06,18,18,0,0,0,gene,Y67A10A.6,0,14361228,0.186402,19104,14342116,8,14361229,9,1
IV,+,14374080,0.0123457,3.35008e-23,81,80,1,0,0,gene,Y67A10A.7,0,14374094,0.176756,5794,14368286,14,14374095,15,1
IV,+,14394104,0.0,2.77556e-17,55,55,0,0,1,gene,Y67A10A.9,0,14394108,0.355427,14495,14379609,4,14394104,0,-4
IV,+,14424651,0.0,0.000244141,12,12,0,0,0,gene,F55B11.3,0,14424674,0.9475,24316,14400335,23,14424659,8,-15
IV,+,14464483,0.00988142,0.0,1012,1002,10,8,0,gene,LLC1.3,0,14464487,5.02208,426,14464057,4,14464483,0,-4
IV,+,14482440,0.00540541,0.0,185,184,1,0,2,gene,Y57G11A.4,0,14482447,0.75575,13411,14469029,7,14482440,0,-7
IV,+,14565327,0.0,0.0,351,351,0,0,9,gene,Y57G11B.2,0,14565390,0.477256,34552,14530775,63,14565327,0,-63
IV,+,14616568,0.00296736,0.0,337,336,1,1,1,gene,F13G11.1,0,14616742,3.17113,40026,14576542,174,14616568,0,-174
IV,+,14619416,0.00934579,6.59438e-31,107,106,1,0,6,gene,F13G11.1,0,14619419,3.17113,42874,14576542,3,14619416,0,-3
IV,+,14657045,0.00598291,0.0,1170,1163,7,7,0,gene,Y57G11C.33,0,14657049,1.08311,15739,14641306,4,14657045,0,-4
IV,+,14663632,0.0,4.70198e-38,124,124,0,0,0,gene,Y57G11C.37,0,14663636,0.123451,5569,14658063,4,14663637,5,1
IV,+,14683005,0.00208333,0.0,480,479,1,0,0,gene,Y57G11C.31,0,14683006,0.744185,7905,14675100,1,14683005,0,-1
IV,+,14734309,0.0185185,2.9976e-15,54,53,1,0,0,gene,Y57G11C.42,0,14734310,0.276663,13908,14720401,1,14734307,-2,-3
IV,+,14768118,0.0,0.0,475,475,0,0,2,gene,Y57G11C.3,1,14768161,2.10722,3760,14764358,43,14768151,33,-10
IV,+,14768251,0.00555556,0.0,180,179,1,1,1,gene,Y57G11C.3,1,14768347,2.10722,3893,14764358,96,14768251,0,-96
IV,+,14769530,0.902724,1.47136e-43,257,25,232,173,85,gene,Y57G11C.43,2,14769535,0.631179,287,14769243,5,14769536,6,1
IV,+,14787111,0.0,0.5,1,1,0,0,13,gene,Y57G11C.9,0,14787144,2.69586,3796,14783315,33,14787145,34,1
IV,+,14787129,0.0,0.0,1179,1179,0,0,49,gene,Y57G11C.9,0,14787144,2.69586,3814,14783315,15,14787129,0,-15
IV,+,14798110,0.00289735,0.0,2416,2409,7,7,19,gene,Y57G11C.13,0,14798139,3.44937,6589,14791521,29,14798110,0,-29
IV,+,14799285,0.666667,0.0554466,21,7,14,13,1,gene,Y57G11C.14,0,14799305,0.214392,15,14799270,20,14799306,21,1
IV,+,14825640,0.00550116,0.0,28903,28744,159,131,1,gene,Y57G11C.16,0,14825659,106.867,15723,14809917,19,14825640,0,-19
IV,+,14853966,1.0,0.03125,5,0,5,5,0,gene,Y57G11C.52,4,14853977,0.180344,340,14853626,11,14853978,12,1
IV,+,14854018,0.75,0.109375,8,2,6,2,84,gene,Y57G11C.52,4,14854061,0.180344,392,14853626,43,14853978,-40,-83
IV,+,14879451,0.0060241,0.0,166,165,1,1,0,gene,Y57G11C.24,0,14879458,2.78077,9489,14869962,7,14879451,0,-7
IV,+,14885534,0.00456621,0.0,219,218,1,1,1,gene,Y57G11C.24,0,14885648,2.78077,15572,14869962,114,14885534,0,-114
IV,+,14886575,0.0,1.29247e-26,86,86,0,0,0,gene,Y57G11C.24,0,14886609,2.78077,16613,14869962,34,14886575,0,-34
IV,+,14891425,0.0,2.71051e-20,65,65,0,0,1,gene,Y57G11C.24,0,14891426,2.78077,21463,14869962,1,14891425,0,-1
IV,+,14919573,0.00277778,0.0,360,359,1,1,1,gene,Y57G11C.25,0,14919584,0.221097,18959,14900614,11,14919585,12,1
IV,+,14981572,0.00268097,0.0,373,372,1,1,0,gene,Y41E3.3,0,14981588,0.193766,27415,14954157,16,14981570,-2,-18
IV,+,14981585,0.0,0.000244141,12,12,0,0,783,gene,Y41E3.3,0,14981588,0.193766,27428,14954157,3,14981570,-15,-18
IV,+,15014003,0.0134048,0.0,373,368,5,5,4,gene,Y41E3.7,1,15014004,1.97787,6849,15007154,1,15014003,0,-1
IV,+,15019867,0.0188679,5.88418e-15,53,52,1,1,0,gene,Y41E3.7,1,15019909,1.97787,4577,15015290,42,15019867,0,-42
IV,+,15025673,0.0864198,1.43814e-15,81,74,7,5,7,gene,Y41E3.9,2,15025681,0.239502,199,15025474,8,15025671,-2,-10
IV,+,15037302,0.0113187,0.0,5566,5503,63,57,15,gene,Y41E3.10,3,15037309,9.65598,305,15036997,7,15037302,0,-7
IV,+,15039581,0.928571,1.40816e-06,28,2,26,20,0,gene,Y41E3.11,4,15039587,1.46363,69,15039512,6,15040036,455,449
IV,+,15040034,0.0108499,0.0,553,547,6,5,0,gene,Y41E3.11,4,15040035,1.46363,522,15039512,1,15040036,2,1
IV,+,15042397,0.660377,0.00717399,53,18,35,28,15,gene,Y41E3.11,4,15042397,1.46363,511,15041886,0,15042397,0,0
IV,+,15108736,0.0185185,2.9976e-15,54,53,1,1,0,gene,M199.2,0,15108823,0.19043,2292,15106444,87,15108736,0,-87
IV,+,15179878,0.0,0.00195312,9,9,0,0,1,gene,Y40H7A.5,0,15179882,0.0194382,20933,15158945,4,15179883,5,1
IV,+,15245918,0.0,0.25,2,2,0,0,0,gene,Y73F8A.36,0,15245953,0.00351242,2282,15243636,35,15245954,36,1
IV,+,15302405,0.0,0.5,1,1,0,0,16,gene,Y73F8A.11,0,15302422,0.455877,7067,15295338,17,15302382,-23,-40
IV,+,15323846,0.0,0.015625,6,6,0,0,0,gene,Y73F8A.16,0,15323853,0.00442405,1645,15322201,7,15323854,8,1
IV,+,15361507,0.0,1.42109e-14,46,46,0,0,0,gene,Y73F8A.19,0,15361554,0.120258,22144,15339363,47,15361555,48,1
IV,+,15400247,0.0,1.65436e-24,79,79,0,0,0,gene,Y73F8A.21,0,15400293,0.271127,18588,15381659,46,15400294,47,1
IV,+,15472770,0.00657895,0.0,760,755,5,5,3,gene,Y73F8A.27,0,15472777,1.3556,65400,15407370,7,15472770,0,-7
IV,+,15513919,0.0,0.5,1,1,0,0,2,gene,Y73F8A.31,0,15514095,0.0577028,2982,15510937,176,15513747,-172,-348
IV,+,15583887,0.0,0.125,3,3,0,0,0,gene,Y105C5A.508,0,15583895,None,53513,15530374,8,15583896,9,1
IV,+,15633155,0.0,0.03125,5,5,0,0,0,gene,Y105C5A.9,0,15633160,0.0354841,47239,15585916,5,15633161,6,1
IV,+,15643484,0.0229008,0.0,262,256,6,6,0,gene,Y105C5A.13,0,15643488,0.337377,2051,15641433,4,15643489,5,1
IV,+,15703321,0.0,2.1684e-19,62,62,0,0,3,gene,Y105C5A.27,0,15703406,None,56028,15647293,85,15703407,86,1
IV,+,15710764,0.0,0.00390625,8,8,0,0,2,gene,Y105C5A.15,0,15710936,0.231857,5234,15705530,172,15710937,173,1
IV,+,15726518,0.0,0.5,1,1,0,0,0,gene,Y105C5A.17,0,15726738,0.0107395,4279,15722239,220,15726426,-92,-312
IV,+,15741739,0.0,0.0625,4,4,0,0,0,gene,Y105C5A.20,0,15741783,None,14866,15726873,44,15741535,-204,-248
IV,+,15820020,0.0,8.67362e-19,60,60,0,0,0,gene,Y105C5A.23,0,15820055,0.145937,76698,15743322,35,15820020,0,-35
IV,+,15847395,0.0,4.76837e-07,21,21,0,0,2,gene,Y105C5A.1269,0,15847433,None,21817,15825578,38,15847357,-38,-76
IV,+,15906528,0.0,0.00012207,13,13,0,0,0,gene,Y105C5B.6,0,15906542,0.0204428,18152,15888376,14,15906543,15,1
IV,+,15908895,0.0,0.5,1,1,0,0,0,gene,Y105C5B.6,0,15908908,0.0204428,20519,15888376,13,15908909,14,1
IV,+,15930542,0.00549451,0.0,182,181,1,1,1,gene,Y105C5B.9,0,15930543,0.626024,20441,15910101,1,15930544,2,1
IV,+,15946745,0.000706714,0.0,1415,1414,1,1,0,gene,Y105C5B.13,0,15946767,1.17916,14980,15931765,22,15946751,6,-16
IV,+,15951872,0.0,0.0625,4,4,0,0,2,gene,Y105C5B.15,0,15951902,1.34604,4473,15947399,30,15951870,-2,-32
IV,+,16132435,0.0,6.10352e-05,14,14,0,0,0,gene,Y105C5B.29,0,16132458,0.0919985,71117,16061318,23,16132459,24,1
IV,+,16278162,0.0,0.0,276,276,0,0,2,gene,F38C2.5,0,16278173,0.0784297,5015,16273147,11,16278173,11,0
IV,+,16308162,0.25,0.25,4,3,1,0,0,gene,K03D3.10,0,16308184,0,2949,16305213,22,16308185,23,1
IV,+,16350929,0.0,8.47033e-22,70,70,0,0,1,gene,C35D6.4,0,16350949,0.00706,3539,16347390,20,16350950,21,1
IV,+,16411980,0.00185185,0.0,540,539,1,1,2,gene,Y65A5A.2,0,16412043,0.504778,17374,16394606,63,16411980,0,-63
IV,+,16416040,0.00826446,4.55151e-35,121,120,1,0,1,gene,Y65A5A.3,0,16416044,0.693507,1021,16415019,4,16416045,5,1
IV,+,16424597,0.194009,0.0,701,565,136,118,5,gene,Y10G11A.1,0,16424609,1.47052,7875,16416722,12,16424610,13,1
IV,+,16432191,0.0122449,0.0,245,242,3,3,1,gene,Y10G11A.2,0,16432210,0.522794,2339,16429852,19,16432191,0,-19
IV,+,16656571,0.00362757,0.0,827,824,3,3,2,gene,Y51H4A.15,0,16656576,1.85073,25397,16631174,5,16656577,6,1
IV,+,16664278,0.0022831,0.0,438,437,1,1,0,gene,Y51H4A.17,0,16664279,0.658554,6961,16657317,1,16664278,0,-1
IV,+,16736287,0.0,0.0,384,384,0,0,13,gene,Y51H4A.25,0,16736288,0.163146,13618,16722669,1,16736287,0,-1
IV,+,16736350,0.0,0.03125,5,5,0,0,26,gene,Y51H4A.25,0,16736376,0.163146,13681,16722669,26,16736287,-63,-89
IV,+,16740118,0.0,0.00012207,13,13,0,0,6,gene,Y51H4A.25,0,16740129,0.163146,997,16739121,11,16740118,0,-11
IV,+,16787280,0.0,0.0625,4,4,0,0,1,gene,Y43D4A.6,0,16787284,0.00780189,2148,16785132,4,16787285,5,1
IV,+,16831653,0.0,0.25,2,2,0,0,9,gene,Y116A8A.8,0,16831669,0.0154896,906,16830747,16,16831624,-29,-45
IV,+,16862347,0.0,4.54747e-13,41,41,0,0,6,gene,T06A10.4,1,16862465,1.21658,29405,16832942,118,16862354,7,-111
IV,+,16863826,0.00444444,0.0,450,448,2,2,3,gene,T06A10.4,1,16863832,1.21658,30884,16832942,6,16863826,0,-6
IV,+,16865798,0.0607287,0.0,247,232,15,12,31,gene,T06A10.3,2,16865837,0.863542,361,16865437,39,16865798,0,-39
IV,+,16895545,0.047619,1.00136e-05,21,20,1,0,0,gene,T06A10.2,0,16895635,0.0329313,29086,16866459,90,16895326,-219,-309
IV,+,16916145,0.0,0.000488281,11,11,0,0,44,gene,Y116A8C.3,0,16916161,0.104884,20068,16896077,16,16916074,-71,-87
IV,+,16947077,0.0052356,0.0,764,760,4,2,0,gene,Y116A8C.12,1,16947084,1.19724,18053,16929024,7,16947085,8,1
IV,+,16950024,0.909091,9.6555e-11,55,5,50,41,0,gene,Y116A8C.13,2,16950054,0.190828,91,16949933,30,16950024,0,-30
IV,+,16995735,0.00485437,0.0,206,205,1,1,3,gene,Y116A8C.16,0,16995752,0.342688,6001,16989734,17,16995740,5,-12
IV,+,17040853,0.0,1.90735e-06,19,19,0,0,3,gene,Y116A8C.20,0,17040873,0.0579056,25993,17014860,20,17040869,16,-4
IV,+,17088014,0.00657109,0.0,3348,3326,22,19,2,gene,Y116A8C.42,0,17088014,7.68148,30370,17057644,0,17088014,0,0
IV,+,17093990,0.0,0.0,414,414,0,0,0,gene,Y116A8C.29,0,17094002,0.529172,3050,17090940,12,17094036,46,34
IV,+,17119639,0.00291545,0.0,686,684,2,2,0,gene,Y116A8C.36,0,17119663,0.911612,4220,17115419,24,17119639,0,-24
IV,+,17163507,0.0,0.0078125,7,7,0,0,0,gene,C52D10.7,0,17163527,0.711194,26048,17137459,20,17163509,2,-18
IV,+,17167210,0.0,0.0,733,733,0,0,0,gene,C52D10.6,0,17167228,0.157758,3047,17164163,18,17167213,3,-15
IV,+,17176424,0.0,0.5,1,1,0,0,0,gene,C52D10.3,0,17176451,0.538018,8551,17167873,27,17176432,8,-19
IV,+,17176432,0.0,0.0,513,513,0,0,0,gene,C52D10.3,0,17176451,0.538018,8559,17167873,19,17176432,0,-19
IV,+,17223729,0.0149254,4.5401e-19,67,66,1,0,0,gene,Y116A8B.4,0,17223733,0.329563,3234,17220495,4,17223734,5,1
IV,+,17245538,0.0120482,8.582e-24,83,82,1,1,2,gene,ZK550.2,0,17245551,0.200876,2465,17243073,13,17245552,14,1
IV,+,17250085,0.0,0.0,573,573,0,0,3,gene,ZK550.3,1,17250086,1.44244,382,17249703,1,17250085,0,-1
IV,+,17255255,0.907143,0.0,420,39,381,301,0,gene,ZK550.4,2,17255256,0.591934,337,17254918,1,17255255,0,-1
IV,+,17269296,0.0,0.0,610,610,0,0,0,gene,F26D10.9,0,17269296,1.97242,2416,17266880,0,17269296,0,0
IV,+,17271223,0.0,0.00390625,8,8,0,0,5,gene,F26D10.9,0,17271355,1.97242,4343,17266880,132,17271223,0,-132
IV,+,17275535,0.0,2.64698e-23,75,75,0,0,0,gene,F26D10.11,0,17275591,0.10669,3400,17272135,56,17275592,57,1
IV,+,17278913,0.00386156,0.0,27968,27860,108,97,6,gene,F26D10.3,0,17278917,40.089,1217,17277696,4,17278913,0,-4
IV,+,17294744,0.0,0.015625,6,6,0,0,0,gene,T28F3.5,0,17294746,0.0394227,13460,17281284,2,17294747,3,1
IV,+,17308467,0.0,0.03125,5,5,0,0,0,gene,T28F3.9,0,17308478,0.00299294,7656,17300811,11,17308479,12,1
IV,+,17320749,0.00287356,0.0,348,347,1,1,0,gene,C49C3.4,0,17320751,1.48025,2506,17318243,2,17320749,0,-2
IV,+,17329148,0.0133333,1.98523e-21,75,74,1,1,14,gene,C49C3.5,0,17329158,0.483887,533,17328615,10,17329159,11,1
IV,+,17331481,0.00679117,0.0,589,585,4,3,0,gene,C49C3.6,1,17331484,1.07389,790,17330691,3,17331481,0,-3
IV,+,17332529,0.78355,4.69614e-19,231,50,181,137,0,gene,C49C3.7,2,17332532,0.635664,135,17332394,3,17332527,-2,-5
IV,+,17334187,0.0,0.0,480,480,0,0,1,gene,C49C3.15,0,17334190,0.248346,587,17333600,3,17334147,-40,-43
IV,+,17375961,0.0,0.25,2,2,0,0,0,gene,C30H6.6,0,17376082,0.10686,375,17375586,121,17376381,420,299
IV,+,17376381,0.0,9.53674e-07,20,20,0,0,0,gene,C30H6.6,0,17376389,0.10686,795,17375586,8,17376381,0,-8
IV,+,17376387,0.0,0.0078125,7,7,0,0,4,gene,C30H6.6,0,17376389,0.10686,801,17375586,2,17376381,-6,-8
IV,+,17380582,0.0021978,0.0,910,908,2,2,3,gene,C30H6.7,1,17380588,3.71277,1311,17379271,6,17380587,5,-1
IV,+,17382283,0.95679,8.71464e-38,162,7,155,113,3,gene,C30H6.8,2,17382358,0.715469,107,17382176,75,17382283,0,-75
IV,+,17399716,0.0,2.91038e-11,35,35,0,0,1,gene,T02D1.4,0,17399729,0.0390006,2271,17397445,13,17399730,14,1
IV,+,17427677,0.00398406,0.0,251,250,1,1,2,gene,C06A12.3,0,17427681,0.716842,25262,17402415,4,17427682,5,1
IV,+,17441884,0.0,9.53674e-07,20,20,0,0,5,gene,F08A7.1,0,17441901,None,3755,17438129,17,17441876,-8,-25
IV,+,17442887,0.0,4.81482e-35,114,114,0,0,24,gene,F11E6.11,0,17442900,0.185805,790,17442097,13,17442887,0,-13
IV,+,17442919,0.0,0.00195312,9,9,0,0,104,gene,F11E6.11,0,17442919,0.185805,822,17442097,0,17442887,-32,-32
V,+,5366,0.0,0.25,2,2,0,0,0,gene,B0348.5,0,5449,0.0559209,0,0,83,5518,152,69
V,+,20653,0.0,0.0,355,355,0,0,0,gene,B0348.4,0,20834,0.834051,14193,6460,181,20653,0,-181
V,+,104656,0.00600601,0.0,333,331,2,2,1,gene,F56E10.1,0,104657,0.270857,41315,63341,1,104658,2,1
V,+,128065,0.00181818,0.0,550,549,1,1,0,gene,W03F9.10,0,128077,1.7192,10049,118016,12,128065,0,-12
V,+,145016,0.0,0.5,1,1,0,0,1,gene,W03F9.6,0,145021,0.000681,874,144142,5,145022,6,1
V,+,156653,0.0135747,0.0,221,218,3,2,2,gene,W03F9.5,1,156658,1.07796,4045,152608,5,156653,0,-5
V,+,156656,0.0,1.52588e-05,16,16,0,0,18,gene,W03F9.5,1,156658,1.07796,4048,152608,2,156656,0,-2
V,+,166818,0.822751,0.0,756,134,622,477,1,gene,Y108G3AL.2,2,166821,0.591634,123,166695,3,166822,4,1
V,+,177408,0.0303907,0.0,691,670,21,16,2,gene,Y108G3AL.1,3,177472,1.67076,756,176652,64,177408,0,-64
V,+,185998,0.141176,3.40093e-12,85,73,12,12,0,gene,Y108G3AL.7,4,186016,0.728464,1035,184963,18,185638,-360,-378
V,+,202369,0.0,0.25,2,2,0,0,0,gene,DC2.8,5,202384,None,1813,200556,15,202367,-2,-17
V,+,204211,0.307047,5.83553e-22,596,413,183,107,0,gene,DC2.3,6,204218,1.50613,103,204108,7,204211,0,-7
V,+,359595,0.824742,3.80315e-21,194,34,160,107,0,gene,T22H9.1,2,359672,0.53133,108,359487,77,359595,0,-77
V,+,381739,0.0,0.0,210,210,0,0,0,gene,ZK6.8,0,381748,0.511542,8131,373608,9,381730,-9,-18
V,+,449629,0.0,0.25,2,2,0,0,1,gene,M02H5.8,0,449659,5.07364,11063,438566,30,449570,-59,-89
V,+,451280,0.0,7.62939e-06,17,17,0,0,0,gene,M02H5.7,0,451281,0.0539594,1016,450264,1,451280,0,-1
V,+,462420,0.0,1.73472e-18,59,59,0,0,1,gene,M02H5.4,0,462428,0.126928,649,461771,8,462429,9,1
V,+,477991,0.00699301,1.28247e-41,143,142,1,0,0,gene,T01G6.7,0,478096,0.155999,1010,476981,105,477991,0,-105
V,+,486813,1.0,3.05176e-05,15,0,15,10,0,gene,T01G6.5,2,486818,0.0448472,89,486724,5,486819,6,1
V,+,494462,0.0,3.8147e-06,18,18,0,0,7,gene,T01G6.2,0,494462,0.158245,2296,492166,0,494414,-48,-48
V,+,636412,0.0,0.0,154,154,0,0,3,gene,F48G7.2,0,636415,0.0416624,2628,633784,3,636416,4,1
V,+,687516,0.00649351,7.00649e-45,154,153,1,1,2,gene,H25P19.1,0,687544,0.475048,1542,685974,28,687545,29,1
V,+,731233,0.0,2.84217e-14,45,45,0,0,2,gene,C05E4.14,0,731266,0.0618682,20837,710396,33,731476,243,210
V,+,731267,0.0,0.00012207,13,13,0,0,4,gene,C05E4.14,0,731443,0.0618682,20871,710396,176,731476,209,33
V,+,762647,0.00943396,1.30655e-30,106,105,1,0,8,gene,C05E4.1,0,762683,0.212639,4929,757718,36,762647,0,-36
V,+,773398,0.00798838,0.0,1377,1366,11,9,327,gene,R09E12.3,0,773420,3.7012,1594,771804,22,773380,-18,-40
V,+,813501,0.0,0.0,196,196,0,0,1,gene,R13D11.3,0,813555,0.000513105,3615,809886,54,813556,55,1
V,+,833500,0.0,0.0078125,7,7,0,0,0,gene,F41H8.1,0,833511,0.00527932,4909,828591,11,833498,-2,-13
V,+,904793,0.0,0.0,261,261,0,0,4,gene,H24K24.4,1,904797,0.551193,10237,894556,4,904793,0,-4
V,+,911606,0.661863,3.52656e-23,902,305,597,436,7,gene,H24K24.3,2,911637,2.23442,723,910883,31,911606,0,-31
V,+,936294,0.0,0.000488281,11,11,0,0,0,gene,Y50D4C.2,0,936369,0.0203013,10339,925955,75,936228,-66,-141
V,+,982364,0.0,0.0,517,517,0,0,0,gene,Y50D4C.1,0,982410,1.55892,19876,962488,46,982364,0,-46
V,+,1008633,0.00318979,0.0,627,625,2,2,0,gene,R09A1.1,0,1008642,1.87411,13066,995567,9,1008633,0,-9
V,+,1061425,0.0,0.0,1789,1789,0,0,20,gene,K10C9.3,0,1061426,1.53308,43242,1018183,1,1061425,0,-1
V,+,1075088,0.0,1.57772e-30,99,99,0,0,31,gene,K10C9.1,0,1075100,0.460362,7350,1067738,12,1075030,-58,-70
V,+,1092489,0.0,1.46937e-39,129,129,0,0,0,gene,Y50D4B.4,0,1092508,0.207483,3033,1089456,19,1092509,20,1
V,+,1112768,0.0,4.54747e-13,41,41,0,0,1,gene,Y50D4B.1,0,1112787,0.192224,8867,1103901,19,1112788,20,1
V,+,1121875,0.0,9.31323e-10,30,30,0,0,0,gene,W07B8.3,0,1121881,0.462972,17974,1103901,6,1121882,7,1
V,+,1141571,0.0,0.00390625,8,8,0,0,0,gene,T21H3.4,0,1141599,0.0223592,2572,1138999,28,1141600,29,1
V,+,1141582,0.0,0.25,2,2,0,0,19,gene,T21H3.4,0,1141599,0.0223592,2583,1138999,17,1141600,18,1
V,+,1156101,0.00404494,0.0,4450,4432,18,17,0,gene,T21H3.3,0,1156137,11.2106,9774,1146327,36,1156101,0,-36
V,+,1169938,0.0,0.25,2,2,0,0,0,gene,T21H3.2,0,1169958,0.232857,11901,1158037,20,1169959,21,1
V,+,1176554,0.00257832,0.0,7757,7737,20,14,42,gene,T21H3.1,0,1176554,24.4527,1761,1174793,0,1176554,0,0
V,+,1178186,0.0,2.71051e-20,65,65,0,0,1,gene,T21H3.1,0,1178212,24.4527,1143,1177043,26,1178213,27,1
V,+,1179506,0.0,0.5,1,1,0,0,21,gene,F25A2.1,0,1179549,0.0703702,814,1178692,43,1179434,-72,-115
V,+,1179556,0.0,0.125,3,3,0,0,14,gene,F25A2.1,0,1179590,0.0703702,864,1178692,34,1179434,-122,-156
V,+,1196148,0.00746733,0.0,1607,1595,12,11,6,gene,Y50D4A.2,0,1196184,0.981539,14770,1181378,36,1196148,0,-36
V,+,1207719,0.92053,6.56179e-29,151,12,139,104,1,gene,Y50D4A.1,2,1207725,0.377195,102,1207617,6,1207719,0,-6
V,+,1208875,0.0,0.5,1,1,0,0,0,gene,Y50D4A.1,2,1208963,0.377195,1258,1207617,88,1208875,0,-88
V,+,1210147,0.0,0.000244141,12,12,0,0,0,gene,Y50D4A.1,2,1210184,0.377195,2530,1207617,37,1210147,0,-37
V,+,1264603,0.0,2.22045e-16,52,52,0,0,0,gene,C39F7.5,0,1264624,0.207169,2157,1262446,21,1264603,0,-21
V,+,1351955,0.0,0.0,166,166,0,0,0,gene,Y75B7AL.1,0,1351962,0.173818,36191,1315764,7,1351955,0,-7
V,+,1439034,0.0,8.67362e-19,60,60,0,0,1,gene,R09B5.11,0,1439084,0.286361,82618,1356416,50,1439034,0,-50
V,+,1454902,0.0,0.5,1,1,0,0,2,gene,R09B5.12,0,1454944,0.0327572,733,1454169,42,1454891,-11,-53
V,+,1460198,0.0,0.0,2274,2274,0,0,2,gene,R09B5.6,0,1460216,3.08147,3667,1456531,18,1460198,0,-18
V,+,1467573,0.0181818,1.54143e-44,165,162,3,1,32,gene,F53E2.1,0,1467595,0.827804,1384,1466189,22,1467573,0,-22
V,+,1474915,0.00150441,0.0,13959,13938,21,18,16,gene,C38C3.5,0,1474967,9.13948,3984,1470931,52,1474915,0,-52
V,+,1481873,0.00392157,0.0,255,254,1,1,0,gene,C38C3.4,0,1481879,0.501591,2469,1479404,6,1481873,0,-6
V,+,1548044,0.0,1.16415e-10,33,33,0,0,3,gene,F52F10.2,0,1548094,0.159442,23991,1524053,50,1547972,-72,-122
V,+,1577520,0.0,0.0,178,178,0,0,0,gene,F16B4.8,0,1577566,1.63801,16643,1560877,46,1577519,-1,-47
V,+,1587327,0.666667,0.375,3,1,2,1,0,gene,F16B4.6,0,1587380,0.124173,1408,1585919,53,1587035,-292,-345
V,+,1593980,0.0,0.015625,6,6,0,0,12187,gene,F16B4.4,0,1594009,7.03636,2366,1591614,29,1593941,-39,-68
V,+,1600867,0.0166667,5.20417e-17,60,59,1,1,2,gene,F16B4.2,0,1600870,0.158315,3808,1597059,3,1600867,0,-3
V,+,1610265,0.0,0.03125,5,5,0,0,12,gene,F16B4.1,0,1610449,0.145938,6478,1603787,184,1610164,-101,-285
V,+,1743643,0.0,9.53674e-07,20,20,0,0,83,gene,ZK697.2,0,1744072,0.204696,7085,1736558,429,1743600,-43,-472
V,+,1821407,0.00162075,0.0,617,616,1,1,4,gene,Y46H3A.7,0,1821417,0.802389,12065,1809342,10,1821418,11,1
V,+,1869041,0.00113766,0.0,879,878,1,1,0,gene,T10B5.6,1,1869041,1.01403,21189,1847852,0,1869041,0,0
V,+,1872074,0.075662,0.0,4758,4398,360,306,0,gene,T10B5.5,2,1872079,6.16205,1084,1870990,5,1872074,0,-5
V,+,1895613,0.0,7.27596e-12,37,37,0,0,0,gene,Y32G9A.6,0,1895624,0.0498017,20287,1875326,11,1895625,12,1
V,+,1921447,0.0,0.000976562,10,10,0,0,0,gene,Y32G9A.1,0,1921448,0.00120942,590,1920857,1,1921449,2,1
V,+,1927190,0.0,0.25,2,2,0,0,19,gene,T06A1.5,0,1927200,0.384121,4981,1922209,10,1927051,-139,-149
V,+,1944783,0.0,2.71051e-20,65,65,0,0,0,gene,T06A1.4,0,1944783,0.163865,13581,1931202,0,1944784,1,1
V,+,1969356,0.0,0.0,154,154,0,0,0,gene,T08B1.6,0,1969368,0.306073,11595,1957761,12,1969369,13,1
V,+,1979265,0.0,0.0,564,564,0,0,0,gene,T08B1.4,0,1979265,0.620739,2063,1977202,0,1979265,0,0
V,+,2011910,1.0,0.00195312,9,0,9,9,0,gene,F59A7.7,2,2011932,0.00518584,556,2011354,22,2012034,124,102
V,+,2029981,0.0215054,4.31968e-25,93,91,2,2,0,gene,F59A7.12,0,2030004,0.0991041,5455,2024526,23,2030005,24,1
V,+,2057475,0.0,0.0,168,168,0,0,71,gene,Y40B10A.2,0,2057495,0.771332,27240,2030235,20,2057457,-18,-38
V,+,2068392,0.0036295,0.0,20664,20589,75,64,3,gene,Y40B10A.1,0,2068397,21.3642,7432,2060960,5,2068392,0,-5
V,+,2090497,0.0,0.0,294,294,0,0,0,gene,F36F12.8,0,2090508,0.242974,905,2089592,11,2090497,0,-11
V,+,2127363,0.00533333,0.0,750,746,4,4,9,gene,F22F7.1,0,2127363,3.99828,372,2126991,0,2127363,0,0
V,+,2188110,0.0,8.88178e-16,50,50,0,0,0,gene,Y5H2B.3,0,2188122,0.146233,1734,2186376,12,2188113,3,-9
V,+,2192325,0.00869565,2.76852e-33,115,114,1,1,0,gene,Y5H2B.2,0,2192328,0.263076,3419,2188906,3,2192325,0,-3
V,+,2215546,0.0,0.0078125,7,7,0,0,2,gene,F44C8.7,0,2215551,0.0161641,5448,2210098,5,2215552,6,1
V,+,2221893,0.8125,0.00854492,16,3,13,5,1,gene,F44C8.5,2,2221906,0.0683368,767,2221126,13,2221893,0,-13
V,+,2221901,0.941176,0.0001297,17,1,16,1,26,gene,F44C8.5,2,2221906,0.0683368,775,2221126,5,2221893,-8,-13
V,+,2225258,0.916667,0.00292969,12,1,11,5,1,gene,F44C8.4,3,2225419,0.131278,115,2225143,161,2225258,0,-161
V,+,2227031,0.823529,0.00518799,17,3,14,8,2,gene,F44C8.3,4,2227105,0.195668,135,2226896,74,2227031,0,-74
V,+,2228909,0.972222,5.23869e-10,36,1,35,13,1,gene,F44C8.10,5,2228997,0.131716,101,2228808,88,2228909,0,-88
V,+,2231051,0.479167,0.109984,48,25,23,10,10,gene,F44C8.2,6,2231070,0.235893,239,2230812,19,2231051,0,-19
V,+,2233307,1.0,2.32831e-10,32,0,32,14,0,gene,F44C8.11,7,2233309,0.12938,100,2233207,2,2233310,3,1
V,+,2244793,0.0,0.5,1,1,0,0,0,gene,F41B5.3,0,2244805,0.0565716,97,2244696,12,2244843,50,38
V,+,2250375,0.00689655,3.25101e-42,145,144,1,1,3,gene,F41B5.2,0,2250375,0.195187,3522,2246853,0,2250376,1,1
V,+,2255367,0.166667,0.09375,6,5,1,1,0,gene,F41B5.1,0,2255430,None,2954,2252413,63,2255218,-149,-212
V,+,2281745,0.0,0.0078125,7,7,0,0,25,gene,T27B7.6,0,2281764,0.255208,523,2281222,19,2281686,-59,-78
V,+,2326506,0.000476417,0.0,4198,4196,2,2,5,gene,F15E11.12,0,2326592,3.2299,3089,2323417,86,2326507,1,-85
V,+,2330232,0.0,0.125,3,3,0,0,0,gene,F15E11.13,0,2330256,0,3127,2327105,24,2330257,25,1
V,+,2392584,0.0,0.125,3,3,0,0,0,gene,Y19D10A.16,0,2392599,0,1924,2390660,15,2392600,16,1
V,+,2418907,0.0,0.5,1,1,0,0,0,gene,C13B7.3,0,2418908,0,3068,2415839,1,2418909,2,1
V,+,2490333,0.0,0.25,2,2,0,0,0,gene,C01B4.8,0,2490339,0,29584,2460749,6,2490340,7,1
V,+,2493984,0.0277778,5.23869e-10,36,35,1,0,0,gene,C01B4.7,0,2494021,0,1383,2492601,37,2494063,79,42
V,+,2500863,0.0,0.03125,5,5,0,0,0,gene,C01B4.6,0,2500878,0,1923,2498940,15,2500879,16,1
V,+,2529967,0.0135135,0.0,370,365,5,3,0,gene,Y45G12C.16,0,2529973,0,277,2529690,6,2529974,7,1
V,+,2590201,0.0,5.82077e-11,34,34,0,0,0,gene,C29G2.2,0,2590219,0.0599533,7431,2582770,18,2590220,19,1
V,+,2592438,0.0,0.125,3,3,0,0,1657,gene,F53E10.4,0,2592508,1.09722,670,2591768,70,2592375,-63,-133
V,+,2608483,0.0,4.76837e-07,21,21,0,0,1,gene,F53E10.2,0,2608500,0.0491827,13594,2594889,17,2608483,0,-17
V,+,2615617,0.00225734,0.0,443,442,1,0,2,gene,F53E10.1,0,2615635,1.14463,542,2615075,18,2615617,0,-18
V,+,2645907,0.0,0.5,1,1,0,0,6,gene,W02H5.1,0,2645924,0.65655,12234,2633673,17,2645925,18,1
V,+,2657860,0.0740741,1.34227e-16,81,75,6,6,0,gene,W02G9.5,0,2657912,0.505796,3108,2654752,52,2657860,0,-52
V,+,2666727,0.00980392,0.0,204,202,2,2,39,gene,W02G9.4,0,2666752,0.619578,6113,2660614,25,2666693,-34,-59
V,+,2683053,0.00689655,3.25101e-42,145,144,1,1,3,gene,W02G9.2,0,2683103,0.449157,9194,2673859,50,2683053,0,-50
V,+,2694600,0.00236128,0.0,847,845,2,2,2,gene,Y45G12B.2,1,2694600,0.753558,6274,2688326,0,2694595,-5,-5
V,+,2698780,1.0,0.5,1,0,1,1,1,gene,Y45G12B.1,2,2698804,2.72542,89,2698691,24,2698799,19,-5
V,+,2698799,0.93245,0.0,755,51,704,474,29,gene,Y45G12B.1,2,2698804,2.72542,108,2698691,5,2698799,0,-5
V,+,2881220,0.00440529,0.0,227,226,1,1,0,gene,F37B4.2,0,2881221,1.55356,9287,2871933,1,2881220,0,-1
V,+,2896443,0.0,2.84217e-14,45,45,0,0,1,gene,C31B8.4,0,2896463,0.251493,1032,2895411,20,2896464,21,1
V,+,2913753,0.0,0.0625,4,4,0,0,0,gene,C31B8.3,0,2913795,None,15509,2898244,42,2914075,322,280
V,+,2914073,0.0,0.125,3,3,0,0,4,gene,C31B8.3,0,2914074,None,320,2913753,1,2914075,2,1
V,+,2915809,0.0,0.5,1,1,0,0,0,gene,C31B8.2,0,2915864,0.0542816,2056,2913753,55,2916350,541,486
V,+,3051413,0.0,4.03897e-28,91,91,0,0,0,gene,F59D6.1,0,3051414,0.192213,22003,3029410,1,3051415,2,1
V,+,3088890,0.0,0.0078125,7,7,0,0,1,gene,C50H11.1,0,3088900,0.315959,1077,3087813,10,3088901,11,1
V,+,3088898,0.0,1.20371e-35,116,116,0,0,8,gene,C50H11.1,0,3088900,0.315959,1085,3087813,2,3088901,3,1
V,+,3115107,0.0,7.10543e-15,47,47,0,0,1,gene,Y73C8C.3,0,3115129,0.0284859,23929,3091178,22,3115130,23,1
V,+,3156919,0.0,2.71051e-20,65,65,0,0,3,gene,C36C5.5,0,3156921,0.188352,17921,3138998,2,3156922,3,1
V,+,3176288,0.0,0.0078125,7,7,0,0,2,gene,C36C5.2,0,3176314,0.00411247,5531,3170757,26,3176288,0,-26
V,+,3188174,0.0208333,5.75553e-26,96,94,2,2,0,gene,Y73C8B.4,0,3188176,0.108571,5872,3182302,2,3188177,3,1
V,+,3197900,0.0,0.5,1,1,0,0,0,gene,Y73C8B.5,0,3197914,0.00626426,4092,3193808,14,3197867,-33,-47
V,+,3209999,0.0,0.5,1,1,0,0,2,gene,K08D9.3,0,3210055,0.669705,11827,3198172,56,3210018,19,-37
V,+,3210018,0.00425532,0.0,705,702,3,2,4,gene,K08D9.3,0,3210055,0.669705,11846,3198172,37,3210018,0,-37
V,+,3243113,0.027027,1.4299e-19,74,72,2,1,0,gene,T28A11.11,0,3243121,0.121975,650,3242463,8,3243122,9,1
V,+,3257408,0.0,7.88861e-31,100,100,0,0,3,gene,T28A11.22,0,3257411,0.137532,3004,3254404,3,3257412,4,1
V,+,3273878,0.0,0.0625,4,4,0,0,2,gene,T28A11.4,0,3273880,0.0172566,2811,3271067,2,3273881,3,1
V,+,3280205,0.00316456,0.0,632,630,2,1,12,gene,T28A11.2,0,3280207,0.416619,4268,3275937,2,3280205,0,-2
V,+,3339138,0.0,1.11022e-16,53,53,0,0,2,gene,C17B7.4,0,3339173,0.002394,297,3338841,35,3339174,36,1
V,+,3398516,0.0,0.0,181,181,0,0,0,gene,T20D4.11,0,3398518,0.1056,875,3397641,2,3398519,3,1
V,+,3401468,0.0,0.5,1,1,0,0,0,gene,T20D4.20,0,3401470,0.005594,625,3400843,2,3401471,3,1
V,+,3408730,0.0,0.0,193,193,0,0,8,gene,T20D4.7,0,3408737,0.175138,1011,3407719,7,3408696,-34,-41
V,+,3410346,0.0,2.38419e-07,22,22,0,0,0,gene,T20D4.6,0,3410352,0.155948,1001,3409345,6,3410346,0,-6
V,+,3460045,0.0,0.125,3,3,0,0,0,gene,F27E11.2,0,3460050,0.0328941,26527,3433518,5,3460045,0,-5
V,+,3463559,0.0833333,0.00292969,12,11,1,0,0,gene,F27E11.1,0,3463560,0.0445375,726,3462833,1,3463640,81,80
V,+,3523413,0.0,7.27596e-12,37,37,0,0,11,gene,C07G3.2,0,3523419,0.136419,3786,3519627,6,3523413,0,-6
V,+,3553007,0.0,0.00390625,8,8,0,0,106,gene,T24A6.20,0,3553042,0.316656,1871,3551136,35,3552975,-32,-67
V,+,3553018,0.0,1.13687e-13,43,43,0,0,114,gene,T24A6.20,0,3553042,0.316656,1882,3551136,24,3552975,-43,-67
V,+,3559777,0.923077,0.00158691,13,1,12,11,13,gene,T24A6.21,0,3560052,None,257,3559520,275,3560096,319,44
V,+,3578949,0.0,0.0078125,7,7,0,0,271,gene,T22F3.3,0,3578992,6.99929,4967,3573982,43,3578950,1,-42
V,+,3578975,0.0,0.25,2,2,0,0,958,gene,T22F3.3,0,3578992,6.99929,4993,3573982,17,3578996,21,4
V,+,3581223,0.0,0.0,887,887,0,0,2,gene,T22F3.3,0,3581276,6.99929,7241,3573982,53,3581223,0,-53
V,+,3586464,0.00603622,0.0,497,494,3,2,0,gene,T22F3.2,0,3586464,0.990417,1601,3584863,0,3586465,1,1
V,+,3633156,0.00101446,0.0,3943,3939,4,4,3,gene,F59B1.2,0,3633159,5.12979,44329,3588827,3,3633156,0,-3
V,+,3668575,0.0,8.67362e-19,60,60,0,0,33,gene,Y39H10B.2,0,3668593,0.461012,17303,3651272,18,3668594,19,1
V,+,3682668,0.0,9.18355e-41,133,133,0,0,0,gene,W08A12.3,0,3682700,0.301599,6163,3676505,32,3682729,61,29
V,+,3686927,0.00662252,5.32493e-44,151,150,1,1,0,gene,W08A12.1,1,3687210,1.80334,660,3686267,283,3686936,9,-274
V,+,3691617,0.0,0.000976562,10,10,0,0,1,gene,W08A12.1,1,3691647,1.80334,5350,3686267,30,3691617,0,-30
V,+,3691782,0.0,1.43493e-42,139,139,0,0,1,gene,W08A12.1,1,3691807,1.80334,5515,3686267,25,3691782,0,-25
V,+,3695786,0.0,0.0,423,423,0,0,4,gene,W08A12.1,1,3695786,1.80334,9519,3686267,0,3695786,0,0
V,+,3704810,0.169829,0.0,1054,875,179,140,0,gene,T27C4.4,2,3704826,2.01946,3154,3701656,16,3704810,0,-16
V,+,3743391,0.027027,5.37835e-38,148,144,4,4,0,gene,Y39H10A.3,0,3743392,0.516405,16936,3726455,1,3743391,0,-1
V,+,3892669,0.0,0.0,497,497,0,0,21,gene,C17E7.4,0,3892671,0.55698,76048,3816621,2,3892669,0,-2
V,+,3894772,0.0,0.0625,4,4,0,0,1,gene,C17E7.3,0,3894773,0.00328853,386,3894386,1,3894774,2,1
V,+,3905942,0.0,1.49012e-08,26,26,0,0,42,gene,C17E7.1,0,3905953,0.0724903,1584,3904358,11,3905954,12,1
V,+,3987667,0.0,0.5,1,1,0,0,0,gene,B0213.3,0,3987746,1.84105,3007,3984660,79,3987713,46,-33
V,+,4094864,0.0,2.27374e-13,42,42,0,0,0,gene,F38H12.3,0,4094867,0.045743,17503,4077361,3,4094868,4,1
V,+,4131737,0.0,3.8147e-06,18,18,0,0,4,gene,T05B4.2,0,4131749,0.253457,1017,4130720,12,4131738,1,-11
V,+,4144319,0.0123239,0.0,568,561,7,6,0,gene,Y45G5AL.1,0,4144332,2.30752,1353,4142966,13,4144319,0,-13
V,+,4160197,0.0,1.12104e-44,146,146,0,0,0,gene,Y45G5AM.5,0,4160199,0.336327,12812,4147385,2,4160200,3,1
V,+,4163023,0.333333,0.375,3,2,1,1,0,gene,Y45G5AM.4,0,4163035,0.000713474,2289,4160734,12,4163036,13,1
V,+,4164460,0.0,0.25,2,2,0,0,18,gene,Y45G5AM.3,0,4164521,0.325722,1035,4163425,61,4164658,198,137
V,+,4164645,0.0151515,8.94467e-19,66,65,1,1,4,gene,Y45G5AM.3,0,4164657,0.325722,1220,4163425,12,4164658,13,1
V,+,4175712,0.0,1.90735e-06,19,19,0,0,10,gene,Y45G5AM.2,0,4175737,0.242642,9076,4166636,25,4175701,-11,-36
V,+,4175721,0.0,6.77626e-21,67,67,0,0,49,gene,Y45G5AM.2,0,4175737,0.242642,9085,4166636,16,4175701,-20,-36
V,+,4187017,0.00416667,0.0,240,239,1,1,20,gene,Y45G5AM.1,0,4187022,1.35656,5850,4181167,5,4187017,0,-5
V,+,4195428,0.0,0.0,363,363,0,0,23,gene,H43I07.3,1,4195429,0.714717,5608,4189820,1,4195430,2,1
V,+,4199299,0.902606,0.0,729,71,658,464,4,gene,H43I07.2,2,4199304,1.08735,116,4199183,5,4199299,0,-5
V,+,4204537,0.957895,2.24208e-44,190,8,182,130,1,gene,H43I07.1,3,4204542,0.827608,1029,4203508,5,4204604,67,62
V,+,4219457,0.0168067,1.0564e-32,119,117,2,1,0,gene,E03D2.2,0,4219480,1.15637,9888,4209569,23,4219457,0,-23
V,+,4236232,0.0053286,0.0,1126,1120,6,1,0,gene,E03D2.1,0,4236240,2.03491,14175,4222057,8,4236232,0,-8
V,+,4346980,0.00338983,0.0,2360,2352,8,5,3,gene,F32D1.10,0,4347011,5.50826,8290,4338690,31,4346980,0,-31
V,+,4422220,0.0,0.0,3608,3608,0,0,1,gene,Y47D7A.1,0,4422240,2.67505,1660,4420560,20,4422220,0,-20
V,+,4483318,0.00104767,0.0,1909,1907,2,2,403,gene,T08H10.1,0,4483318,4.76407,6518,4476800,0,4483282,-36,-36
V,+,4497277,0.00117233,0.0,853,852,1,1,1,gene,T28F12.2,0,4497280,2.16405,10931,4486346,3,4497277,0,-3
V,+,4501033,0.0,3.05176e-05,15,15,0,0,2,gene,T28F12.2,0,4501042,2.16405,14687,4486346,9,4501033,0,-9
V,+,4502397,0.0,6.77626e-21,67,67,0,0,0,gene,T28F12.2,0,4502453,2.16405,679,4501718,56,4502397,0,-56
V,+,4505643,0.0,0.0078125,7,7,0,0,4,gene,T28F12.2,0,4505739,2.16405,1316,4504327,96,4505643,0,-96
V,+,4509693,0.0,0.00012207,13,13,0,0,4,gene,T28F12.2,0,4509726,2.16405,5366,4504327,33,4509693,0,-33
V,+,4553172,0.0,0.03125,5,5,0,0,3,gene,Y61A9LA.12,0,4553227,0.0255877,36411,4516761,55,4553686,514,459
V,+,4570831,0.0,0.0625,4,4,0,0,1,gene,Y61A9LA.3,0,4570956,0.591415,9275,4561556,125,4570957,126,1
V,+,4570949,0.00585938,0.0,512,509,3,2,3,gene,Y61A9LA.3,0,4570956,0.591415,9393,4561556,7,4570957,8,1
V,+,4615972,0.00619195,0.0,646,642,4,4,3,gene,F54D11.4,1,4615980,1.53456,14144,4601828,8,4615996,24,16
V,+,4617752,0.787234,3.67924e-05,47,10,37,27,0,gene,F54D11.2,2,4617760,1.05972,166,4617586,8,4617752,0,-8
V,+,4628394,0.0,0.00390625,8,8,0,0,0,gene,F54D11.1,0,4628422,8.13362,58,4628336,28,4628394,0,-28
V,+,4642768,0.00826446,4.55151e-35,121,120,1,0,0,gene,F41F3.2,0,4642783,0.320115,7691,4635077,15,4642766,-2,-17
V,+,4648643,0.0174672,0.0,229,225,4,4,65,gene,F41F3.8,0,4648645,0.687692,1898,4646745,2,4648646,3,1
V,+,4683703,0.0,0.0,1415,1415,0,0,28,gene,K03B4.4,0,4683741,1.29471,28055,4655648,38,4683742,39,1
V,+,4686923,0.0061665,0.0,973,967,6,5,2,gene,K03B4.3,1,4686927,1.91367,1998,4684925,4,4686923,0,-4
V,+,4687808,0.851528,0.0,916,136,780,553,13,gene,K03B4.2,2,4687820,2.3681,95,4687713,12,4687808,0,-12
V,+,4689144,0.977778,0.0,180,4,176,112,1,gene,K03B4.1,3,4689153,0.886872,99,4689045,9,4689144,0,-9
V,+,4689150,0.9375,6.14477e-11,48,3,45,31,270,gene,K03B4.1,3,4689153,0.886872,105,4689045,3,4689144,-6,-9
V,+,4722434,0.0,0.0,211,211,0,0,1,gene,F39G3.5,0,4722458,0.56375,7694,4714740,24,4722434,0,-24
V,+,4737651,0.0,0.00390625,8,8,0,0,1,gene,F39G3.2,0,4737658,0.0679411,3114,4734537,7,4737581,-70,-77
V,+,4755799,0.0130548,0.0,766,756,10,8,7,gene,C18G1.4,0,4755823,1.1611,531,4755268,24,4755799,0,-24
V,+,4771607,0.0,0.25,2,2,0,0,49,gene,C18G1.2,0,4771651,0.427481,7615,4763992,44,4771607,0,-44
V,+,4794493,0.0183486,9.06882e-30,109,107,2,2,25,gene,R02F11.2,0,4794500,0.0701584,1625,4792868,7,4794413,-80,-87
V,+,4800908,0.00925926,0.0,432,428,4,3,1,gene,R02F11.1,0,4800961,3.38789,4080,4796828,53,4800913,5,-48
V,+,4827174,0.00236967,0.0,422,421,1,1,0,gene,C37H5.5,0,4827178,0.877089,24753,4802421,4,4827174,0,-4
V,+,4855139,0.0,4.44089e-16,51,51,0,0,0,gene,C37H5.1,0,4855198,0.332024,5491,4849648,59,4855139,0,-59
V,+,4872108,0.0,3.05176e-05,15,15,0,0,0,gene,T19H12.4,0,4872116,0.0287681,1939,4870169,8,4872117,9,1
V,+,4890243,0.0,0.125,3,3,0,0,0,gene,T19H12.2,0,4890262,6.18875,3621,4886622,19,4890243,0,-19
V,+,4975299,0.0,6.61744e-24,77,77,0,0,2,gene,F26G5.1,0,4975307,0.291753,16913,4958386,8,4975299,0,-8
V,+,5019037,0.0137931,2.34073e-40,145,143,2,1,13,gene,K11D12.3,0,5019052,0.637481,4012,5015025,15,5019037,0,-15
V,+,5049420,0.00430416,0.0,697,694,3,3,418,gene,K11D12.2,1,5049632,2.53152,15436,5033984,212,5049420,0,-212
V,+,5049970,0.0,7.27596e-12,37,37,0,0,0,gene,K11D12.2,1,5049987,2.53152,15986,5033984,17,5049970,0,-17
V,+,5052074,0.973913,5.94402e-30,115,3,112,74,1,gene,K11D12.12,2,5052085,0.284877,47,5052027,11,5052086,12,1
V,+,5052086,1.0,0.0078125,7,0,7,4,183,gene,K11D12.12,2,5052255,0.284877,59,5052027,169,5052086,0,-169
V,+,5119783,0.0,4.44089e-16,51,51,0,0,6,gene,C04F5.1,0,5119789,0.339439,57068,5062715,6,5119783,0,-6
V,+,5132554,0.0,1.90735e-06,19,19,0,0,0,gene,F14F9.4,0,5132573,0.0832102,1199,5131355,19,5132554,0,-19
V,+,5138008,0.0,0.0078125,7,7,0,0,0,gene,F14F9.3,0,5138031,0.00413463,1126,5136882,23,5138008,0,-23
V,+,5204291,0.0188679,5.88418e-15,53,52,1,0,0,gene,Y47A7.1,0,5204292,0.269091,20675,5183616,1,5204293,2,1
V,+,5226818,0.148649,2.21278e-10,74,63,11,9,0,gene,Y49G5B.1,0,5226826,0.551706,13542,5213276,8,5226818,0,-8
V,+,5240079,0.0,0.125,3,3,0,0,8,gene,B0238.15,0,5240103,0.0528625,9865,5230214,24,5240001,-78,-102
V,+,5269297,0.00965018,0.0,829,821,8,6,2,gene,B0238.11,0,5269301,2.86085,662,5268635,4,5269297,0,-4
V,+,5273888,0.20993,0.0,2296,1814,482,377,0,gene,B0238.10,0,5273913,2.85604,3281,5270607,25,5273888,0,-25
V,+,5303501,0.00634921,0.0,315,313,2,2,2,gene,C10G8.5,0,5303504,2.52921,28130,5275371,3,5303501,0,-3
V,+,5312518,0.5,0.375,4,2,2,1,1,gene,C10G8.3,0,5312590,0.0531939,394,5312124,72,5312702,184,112
V,+,5365308,0.0,0.00195312,9,9,0,0,0,gene,T09D3.8,0,5365330,0.0286032,12429,5352879,22,5365306,-2,-24
V,+,5405170,0.0,8.67362e-19,60,60,0,0,0,gene,C35A11.1,0,5405170,0.131195,15914,5389256,0,5405170,0,0
V,+,5428009,0.0,0.0,1080,1080,0,0,27,gene,F08F3.3,0,5428028,4.50716,3624,5424385,19,5428009,0,-19
V,+,5433204,0.00636943,1.4013e-45,157,156,1,1,7,gene,F08F3.2,0,5433228,0.627321,2950,5430254,24,5433204,0,-24
V,+,5445952,0.117647,0.0010376,17,15,2,1,0,gene,F08F3.1,0,5445954,0.0733029,5175,5440777,2,5445966,14,12
V,+,5459987,0.0,6.93889e-18,57,57,0,0,15,gene,ZC317.2,0,5459988,0.0736572,1181,5458806,1,5459918,-69,-70
V,+,5514160,0.348837,0.000184368,129,84,45,12,1,gene,C24G6.3,0,5514206,0.596648,4393,5509767,46,5514160,0,-46
V,+,5523539,0.0,0.0,167,167,0,0,0,gene,C24G6.2,0,5523554,0.377563,3268,5520271,15,5523539,0,-15
V,+,5558704,0.0,0.015625,6,6,0,0,0,gene,C18C4.1,0,5558711,0.0149673,12084,5546620,7,5558702,-2,-9
V,+,5589731,0.0,0.0078125,7,7,0,0,0,gene,CD4.5,0,5589799,0.00590632,3419,5586312,68,5589464,-267,-335
V,+,5592513,0.00546448,0.0,549,546,3,3,0,gene,CD4.4,1,5592518,1.67965,1238,5591275,5,5592519,6,1
V,+,5593518,0.925651,0.0,269,20,249,174,31,gene,CD4.3,2,5593521,1.27743,97,5593421,3,5593521,3,0
V,+,5593521,0.865385,5.95019e-22,156,21,135,88,64,gene,CD4.3,2,5593521,1.27743,100,5593421,0,5593521,0,0
V,+,5594427,0.775424,2.19917e-18,236,53,183,117,0,gene,CD4.2,3,5594457,0.38677,116,5594311,30,5594427,0,-30
V,+,5594457,1.0,0.5,1,0,1,0,168,gene,CD4.2,3,5594457,0.38677,146,5594311,0,5594427,-30,-30
V,+,5623504,0.0,0.0078125,7,7,0,0,3,gene,M03E7.1,0,5623625,0.256418,5355,5618149,121,5623454,-50,-171
V,+,5654261,0.0,0.0,379,379,0,0,1,gene,C14C11.3,0,5654279,0.772464,3391,5650870,18,5654261,0,-18
V,+,5684689,0.0588235,2.75924e-15,68,64,4,1,3,gene,F25B4.4,0,5684699,0.568805,19614,5665075,10,5684697,8,-2
V,+,5709230,0.0,1.50463e-36,119,119,0,0,2,gene,F25B4.2,0,5709233,0.746614,3350,5705880,3,5709230,0,-3
V,+,5712740,0.00877193,0.0,228,226,2,1,981,gene,F25B4.1,0,5712754,2.00558,593,5712147,14,5712740,0,-14
V,+,5712743,0.0,0.0,206,206,0,0,930,gene,F25B4.1,0,5712754,2.00558,596,5712147,11,5712740,-3,-14
V,+,5712775,0.0,4.54747e-13,41,41,0,0,1843,gene,F25B4.1,0,5712788,2.00558,628,5712147,13,5712740,-35,-48
V,+,5717697,0.00720721,0.0,555,551,4,4,0,gene,K09H11.3,0,5717716,0.613759,813,5716884,19,5717695,-2,-21
V,+,5747631,0.0,4.81482e-35,114,114,0,0,19,gene,K09H11.1,0,5747631,0.403953,13255,5734376,0,5747631,0,0
V,+,5770267,0.00210231,0.0,1427,1424,3,3,16,gene,F44E7.2,0,5770269,1.01536,5264,5765003,2,5770266,-1,-3
V,+,5791041,0.00769724,0.0,1559,1547,12,12,0,gene,F44E7.9,1,5791045,2.70441,723,5790318,4,5791046,5,1
V,+,5826644,0.00641026,0.0,468,465,3,2,0,gene,F26F12.7,1,5826671,1.81402,19303,5807341,27,5826644,0,-27
V,+,5880870,0.0,9.53674e-07,20,20,0,0,2,gene,C02G6.3,0,5880942,0.0989357,1117,5879753,72,5880922,52,-20
V,+,5893130,0.0045045,0.0,222,221,1,0,4,gene,C04E6.7,0,5893156,0.21585,10835,5882295,26,5893137,7,-19
V,+,5912570,0.0,0.0,412,412,0,0,188,gene,C04E6.13,0,5912576,0.866097,3030,5909540,6,5912568,-2,-8
V,+,5939835,0.00298329,0.0,1676,1671,5,3,0,gene,M03F8.3,1,5939843,1.18877,814,5939021,8,5939835,0,-8
V,+,5943285,0.942708,3.89631e-41,192,11,181,138,11,gene,M03F8.2,2,5943299,0.673602,112,5943173,14,5943285,0,-14
V,+,5943293,1.0,0.25,2,0,2,1,475,gene,M03F8.2,2,5943299,0.673602,120,5943173,6,5943285,-8,-14
V,+,5951244,0.0,0.0,153,153,0,0,0,gene,M03F8.1,0,5951245,0.244362,17,5951227,1,5951246,2,1
V,+,5964752,0.0136986,7.72918e-21,73,72,1,1,0,gene,C10F3.4,0,5964773,0.314947,11058,5953694,21,5964752,0,-21
V,+,5975833,0.0,1.52588e-05,16,16,0,0,1,gene,C10F3.3,0,5975839,0.0402919,6849,5968984,6,5975840,7,1
V,+,5983556,0.0,7.10543e-15,47,47,0,0,0,gene,C10F3.2,0,5983556,0.138368,2232,5981324,0,5983556,0,0
V,+,6003412,0.00178253,0.0,561,560,1,1,2,gene,F29G9.4,0,6003497,1.12088,4257,5999155,85,6003412,0,-85
V,+,6010689,0.0,0.0078125,7,7,0,0,9,gene,F29G9.4,0,6010714,1.12088,11534,5999155,25,6010912,223,198
V,+,6017738,0.0,1.52588e-05,16,16,0,0,20,gene,F29G9.3,1,6017785,1.61765,1864,6015874,47,6017781,43,-4
V,+,6017781,0.00816104,0.0,1838,1823,15,12,22,gene,F29G9.3,1,6017785,1.61765,1907,6015874,4,6017781,0,-4
V,+,6018789,1.0,0.000976562,10,0,10,9,3,gene,F29G9.2,2,6018816,1.23792,33,6018756,27,6018805,16,-11
V,+,6018805,0.936283,0.0,1130,72,1058,880,23,gene,F29G9.2,2,6018816,1.23792,49,6018756,11,6018805,0,-11
V,+,6023285,0.00465658,0.0,859,855,4,4,3,gene,F29G9.2,2,6023289,1.23792,4529,6018756,4,6023285,0,-4
V,+,6043873,0.00241973,0.0,10745,10719,26,24,51,gene,R01B10.1,0,6043914,28.0023,2199,6041674,41,6043873,0,-41
V,+,6096916,0.940397,0.0,302,18,284,233,0,gene,Y38A10A.6,2,6096940,11.7874,12,6096904,24,6096916,0,-24
V,+,6107639,0.0107527,0.0,465,460,5,4,10,gene,F17A9.2,0,6107675,0.754134,298,6107341,36,6107639,0,-36
V,+,6141282,0.0,2.27374e-13,42,42,0,0,12,gene,F12F3.1,0,6141294,0.309162,23590,6117692,12,6141282,0,-12
V,+,6141520,0.0,0.5,1,1,0,0,9,gene,F12F3.1,0,6141566,0.309162,23828,6117692,46,6141520,0,-46
V,+,6209672,0.0,9.53674e-07,20,20,0,0,0,gene,W06H8.1,0,6209687,3.76089,1301,6208371,15,6209672,0,-15
V,+,6210498,0.0,0.000976562,10,10,0,0,0,gene,W06H8.1,0,6210836,3.76089,2127,6208371,338,6210498,0,-338
V,+,6214631,0.0,3.23117e-27,88,88,0,0,1,gene,W06H8.1,0,6214669,3.76089,3668,6210963,38,6214636,5,-33
V,+,6214638,0.0071599,0.0,419,416,3,2,16,gene,W06H8.1,0,6214669,3.76089,3675,6210963,31,6214638,0,-31
V,+,6234987,0.00444444,0.0,225,224,1,0,0,gene,K08B12.3,0,6234993,0.208581,17520,6217467,6,6234994,7,1
V,+,6248983,0.0,0.0,395,395,0,0,1,gene,K08B12.2,0,6249096,2.40787,11412,6237571,113,6248983,0,-113
V,+,6276301,0.0,0.125,3,3,0,0,296,gene,F31F7.1,0,6276309,2.21779,1579,6274722,8,6276251,-50,-58
V,+,6276667,0.0,0.0,1087,1087,0,0,134,gene,F31F7.1,0,6276708,2.21779,1945,6274722,41,6276709,42,1
V,+,6276793,0.0,0.0625,4,4,0,0,254,gene,F31F7.1,0,6276879,2.21779,2071,6274722,86,6276709,-84,-170
V,+,6303585,0.0,0.0,260,260,0,0,1,gene,K12B6.1,0,6303609,0.742068,14096,6289489,24,6303610,25,1
V,+,6323018,0.0,7.62939e-06,17,17,0,0,1,gene,T28C12.4,0,6323092,0.368198,6740,6316278,74,6323016,-2,-76
V,+,6323234,0.0,0.5,1,1,0,0,41,gene,T28C12.4,0,6323269,0.368198,6956,6316278,35,6323088,-146,-181
V,+,6329008,0.0,3.55271e-15,48,48,0,0,1,gene,T28C12.2,0,6329018,0.0787212,353,6328655,10,6329008,0,-10
V,+,6356286,0.00369004,0.0,271,270,1,1,0,gene,F13H6.1,0,6356358,1.9806,22467,6333819,72,6356286,0,-72
V,+,6433941,0.00223048,0.0,1345,1342,3,3,0,gene,T05H4.6,1,6433970,2.94301,16676,6417265,29,6433941,0,-29
V,+,6436456,0.443282,7.53022e-06,1243,692,551,368,73,gene,T05H4.5,2,6436457,4.42232,235,6436221,1,6436456,0,-1
V,+,6438718,0.0,9.31323e-10,30,30,0,0,0,gene,T05H4.4,0,6438746,0.0271786,1024,6437694,28,6438747,29,1
V,+,6450681,0.00815217,0.0,368,365,3,3,2,gene,T05H4.1,1,6450700,0.696577,653,6450028,19,6450709,28,9
V,+,6452558,0.0,0.00390625,8,8,0,0,1,gene,ZK40.1,2,6452634,1.49681,562,6451996,76,6453007,449,373
V,+,6453037,0.929752,0.0,484,34,450,322,19,gene,ZK40.1,2,6453037,1.49681,127,6452910,0,6453037,0,0
V,+,6464876,0.0,0.0,229,229,0,0,0,gene,W01A11.3,0,6464907,1.29994,10100,6454776,31,6464876,0,-31
V,+,6466816,0.0,0.03125,5,5,0,0,0,gene,W01A11.3,0,6466955,1.29994,12040,6454776,139,6466816,0,-139
V,+,6467144,1.0,0.25,2,0,2,1,1,gene,W01A11.3,0,6467221,1.29994,12368,6454776,77,6466816,-328,-405
V,+,6471693,0.0188679,5.88418e-15,53,52,1,1,0,gene,W01A11.3,0,6471700,1.29994,16917,6454776,7,6471693,0,-7
V,+,6480582,0.0,1.52588e-05,16,16,0,0,0,gene,W01A11.3,0,6480785,1.29994,25806,6454776,203,6480786,204,1
V,+,6496919,0.0,0.0,247,247,0,0,0,gene,W01A11.2,1,6496920,0.359608,9228,6487691,1,6496921,2,1
V,+,6499035,0.484582,0.0475088,227,117,110,95,1,gene,W01A11.1,2,6499093,1.42935,740,6498295,58,6499035,0,-58
V,+,6520246,0.0,0.0,1068,1068,0,0,2,gene,F46E10.2,0,6520258,1.84786,1013,6519233,12,6520246,0,-12
V,+,6524476,0.0,0.5,1,1,0,0,2,gene,F46E10.1,0,6524510,1.55835,2613,6521863,34,6524800,324,290
V,+,6524872,0.0,1.13687e-13,43,43,0,0,621,gene,F46E10.1,0,6524905,1.55835,3009,6521863,33,6524842,-30,-63
V,+,6527286,0.0,8.27181e-25,80,80,0,0,2,gene,F46E10.1,0,6527321,1.55835,5423,6521863,35,6527286,0,-35
V,+,6529033,0.0,0.00390625,8,8,0,0,1,gene,F46E10.1,0,6529079,1.55835,7170,6521863,46,6529033,0,-46
V,+,6553361,0.0,0.5,1,1,0,0,1,gene,K04A8.3,0,6553375,0.0650336,1722,6551639,14,6553825,464,450
V,+,6566370,0.0,7.10543e-15,47,47,0,0,0,gene,K04A8.1,0,6566386,0.482567,2378,6563992,16,6566370,0,-16
V,+,6585442,0.0,0.03125,5,5,0,0,2,gene,ZK1055.4,0,6585442,0.0501719,1241,6584201,0,6585410,-32,-32
V,+,6594015,0.00276817,0.0,1445,1441,4,4,2,gene,ZK1055.1,0,6594036,1.23565,570,6593445,21,6594037,22,1
V,+,6633042,0.0,3.63798e-12,38,38,0,0,1,gene,T10H9.2,0,6633079,0.105643,8537,6624505,37,6633080,38,1
V,+,6649421,0.0,0.00012207,13,13,0,0,1,gene,T10H9.1,0,6649427,0.0306866,9945,6639476,6,6649428,7,1
V,+,6652168,0.0,1.90735e-06,19,19,0,0,6,gene,T10H9.8,0,6652264,0.56053,3,6652165,96,6652265,97,1
V,+,6669633,0.0,0.0625,4,4,0,0,0,gene,K11G9.3,0,6669633,0.004689,16088,6653545,0,6669634,1,1
V,+,6674078,0.0,9.53674e-07,20,20,0,0,0,gene,K11G9.2,0,6674078,0.0895757,2231,6671847,0,6674079,1,1
V,+,6676610,0.0,0.00012207,13,13,0,0,2,gene,K11G9.1,0,6676610,0.0468996,382,6676228,0,6676610,0,0
V,+,6702893,0.0101523,0.0,591,585,6,6,41,gene,W02F12.3,0,6702897,2.26553,23976,6678917,4,6702868,-25,-29
V,+,6727649,0.0,2.38419e-07,22,22,0,0,4,gene,ZC487.1,0,6727650,0.187202,11604,6716045,1,6727649,0,-1
V,+,6744892,0.0,0.0,151,151,0,0,6,gene,T25F10.3,0,6744933,0.89055,14858,6730034,41,6744892,0,-41
V,+,6757946,0.0,1.2326e-32,106,106,0,0,0,gene,T25F10.2,0,6757952,0.279723,9544,6748402,6,6757946,0,-6
V,+,6785258,0.0,0.015625,6,6,0,0,0,gene,ZC404.3,0,6785283,0.742528,2256,6783002,25,6785268,10,-15
V,+,6785268,0.0238095,1.80222e-22,84,82,2,2,3,gene,ZC404.3,0,6785283,0.742528,2266,6783002,15,6785268,0,-15
V,+,6794008,0.0,0.000976562,10,10,0,0,2,gene,ZC404.1,0,6794049,0.042145,5738,6788270,41,6793747,-261,-302
V,+,6810232,0.0,0.000488281,11,11,0,0,1,gene,T15B7.10,0,6810287,0.0116151,14651,6795581,55,6810437,205,150
V,+,6839100,0.00254323,0.0,1966,1961,5,4,111,gene,T15B7.2,0,6839106,7.01389,2590,6836510,6,6839100,0,-6
V,+,6870116,0.0,0.000244141,12,12,0,0,0,gene,T19F4.1,0,6870119,0.0921224,23637,6846479,3,6870120,4,1
V,+,6881154,0.0,0.0,173,173,0,0,1,gene,K11C4.3,0,6881199,2.98111,7535,6873619,45,6881154,0,-45
V,+,6894895,0.0,1.03398e-25,83,83,0,0,1,gene,K11C4.2,0,6894897,0.193308,2864,6892031,2,6894898,3,1
V,+,6956347,0.0,6.10352e-05,14,14,0,0,0,gene,T07H8.4,0,6956367,0.122845,7674,6948673,20,6956347,0,-20
V,+,6998629,0.00327869,0.0,305,304,1,1,16,gene,C33G8.6,0,6998705,0.395405,21396,6977233,76,6998629,0,-76
V,+,7003960,0.0,0.00195312,9,9,0,0,0,gene,C33G8.5,0,7003960,0.0437598,3518,7000442,0,7003960,0,0
V,+,7009875,0.0,0.000976562,10,10,0,0,8,gene,C33G8.2,0,7009903,0.29815,1735,7008140,28,7009571,-304,-332
V,+,7046121,0.0,0.0625,4,4,0,0,0,gene,F20A1.2,0,7046121,0.0232758,27658,7018463,0,7046122,1,1
V,+,7060621,0.00630631,0.0,1110,1103,7,6,10,gene,Y57E12AL.1,1,7060624,3.08495,5475,7055146,3,7060621,0,-3
V,+,7062984,0.637168,0.0,3390,1230,2160,1357,1,gene,Y57E12AM.1,2,7062989,6.31428,480,7062504,5,7062984,0,-5
V,+,7074703,0.0,6.77626e-21,67,67,0,0,1,gene,F27B10.1,0,7074733,0.50918,11203,7063500,30,7074703,0,-30
V,+,7075690,0.0,0.000976562,10,10,0,0,6,gene,VC5.3,0,7075770,4.88605,45,7075645,80,7075745,55,-25
V,+,7085767,0.0,1.19209e-07,23,23,0,0,5,gene,VC5.2,0,7085841,0.306126,4379,7081388,74,7085767,0,-74
V,+,7103355,0.0,0.000244141,12,12,0,0,0,gene,T01C4.2,0,7103506,0.310511,14688,7088667,151,7103507,152,1
V,+,7123462,0.0,6.10352e-05,14,14,0,0,1,gene,T01C4.1,0,7123466,0.0130189,9140,7114322,4,7123467,5,1
V,+,7157182,0.0,0.0625,4,4,0,0,26,gene,F10D2.2,0,7157247,0.138862,21747,7135435,65,7157311,129,64
V,+,7175331,0.0,4.44089e-16,51,51,0,0,1,gene,F09G2.5,0,7175365,0.192532,6317,7169014,34,7175379,48,14
V,+,7178987,0.00900901,0.0,222,220,2,2,0,gene,F09G2.4,0,7179016,0.641453,394,7178593,29,7179008,21,-8
V,+,7184824,0.0,0.000488281,11,11,0,0,0,gene,F09G2.3,0,7184943,0.344021,2163,7182661,119,7184824,0,-119
V,+,7196725,0.00566572,0.0,1765,1755,10,9,23,gene,F09G2.2,0,7196754,2.83217,8360,7188365,29,7196725,0,-29
V,+,7200043,0.0272374,0.0,257,250,7,6,1,gene,F09G2.1,0,7200054,0.159293,1797,7198246,11,7200033,-10,-21
V,+,7221283,0.0168776,0.0,474,466,8,7,0,gene,C13F10.2,0,7221288,1.07211,15865,7205418,5,7221289,6,1
V,+,7224136,0.0,0.015625,6,6,0,0,132,gene,C13F10.1,0,7224172,0.410189,2126,7222010,36,7223888,-248,-284
V,+,7225155,0.00364299,0.0,1098,1094,4,3,37,gene,C05C8.3,0,7225178,2.74489,45,7225110,23,7225179,24,1
V,+,7231000,0.00796813,0.0,753,747,6,4,0,gene,C05C8.2,0,7231049,0.984859,4889,7226111,49,7231000,0,-49
V,+,7237225,0.0,1.92593e-34,112,112,0,0,51,gene,C05C8.9,1,7237367,0.54456,4666,7232559,142,7237208,-17,-159
V,+,7239581,0.801865,1.94671e-38,429,85,344,205,0,gene,C05C8.1,2,7239711,0.849175,114,7239467,130,7239581,0,-130
V,+,7279200,0.0,0.0625,4,4,0,0,0,gene,C13A2.4,0,7279207,0.022302,928,7278272,7,7279200,0,-7
V,+,7331136,0.166667,0.09375,6,5,1,0,3,gene,F10G2.2,0,7331189,0.104944,1325,7329811,53,7331026,-110,-163
V,+,7332369,0.00117786,0.0,1698,1696,2,1,1,gene,F10G2.1,0,7332371,1.58395,780,7331589,2,7332372,3,1
V,+,7341998,0.0606061,6.14673e-08,33,31,2,2,2,gene,C03G6.10,0,7342046,0.0339533,144,7341854,48,7341998,0,-48
V,+,7346113,0.0,0.125,3,3,0,0,1,gene,C03G6.8,0,7346219,0.0458563,1379,7344734,106,7346500,387,281
V,+,7365061,0.00210526,0.0,475,474,1,1,3,gene,C03G6.5,0,7365063,0.669843,6369,7358692,2,7365053,-8,-10
V,+,7369525,0.0,0.0078125,7,7,0,0,3,gene,C03G6.3,0,7369557,0.0487205,2097,7367428,32,7369570,45,13
V,+,7414840,0.0,0.125,3,3,0,0,372,gene,F18E3.12,0,7414920,None,1277,7413563,80,7414750,-90,-170
V,+,7414904,0.0,0.03125,5,5,0,0,136,gene,F18E3.12,0,7414920,None,1341,7413563,16,7414750,-154,-170
V,+,7416083,0.0,0.5,1,1,0,0,419,gene,F18E3.13,0,7416099,None,1020,7415063,16,7415925,-158,-174
V,+,7435739,0.00244798,0.0,817,815,2,1,15,gene,F25E5.8,0,7435750,2.55215,2733,7433006,11,7435739,0,-11
V,+,7438094,0.0,4.65661e-10,31,31,0,0,1,gene,F25E5.16,0,7438130,0.0760464,1332,7436762,36,7438131,37,1
V,+,7445066,0.0,0.5,1,1,0,0,2,gene,F25E5.6,0,7445083,0.0298196,3731,7441335,17,7445084,18,1
V,+,7447082,0.0,1.13687e-13,43,43,0,0,1,gene,F25E5.5,0,7447084,0.193896,552,7446530,2,7447082,0,-2
V,+,7455627,0.0,1.26218e-29,96,96,0,0,1,gene,F25E5.2,0,7455635,0.123859,2871,7452756,8,7455636,9,1
V,+,7465700,0.0,5.29396e-23,74,74,0,0,0,gene,F25E5.1,0,7465705,0.297226,8296,7457404,5,7465698,-2,-7
V,+,7508803,0.0,0.0078125,7,7,0,0,1,gene,C54F6.9,0,7508808,0.0232007,9939,7498864,5,7508803,0,-5
V,+,7511946,0.0,3.05176e-05,15,15,0,0,0,gene,C54F6.8,0,7511963,0.0169312,1535,7510411,17,7511946,0,-17
V,+,7524819,0.0,3.8147e-06,18,18,0,0,4,gene,C54F6.6,0,7524819,0.0940966,918,7523901,0,7524819,0,0
V,+,7528925,0.00141443,0.0,4949,4942,7,5,0,gene,C54F6.5,1,7528925,7.41396,1111,7527814,0,7528926,1,1
V,+,7587797,0.0149254,4.5401e-19,67,66,1,1,0,gene,C50E3.5,0,7587806,0.532722,6406,7581391,9,7587805,8,-1
V,+,7587805,0.0,0.0,262,262,0,0,60,gene,C50E3.5,0,7587806,0.532722,6414,7581391,1,7587805,0,-1
V,+,7624761,0.00355619,0.0,1406,1401,5,4,0,gene,F07C4.7,0,7624761,1.00805,4583,7620178,0,7624761,0,0
V,+,7671648,0.0,0.25,2,2,0,0,0,gene,C12D5.4,0,7671729,0.0508566,2853,7668795,81,7671898,250,169
V,+,7696951,0.0,0.03125,5,5,0,0,1,gene,ZK105.3,0,7697005,0.0356622,4731,7692220,54,7696951,0,-54
V,+,7713806,0.0,0.0,673,673,0,0,22,gene,ZK105.1,0,7713808,1.2268,4544,7709262,2,7713809,3,1
V,+,7713855,0.0,0.0625,4,4,0,0,92,gene,ZK105.1,0,7713863,1.2268,4593,7709262,8,7713809,-46,-54
V,+,7728688,0.0145228,0.0,482,475,7,2,19,gene,Y97E10C.1,0,7728700,7.18659,2677,7726011,12,7728688,0,-12
V,+,7748672,0.0,0.0,1041,1041,0,0,1,gene,T05B11.1,0,7748672,0.912817,9267,7739405,0,7748673,1,1
V,+,7760419,0.0,0.0,250,250,0,0,2,gene,C26F1.7,0,7760419,0.653264,9191,7751228,0,7760419,0,0
V,+,7771076,0.0,5.82077e-11,34,34,0,0,0,gene,C26F1.6,0,7771082,0.0522142,9653,7761423,6,7771137,61,55
V,+,7774546,0.0,0.125,3,3,0,0,64,gene,C26F1.5,0,7774546,0.645977,1463,7773083,0,7774325,-221,-221
V,+,7776387,0.00376581,0.0,42222,42063,159,143,0,gene,C26F1.4,1,7776387,108.542,819,7775568,0,7776387,0,0
V,+,7777109,0.88005,0.0,792,95,697,556,2,gene,C26F1.3,2,7777157,1.05567,56,7777053,48,7777109,0,-48
V,+,7781620,0.0243902,6.86767e-22,82,80,2,0,0,gene,C26F1.2,0,7781623,0.269469,2826,7778794,3,7781620,0,-3
V,+,7785226,0.00361011,0.0,554,552,2,2,1,gene,C26F1.1,0,7785227,3.97561,826,7784400,1,7785228,2,1
V,+,7793176,0.0173913,1.57806e-31,115,113,2,2,0,gene,C26F1.10,0,7793178,1.44829,5655,7787521,2,7793174,-2,-4
V,+,7804873,0.00180723,0.0,1660,1657,3,3,0,gene,ZK742.1,0,7805135,4.17666,4449,7800424,262,7804873,0,-262
V,+,7805184,0.0,0.015625,6,6,0,0,242,gene,ZK742.1,0,7805185,4.17666,4760,7800424,1,7805152,-32,-33
V,+,7812419,0.0,0.5,1,1,0,0,0,gene,ZK742.1,0,7812463,4.17666,4243,7808176,44,7812463,44,0
V,+,7820387,0.0239234,0.0,418,408,10,8,50,gene,ZK742.5,0,7820395,1.23375,5925,7814462,8,7820396,9,1
V,+,7827031,0.0,0.0078125,7,7,0,0,10,gene,C37C3.6,0,7827108,6.12163,5749,7821282,77,7827099,68,-9
V,+,7827041,0.00196078,0.0,510,509,1,1,25,gene,C37C3.6,0,7827108,6.12163,5759,7821282,67,7827041,0,-67
V,+,7827072,0.025,3.63798e-11,40,39,1,1,84,gene,C37C3.6,0,7827108,6.12163,5790,7821282,36,7827099,27,-9
V,+,7827099,0.00121803,0.0,821,820,1,1,110,gene,C37C3.6,0,7827108,6.12163,5817,7821282,9,7827099,0,-9
V,+,7854363,0.0,0.000488281,11,11,0,0,12,gene,C37C3.2,1,7854379,5.00749,3510,7850853,16,7854800,437,421
V,+,7854802,0.00261643,0.0,3822,3812,10,7,15,gene,C37C3.2,1,7854860,5.00749,3949,7850853,58,7854802,0,-58
V,+,7855560,0.0,0.5,1,1,0,0,3,gene,C37C3.2,1,7855656,5.00749,4707,7850853,96,7855560,0,-96
V,+,7857799,0.959016,0.0,244,10,234,164,4,gene,C37C3.1,2,7857826,0.433003,64,7857735,27,7857772,-27,-54
V,+,7875572,0.0,1.11022e-16,53,53,0,0,0,gene,F40A3.4,0,7875592,0.299177,15850,7859722,20,7875565,-7,-27
V,+,7877423,0.028169,0.0,355,345,10,6,5,gene,F40A3.3,0,7877423,3.90825,825,7876598,0,7877423,0,0
V,+,7877585,0.00382305,0.0,1831,1824,7,7,0,gene,F40A3.3,0,7877597,3.90825,987,7876598,12,7877585,0,-12
V,+,7878723,0.0,3.58732e-43,141,141,0,0,5,gene,F40A3.2,0,7878741,1.42199,394,7878329,18,7878723,0,-18
V,+,7878736,0.0,3.05176e-05,15,15,0,0,1171,gene,F40A3.2,0,7878741,1.42199,407,7878329,5,7878723,-13,-18
V,+,7891339,0.00199203,0.0,502,501,1,1,1,gene,F40A3.1,0,7891367,0.860092,10132,7881207,28,7891339,0,-28
V,+,7981355,0.00414625,0.0,2653,2642,11,10,1,gene,F26D11.1,0,7981531,0.244612,20455,7960900,176,7981355,0,-176
V,+,7981633,0.0,0.015625,6,6,0,0,3,gene,F26D11.1,0,7981701,0.244612,20733,7960900,68,7981633,0,-68
V,+,7983901,0.00829876,0.0,482,478,4,4,12,gene,Y97E10AL.2,0,7983917,2.22714,1456,7982445,16,7983901,0,-16
V,+,7995986,0.0,1.16415e-10,33,33,0,0,7,gene,Y97E10AR.2,0,7995998,0.141944,7843,7988143,12,7995986,0,-12
V,+,8001271,0.0,1.43493e-42,139,139,0,0,5,gene,Y97E10AR.1,0,8001385,0.449836,1230,8000041,114,8001271,0,-114
V,+,8017755,0.0,5.29396e-23,74,74,0,0,0,gene,F43H9.2,0,8017881,0.797656,11863,8005892,126,8017755,0,-126
V,+,8022028,0.0,0.125,3,3,0,0,0,gene,F43H9.1,0,8022102,0.376947,505,8021523,74,8022102,74,0
V,+,8029247,0.00716204,0.0,1117,1109,8,8,0,gene,ZC513.6,2,8029316,3.26481,676,8028571,69,8029246,-1,-70
V,+,8031255,0.684466,3.47812e-08,206,65,141,133,118,gene,ZC513.4,3,8031263,0.495028,233,8031022,8,8031532,277,269
V,+,8034919,0.953781,0.0,238,11,227,170,2,gene,ZC513.5,4,8034919,0.710627,88,8034831,0,8034919,0,0
V,+,8075770,0.0,0.25,2,2,0,0,0,gene,C09H5.2,0,8075781,0.766393,15645,8060125,11,8075893,123,112
V,+,8108778,0.0,7.45058e-09,27,27,0,0,0,gene,F58G4.1,0,8108858,0.483946,2065,8106713,80,8108859,81,1
V,+,8130425,0.00372671,0.0,805,802,3,2,3,gene,D1014.3,1,8130427,2.89897,3909,8126516,2,8130425,0,-2
V,+,8133064,0.0,0.125,3,3,0,0,24,gene,D1014.4,2,8133119,0.598457,72,8132992,55,8133246,182,127
V,+,8133240,0.846626,1.59765e-20,163,25,138,98,0,gene,D1014.4,2,8133245,0.598457,81,8133159,5,8133246,6,1
V,+,8143713,0.0,5.96046e-08,24,24,0,0,0,gene,D1014.2,0,8143750,0.0456468,8924,8134789,37,8143569,-144,-181
V,+,8157551,0.0,3.63798e-12,38,38,0,0,1,gene,D1014.1,0,8157553,0.212291,9908,8147643,2,8157554,3,1
V,+,8181234,0.0125,0.0,720,711,9,9,0,gene,F20D6.4,0,8181234,3.20999,15978,8165256,0,8181234,0,0
V,+,8185419,1.0,0.5,1,0,1,1,2,gene,F20D6.2,0,8185428,0.0113075,2169,8183250,9,8185847,428,419
V,+,8201616,0.0,0.0,659,659,0,0,1,gene,K07C11.5,0,8201715,1.56562,9765,8191851,99,8201616,0,-99
V,+,8203171,0.0,0.000488281,11,11,0,0,15,gene,K07C11.4,0,8203318,0.869022,839,8202332,147,8203249,78,-69
V,+,8207043,0.0,0.0,428,428,0,0,0,gene,K07C11.3,0,8207043,1.28813,1252,8205791,0,8207043,0,0
V,+,8221296,0.00137615,0.0,2180,2177,3,3,229,gene,K07C11.2,0,8221308,2.44147,11784,8209512,12,8221296,0,-12
V,+,8259123,0.00840336,1.79051e-34,119,118,1,1,0,gene,C16D9.1,0,8259181,0.262338,20415,8238708,58,8259123,0,-58
V,+,8264155,0.0,5.16988e-26,84,84,0,0,0,gene,C16D9.9,0,8264167,0.111973,3033,8261122,12,8264048,-107,-119
V,+,8270450,0.0,0.0,405,405,0,0,0,gene,F21F8.4,1,8270451,0.995791,5960,8264490,1,8270450,0,-1
V,+,8272192,0.00928493,0.0,23802,23581,221,138,68,gene,F21F8.3,2,8272193,30.1426,330,8271862,1,8272192,0,-1
V,+,8336465,0.00537634,0.0,186,185,1,1,0,gene,C08D8.2,0,8336495,0.386663,13736,8322729,30,8336465,0,-30
V,+,8345090,0.0,0.5,1,1,0,0,1,gene,C08D8.1,0,8345240,0.0301754,4607,8340483,150,8345566,476,326
V,+,8345575,0.0,0.00390625,8,8,0,0,0,gene,C08D8.1,0,8345587,0.0301754,369,8345206,12,8345566,-9,-21
V,+,8355795,0.00529101,0.0,189,188,1,1,1,gene,F38E1.7,0,8355904,1.14843,3214,8352581,109,8355795,0,-109
V,+,8370818,0.0322581,1.44355e-08,31,30,1,1,0,gene,F38E1.5,0,8370820,0.0865791,9018,8361800,2,8370821,3,1
V,+,8379313,0.0,2.77556e-17,55,55,0,0,9,gene,F52E1.5,0,8379326,0.227847,1562,8377751,13,8379313,0,-13
V,+,8383670,0.0,0.0078125,7,7,0,0,2,gene,F52E1.14,0,8383727,5.23603,195,8383475,57,8383729,59,2
V,+,8413894,0.0039278,0.0,10693,10651,42,40,22,gene,F52E1.1,0,8413900,8.83727,2318,8411576,6,8413892,-2,-8
V,+,8455992,0.0,0.00390625,8,8,0,0,0,gene,T23B12.11,0,8455997,0.699465,40936,8415056,5,8455979,-13,-18
V,+,8462193,0.0,5.60519e-45,147,147,0,0,269,gene,T23B12.4,1,8462205,0.863679,4781,8457412,12,8462133,-60,-72
V,+,8465492,0.876543,0.0,891,110,781,551,10,gene,T23B12.3,2,8465719,2.11547,117,8465375,227,8465492,0,-227
V,+,8467071,0.972441,0.0,254,7,247,165,2,gene,T23B12.2,3,8467131,1.01057,106,8466965,60,8467071,0,-60
V,+,8468846,0.960526,0.0,228,9,219,159,0,gene,T23B12.1,4,8468858,0.499281,94,8468752,12,8468846,0,-12
V,+,8494697,0.0,4.03897e-28,91,91,0,0,0,gene,ZK994.3,0,8494700,0.280992,24821,8469876,3,8494695,-2,-5
V,+,8545985,0.0,1.57772e-30,99,99,0,0,0,gene,F25G6.6,0,8546092,0.421165,8067,8537918,107,8546093,108,1
V,+,8552500,0.0,5.68434e-14,44,44,0,0,9,gene,F25G6.4,0,8552513,0.0815729,1530,8550970,13,8552500,0,-13
V,+,8561021,0.0,1.42109e-14,46,46,0,0,1,gene,F25G6.3,0,8561042,0.114142,5828,8555193,21,8561021,0,-21
V,+,8570116,0.00909091,8.47409e-32,110,109,1,1,0,gene,F25G6.2,1,8570146,0.543742,5966,8564150,30,8570116,0,-30
V,+,8575988,0.0,0.5,1,1,0,0,0,gene,F25G6.1,2,8575990,0.0966851,929,8575059,2,8575889,-99,-101
V,+,8581324,0.9375,3.44438e-14,64,4,60,43,5,gene,C10B5.1,3,8581385,0.0868849,91,8581233,61,8581324,0,-61
V,+,8594719,0.00162866,0.0,614,613,1,1,0,gene,F41E6.6,0,8594723,2.49441,11338,8583381,4,8594719,0,-4
V,+,8603461,0.0,0.125,3,3,0,0,65,gene,F41E6.5,0,8603481,0.801187,6189,8597272,20,8603400,-61,-81
V,+,8607605,0.00193798,0.0,516,515,1,1,1,gene,F41E6.4,0,8607606,2.07401,2311,8605294,1,8607605,0,-1
V,+,8618817,0.0,1.77636e-15,49,49,0,0,7,gene,F41E6.2,0,8618854,12.0129,3171,8615646,37,8618837,20,-17
V,+,8618844,0.000328084,0.0,6096,6094,2,1,68,gene,F41E6.2,0,8618854,12.0129,3198,8615646,10,8618837,-7,-17
V,+,8665870,0.0,0.0,391,391,0,0,3,gene,ZC190.4,0,8665883,1.04848,25393,8640477,13,8665870,0,-13
V,+,8681150,0.0,0.5,1,1,0,0,0,gene,ZC190.2,0,8681154,0.00422911,9670,8671480,4,8681155,5,1
V,+,8682857,0.0,3.72529e-09,28,28,0,0,14,gene,ZC190.1,0,8682872,0.233043,113,8682744,15,8682857,0,-15
V,+,8716300,0.0,0.000976562,10,10,0,0,4,gene,ZC196.7,0,8716325,0.0998635,13435,8702865,25,8716300,0,-25
V,+,8726323,0.0,2.91038e-11,35,35,0,0,0,gene,ZC196.6,0,8726332,0.117348,5713,8720610,9,8726333,10,1
V,+,8726329,0.0,1.45519e-11,36,36,0,0,1,gene,ZC196.6,0,8726332,0.117348,5719,8720610,3,8726333,4,1
V,+,8736476,0.0,0.0078125,7,7,0,0,1,gene,ZC196.3,0,8736478,0.0400218,890,8735586,2,8736479,3,1
V,+,8739240,0.0,5.68434e-14,44,44,0,0,0,gene,ZC196.2,0,8739241,0.111532,998,8738242,1,8739242,2,1
V,+,8768713,0.0,1.11022e-16,53,53,0,0,2,gene,B0507.3,0,8768722,0.281644,13149,8755564,9,8768713,0,-9
V,+,8769407,0.0,0.0078125,7,7,0,0,0,gene,B0507.3,0,8769477,0.281644,13843,8755564,70,8769407,0,-70
V,+,8771684,1.0,0.5,1,0,1,1,0,gene,B0507.11,0,8771702,0.001579,1008,8770676,18,8771703,19,1
V,+,8774136,0.00416667,0.0,240,239,1,0,6,gene,B0507.2,0,8774142,0.779037,551,8773585,6,8774136,0,-6
V,+,8786142,0.0,0.125,3,3,0,0,1,gene,C01B7.1,0,8786632,1.32407,7022,8779120,490,8786644,502,12
V,+,8786355,0.00594354,0.0,673,669,4,4,1,gene,C01B7.1,0,8786632,1.32407,7235,8779120,277,8786355,0,-277
V,+,8786644,0.0,0.25,2,2,0,0,0,gene,C01B7.1,0,8786651,1.32407,7524,8779120,7,8786644,0,-7
V,+,8827945,0.0,0.25,2,2,0,0,0,gene,W09B7.2,0,8827968,0,35366,8792579,23,8827969,24,1
V,+,8898866,0.0,0.00012207,13,13,0,0,0,gene,K06C4.17,0,8898867,0.0905969,523,8898343,1,8899080,214,213
V,+,8907006,0.0,1.77636e-15,49,49,0,0,0,gene,K06C4.8,0,8907020,0.100536,1770,8905236,14,8907433,427,413
V,+,8907427,0.0,0.125,3,3,0,0,0,gene,K06C4.8,0,8907432,0.100536,2191,8905236,5,8907433,6,1
V,+,8922892,0.000644745,0.0,3102,3100,2,2,9,gene,H14N18.3,0,8922892,3.37574,13646,8909246,0,8922892,0,0
V,+,8936096,1.0,0.125,3,0,3,3,0,gene,H14N18.1,0,8936118,1.46343,1963,8934133,22,8936196,100,78
V,+,8936314,0.0,0.25,2,2,0,0,107,gene,H14N18.1,0,8936422,1.46343,2181,8934133,108,8936196,-118,-226
V,+,8937197,0.0,0.0,344,344,0,0,53,gene,H14N18.1,0,8937197,1.46343,3064,8934133,0,8937197,0,0
V,+,8937207,0.0078534,0.0,382,379,3,3,356,gene,H14N18.1,0,8937371,1.46343,3074,8934133,164,8937207,0,-164
V,+,8947603,0.0,4.54747e-13,41,41,0,0,5,gene,T19A5.2,1,8947614,0.948741,8125,8939478,11,8947603,0,-11
V,+,8948510,0.0,2.46519e-32,105,105,0,0,1,gene,T19A5.2,1,8948511,0.948741,9032,8939478,1,8948840,330,329
V,+,8956849,0.311538,3.19529e-10,260,179,81,67,0,gene,T19A5.1,2,8956874,1.06992,420,8956429,25,8956875,26,1
V,+,8994904,0.0301205,0.0,332,322,10,5,0,gene,F59E11.5,0,8994904,0.777802,2012,8992892,0,8994904,0,0
V,+,9000937,0.0,0.5,1,1,0,0,1,gene,F59E11.2,0,9001006,0.0570375,4732,8996205,69,9001333,396,327
V,+,9030352,0.0,1.49012e-08,26,26,0,0,1,gene,C25E10.5,0,9030360,0.249275,11230,9019122,8,9030352,0,-8
V,+,9044975,0.0,0.00195312,9,9,0,0,0,gene,C25E10.1,0,9044985,0.0165666,1508,9043467,10,9044975,0,-10
V,+,9096071,0.00161943,0.0,1235,1233,2,2,2,gene,F21C10.10,0,9096073,7.6913,1912,9094159,2,9096071,0,-2
V,+,9112571,0.00555556,0.0,180,179,1,0,0,gene,F21C10.7,0,9112593,0.616923,1754,9110817,22,9112594,23,1
V,+,9123463,0.0410959,6.58526e-18,73,70,3,2,1,gene,F21C10.11,0,9123479,3.43621,149,9123314,16,9123487,24,8
V,+,9175600,0.00722543,0.0,692,687,5,5,1,gene,C24B5.2,0,9175604,1.03862,548,9175052,4,9175600,0,-4
V,+,9191418,0.0,9.53674e-07,20,20,0,0,1,gene,C24B5.1,0,9191486,0.175169,13621,9177797,68,9191487,69,1
V,+,9202879,0.0049597,0.0,3226,3210,16,14,65,gene,T18H9.2,0,9202880,15.338,838,9202041,1,9202879,0,-1
V,+,9225896,0.0142045,0.0,352,347,5,1,0,gene,F07C3.2,0,9225911,0.867773,1746,9224150,15,9225896,0,-15
V,+,9225904,0.0,0.0625,4,4,0,0,664,gene,F07C3.2,0,9225911,0.867773,1754,9224150,7,9225896,-8,-15
V,+,9297433,0.0,0.0,219,219,0,0,1,gene,F44A2.5,0,9297673,0.797839,43395,9254038,240,9297433,0,-240
V,+,9318112,0.0,6.10352e-05,14,14,0,0,0,gene,F44A2.2,0,9318113,0.0415545,7386,9310726,1,9318104,-8,-9
V,+,9321294,0.0,0.00195312,9,9,0,0,2,gene,F44A2.7,0,9321303,0.0364622,495,9320799,9,9321304,10,1
V,+,9323003,0.0,0.0,537,537,0,0,8,gene,F44A2.1,0,9323098,1.22538,308,9322695,95,9323012,9,-86
V,+,9328664,0.0,3.8147e-06,18,18,0,0,0,gene,K07B1.4,0,9328729,1.00132,1657,9327007,65,9328771,107,42
V,+,9328771,0.157025,1.03696e-42,363,306,57,51,2,gene,K07B1.4,0,9328809,1.00132,1764,9327007,38,9328771,0,-38
V,+,9330051,0.0,5.29396e-23,74,74,0,0,2,gene,K07B1.4,0,9330185,1.00132,3044,9327007,134,9330051,0,-134
V,+,9334574,0.0021978,0.0,455,454,1,0,0,gene,K07B1.3,1,9334713,0.293344,3253,9331321,139,9334574,0,-139
V,+,9336563,0.935368,0.0,557,36,521,359,2,gene,K07B1.2,2,9336614,0.759613,100,9336463,51,9336563,0,-51
V,+,9346845,0.0,9.53674e-07,20,20,0,0,2,gene,K07B1.1,0,9346861,0.175625,8203,9338642,16,9346938,93,77
V,+,9346978,0.0,0.03125,5,5,0,0,0,gene,K07B1.1,0,9346980,0.175625,8336,9338642,2,9346938,-40,-42
V,+,9385982,0.0,0.0,175,175,0,0,0,gene,F36D4.3,1,9386030,1.44943,14246,9371736,48,9385955,-27,-75
V,+,9396300,0.0,8.27181e-25,80,80,0,0,9,gene,F36D4.3,1,9396328,1.44943,24564,9371736,28,9396300,0,-28
V,+,9396548,0.0,0.5,1,1,0,0,7,gene,F36D4.3,1,9396569,1.44943,24812,9371736,21,9396548,0,-21
V,+,9397783,1.0,0.0078125,7,0,7,5,2,gene,F36D4.3,1,9397814,1.44943,105,9397678,31,9398114,331,300
V,+,9398114,0.904762,2.54499e-08,42,4,38,32,3,gene,F36D4.3,1,9398267,1.44943,436,9397678,153,9398114,0,-153
V,+,9400128,0.537037,0.0145649,378,175,203,149,3,gene,F36D4.2,2,9400134,0.626132,265,9399863,6,9400135,7,1
V,+,9454184,0.0192308,1.15463e-14,52,51,1,0,0,gene,H24G06.1,0,9454390,1.32423,26020,9428164,206,9454184,0,-206
V,+,9456040,0.00666667,1.05097e-43,150,149,1,1,3,gene,H24G06.1,0,9456086,1.32423,27876,9428164,46,9456040,0,-46
V,+,9471776,0.0,0.0,884,884,0,0,0,gene,F07D3.2,0,9471778,1.07905,11206,9460570,2,9471779,3,1
V,+,9501202,0.015625,3.46945e-18,64,63,1,0,0,gene,K06A4.4,0,9501202,0.315302,2027,9499175,0,9501203,1,1
V,+,9505406,0.0,0.0,581,581,0,0,3,gene,K06A4.5,0,9505489,0.731882,1025,9504381,83,9505490,84,1
V,+,9507933,0.00368324,0.0,543,541,2,1,129,gene,F11A3.1,0,9507934,1.26842,1014,9506919,1,9507933,0,-1
V,+,9513978,0.0,0.0,180,180,0,0,1,gene,F11A3.2,0,9514019,0.694345,1133,9512845,41,9513978,0,-41
V,+,9526362,0.0,0.03125,5,5,0,0,3,gene,C50F4.1,0,9526399,1.28736,8920,9517442,37,9526534,172,135
V,+,9526594,0.0,1.42109e-14,46,46,0,0,53,gene,C50F4.1,0,9526645,1.28736,9152,9517442,51,9526594,0,-51
V,+,9534729,0.0,0.5,1,1,0,0,19,gene,C50F4.3,0,9534744,0.898469,400,9534329,15,9534727,-2,-17
V,+,9536621,0.0,1.35525e-20,66,66,0,0,40,gene,C50F4.4,0,9536625,0.238785,417,9536204,4,9536586,-35,-39
V,+,9550445,0.00714286,1.00445e-40,140,139,1,1,1,gene,F25B3.1,0,9550587,0.86299,3040,9547405,142,9550445,0,-142
V,+,9577146,0.0,9.31323e-10,30,30,0,0,2,gene,F25B3.2,0,9577153,0.168516,21316,9555830,7,9576929,-217,-224
V,+,9585985,0.0,0.0,157,157,0,0,1,gene,K09G1.1,0,9586040,3.61185,6160,9579825,55,9585985,0,-55
V,+,9588960,0.00114482,0.0,1747,1745,2,2,57,gene,K09G1.1,0,9588967,3.61185,9135,9579825,7,9588960,0,-7
V,+,9608363,0.0,4.65661e-10,31,31,0,0,0,gene,K09G1.4,0,9608380,0.093752,17306,9591057,17,9608363,0,-17
V,+,9645662,0.00867052,0.0,346,343,3,3,29,gene,T06E4.1,0,9645682,0.886822,13605,9632057,20,9645641,-21,-41
V,+,9654556,0.0,0.25,2,2,0,0,3,gene,B0331.1,0,9654557,0.0181126,4544,9650012,1,9654506,-50,-51
V,+,9666501,0.0196078,2.26485e-14,51,50,1,0,0,gene,ZK287.1,0,9666736,0.628116,8714,9657787,235,9666501,0,-235
V,+,9678077,0.0017301,0.0,578,577,1,0,5,gene,ZK287.3,0,9678086,0.786476,8224,9669853,9,9678075,-2,-11
V,+,9692863,0.0,0.0,343,343,0,0,5,gene,ZK287.7,0,9692868,0.334556,12849,9680014,5,9692863,0,-5
V,+,9705157,0.00339559,0.0,2945,2935,10,1,0,gene,F40F9.1,0,9705158,3.15867,3323,9701834,1,9705157,0,-1
V,+,9729662,0.0,0.5,1,1,0,0,0,gene,F40F9.7,0,9729724,2.75364,10161,9719501,62,9729911,249,187
V,+,9729900,0.0,0.0078125,7,7,0,0,0,gene,F40F9.7,0,9730072,2.75364,10399,9719501,172,9729911,11,-161
V,+,9729911,0.00286533,0.0,349,348,1,1,8,gene,F40F9.7,0,9730072,2.75364,10410,9719501,161,9729911,0,-161
V,+,9731758,0.0,0.0,238,238,0,0,11,gene,F40F9.7,0,9731778,2.75364,950,9730808,20,9731758,0,-20
V,+,9731768,0.0,2.32831e-10,32,32,0,0,436,gene,F40F9.7,0,9731778,2.75364,960,9730808,10,9731758,-10,-20
V,+,9731888,0.0,0.000976562,10,10,0,0,81,gene,F40F9.7,0,9731963,2.75364,1080,9730808,75,9731758,-130,-205
V,+,9732314,0.25,0.25,4,3,1,0,5,gene,F40F9.7,0,9732318,2.75364,278,9732036,4,9732314,0,-4
V,+,9741022,0.0,5.16988e-26,84,84,0,0,4,gene,F58E6.1,0,9741045,0.594808,329,9740693,23,9741022,0,-23
V,+,9745039,0.00124146,0.0,1611,1609,2,0,3,gene,F58E6.13,0,9745039,None,914,9744125,0,9745040,1,1
V,+,9796662,0.0,5.55112e-17,54,54,0,0,0,gene,F46B6.9,0,9796677,0.100033,3582,9793080,15,9796662,0,-15
V,+,9807431,0.0,0.5,1,1,0,0,0,gene,C50C10.8,0,9807434,0.00325095,1031,9806400,3,9807435,4,1
V,+,9811242,0.0,0.25,2,2,0,0,0,gene,C50C10.2,0,9811242,0.000893211,2010,9809232,0,9811261,19,19
V,+,9816483,0.0,0.015625,6,6,0,0,0,gene,C50C10.4,0,9816489,0.00588484,1676,9814807,6,9816490,7,1
V,+,9819056,0.0,0.25,2,2,0,0,0,gene,C50C10.5,0,9819078,None,1336,9817720,22,9819079,23,1
V,+,9838271,0.0,0.5,1,1,0,0,2,gene,R07B5.5,0,9838332,0.00152989,8300,9829971,61,9837779,-492,-553
V,+,9889639,0.0,3.46945e-18,58,58,0,0,1,gene,C50H2.1,0,9889726,0.314298,8658,9880981,87,9889639,0,-87
V,+,9899385,0.0,0.000488281,11,11,0,0,0,gene,C50H2.2,0,9899386,0.0608779,4736,9894649,1,9899387,2,1
V,+,9904817,0.142857,0.0546875,7,6,1,0,0,gene,C50H2.2,0,9904912,0.0608779,10168,9894649,95,9904817,0,-95
V,+,9916767,0.0,0.03125,5,5,0,0,3,gene,C50H2.4,0,9916774,0.0195503,2438,9914329,7,9916775,8,1
V,+,9925929,0.0,0.5,1,1,0,0,0,gene,C50H2.13,0,9925990,0.168995,2078,9923851,61,9926344,415,354
V,+,9926346,0.0,5.29396e-23,74,74,0,0,1,gene,C50H2.13,0,9926409,0.168995,327,9926019,63,9926344,-2,-65
V,+,9930821,0.0164425,0.0,669,658,11,9,0,gene,T07C12.14,0,9930826,0.707807,3137,9927684,5,9930819,-2,-7
V,+,9930834,0.0,0.125,3,3,0,0,2570,gene,T07C12.14,0,9930950,0.707807,3150,9927684,116,9930819,-15,-131
V,+,9951033,0.00470163,0.0,5530,5504,26,19,21,gene,T07C12.7,0,9951034,6.97513,5759,9945274,1,9951033,0,-1
V,+,9982668,0.899642,0.0,279,28,251,202,2,gene,C27H6.9,2,9982679,None,110,9982558,11,9982680,12,1
V,+,9982677,1.0,0.5,1,0,1,1,708,gene,C27H6.9,2,9982679,None,119,9982558,2,9982680,3,1
V,+,9991698,0.0,0.5,1,1,0,0,24,gene,K08H10.9,0,9991706,0.829646,8013,9983685,8,9991652,-46,-54
V,+,10000862,0.02,4.44089e-14,50,49,1,1,1,gene,K08H10.10,0,10000917,None,2544,9998318,55,10000918,56,1
V,+,10004555,0.00303721,0.0,1317,1313,4,4,7,gene,K08H10.4,0,10004616,1.50777,2102,10002453,61,10004555,0,-61
V,+,10011673,0.00308642,0.0,324,323,1,0,1,gene,K08H10.3,0,10011722,0.545181,4391,10007282,49,10011723,50,1
V,+,10013065,0.0,0.0,261,261,0,0,0,gene,K08H10.3,0,10013073,0.545181,5783,10007282,8,10013074,9,1
V,+,10020345,0.00374237,0.0,5077,5058,19,17,0,gene,K08H10.1,1,10020362,9.32899,7073,10013272,17,10020345,0,-17
V,+,10023359,1.0,0.5,1,0,1,1,2,gene,K08H10.2,2,10023404,1.9173,325,10023034,45,10023359,0,-45
V,+,10037140,0.0,3.46945e-18,58,58,0,0,1,gene,F57A8.1,0,10037218,2.55478,9183,10027957,78,10037140,0,-78
V,+,10043477,0.00448431,0.0,446,444,2,1,0,gene,F57A8.1,0,10043478,2.55478,15520,10027957,1,10043477,0,-1
V,+,10066880,0.0,7.62939e-06,17,17,0,0,0,gene,F57A8.4,0,10066886,0.0763678,2137,10064743,6,10066887,7,1
V,+,10087286,0.0428571,4.63666e-17,70,67,3,2,1,gene,R04B5.5,0,10087287,0.335961,230,10087056,1,10087288,2,1
V,+,10107428,1.0,0.5,1,0,1,0,2,gene,C08B6.11,0,10107449,0.128291,128,10107300,21,10107731,303,282
V,+,10107554,0.0,0.00195312,9,9,0,0,3,gene,C08B6.11,0,10107587,0.128291,254,10107300,33,10107731,177,144
V,+,10114965,0.0,0.25,2,2,0,0,1,gene,C08B6.4,0,10114965,0.2712,5259,10109706,0,10114965,0,0
V,+,10125299,0.0,3.67342e-40,131,131,0,0,308,gene,C08B6.10,0,10125303,0.800371,700,10124599,4,10124851,-448,-452
V,+,10134442,0.00294118,0.0,680,678,2,2,1,gene,C08B6.8,0,10134446,0.884843,7073,10127369,4,10134460,18,14
V,+,10143733,1.0,0.0625,4,0,4,3,0,gene,C08B6.15,0,10143734,None,889,10142844,1,10143735,2,1
V,+,10158629,0.0,0.03125,5,5,0,0,0,gene,C51E3.5,0,10158631,0.0123782,2638,10155991,2,10158632,3,1
V,+,10179333,0.00550747,0.0,1271,1264,7,6,1,gene,ZK856.1,1,10179362,0.693053,19237,10160096,29,10179333,0,-29
V,+,10198489,0.0,0.00390625,8,8,0,0,1,gene,ZK856.6,0,10198501,0.0783497,14245,10184244,12,10198502,13,1
V,+,10201883,0.0,0.5,1,1,0,0,38,gene,ZK856.7,0,10201896,12.0764,1956,10199927,13,10201896,13,0
V,+,10201896,0.00156326,0.0,10235,10219,16,15,77,gene,ZK856.7,0,10201896,12.0764,1969,10199927,0,10201896,0,0
V,+,10212721,0.0,0.0078125,7,7,0,0,1,gene,ZK856.12,0,10212746,0.474676,9675,10203046,25,10212747,26,1
V,+,10212727,0.0,0.0,216,216,0,0,0,gene,ZK856.12,0,10212746,0.474676,9681,10203046,19,10212747,20,1
V,+,10212733,0.0,1.29247e-26,86,86,0,0,19,gene,ZK856.12,0,10212746,0.474676,9687,10203046,13,10212747,14,1
V,+,10212986,0.0,0.5,1,1,0,0,124,gene,ZK856.12,0,10213003,0.474676,9940,10203046,17,10212747,-239,-256
V,+,10248706,0.00344531,0.0,1161,1157,4,3,1,gene,C12D8.10,0,10248754,2.24548,6189,10242517,48,10248706,0,-48
V,+,10255968,0.0,0.0625,4,4,0,0,1,gene,Y22F5A.1,0,10256048,0.167392,3327,10252641,80,10256159,191,111
V,+,10277703,0.0027791,0.0,14753,14712,41,30,191,gene,Y22F5A.4,0,10277706,16.5494,19250,10258453,3,10277703,0,-3
V,+,10277789,0.0,0.000976562,10,10,0,0,1152,gene,Y22F5A.4,0,10277869,16.5494,19336,10258453,80,10277703,-86,-166
V,+,10287365,0.0,3.72529e-09,28,28,0,0,0,gene,B0024.3,0,10287374,0.101809,8419,10278946,9,10287375,10,1
V,+,10289842,0.0,1.52588e-05,16,16,0,0,1,gene,B0024.15,0,10289845,0.0366414,752,10289090,3,10289842,0,-3
V,+,10297244,0.0,0.5,1,1,0,0,240,gene,B0024.4,0,10297270,0.520177,2777,10294467,26,10297198,-46,-72
V,+,10314439,0.0,1.69407e-21,69,69,0,0,1,gene,B0024.9,0,10314455,1.95641,15660,10298779,16,10314439,0,-16
V,+,10314469,0.00410557,0.0,1705,1698,7,7,103,gene,B0024.9,0,10314546,1.95641,15690,10298779,77,10314439,-30,-107
V,+,10314475,0.0,4.54747e-13,41,41,0,0,699,gene,B0024.9,0,10314546,1.95641,15696,10298779,71,10314439,-36,-107
V,+,10320515,0.0166667,0.0,240,236,4,4,1,gene,B0024.13,0,10320515,0.881084,5398,10315117,0,10320516,1,1
V,+,10339300,0.00326797,0.0,306,305,1,1,3,gene,K07C5.2,1,10339302,0.723733,17199,10322101,2,10339300,0,-2
V,+,10342323,0.0125,8.40779e-45,160,158,2,1,3,gene,K07C5.13,2,10342331,None,1552,10340771,8,10342332,9,1
V,+,10342832,0.415644,2.82941e-06,652,381,271,206,33,gene,K07C5.3,3,10342887,0.830505,95,10342737,55,10342832,0,-55
V,+,10358349,0.0,7.62939e-06,17,17,0,0,1,gene,K07C5.7,0,10358359,0.169935,13062,10345287,10,10358351,2,-8
V,+,10362063,0.0039032,0.0,1281,1276,5,4,1,gene,K07C5.8,0,10362124,1.83422,775,10361288,61,10362125,62,1
V,+,10372127,0.0,1.32349e-23,76,76,0,0,0,gene,AC3.2,0,10372139,0.677682,2440,10369687,12,10371941,-186,-198
V,+,10388315,0.00409836,0.0,244,243,1,1,35,gene,AC3.5,0,10388326,0.898194,2804,10385511,11,10388315,0,-11
V,+,10395588,0.0,0.25,2,2,0,0,9,gene,AC3.7,0,10395604,0.221749,2287,10393301,16,10395477,-111,-127
V,+,10436803,0.00361011,0.0,277,276,1,1,10,gene,Y32F6A.1,1,10436815,0.4284,35696,10401107,12,10436803,0,-12
V,+,10441781,0.0578358,0.0,536,505,31,25,1,gene,Y32F6A.3,2,10441848,1.50761,884,10440897,67,10441781,0,-67
V,+,10441907,0.0,0.5,1,1,0,0,0,gene,Y32F6A.3,2,10441916,1.50761,1010,10440897,9,10441907,0,-9
V,+,10462038,0.0,1.49012e-08,26,26,0,0,1,gene,F22E12.2,0,10462081,0.629406,9290,10452748,43,10462082,44,1
V,+,10462082,0.0,0.0,282,282,0,0,10,gene,F22E12.2,0,10462097,0.629406,9334,10452748,15,10462082,0,-15
V,+,10468317,0.0,0.0,376,376,0,0,28,gene,F22E12.4,0,10468319,0.830712,3857,10464460,2,10468317,0,-2
V,+,10468744,0.0,0.5,1,1,0,0,0,gene,F22E12.4,0,10468826,0.830712,4284,10464460,82,10468744,0,-82
V,+,10470200,0.0,0.125,3,3,0,0,0,gene,F22E12.4,0,10470223,0.830712,5740,10464460,23,10470200,0,-23
V,+,10473135,0.0,1.35525e-20,66,66,0,0,1,gene,F22E12.4,0,10473136,0.830712,8675,10464460,1,10473137,2,1
V,+,10478366,0.0,0.0,252,252,0,0,9,gene,Y32F6B.3,0,10478417,0.348181,1659,10476707,51,10478390,24,-27
V,+,10557776,0.0140845,0.0,213,210,3,2,0,gene,F32G8.4,0,10557803,1.32366,3331,10554445,27,10557776,0,-27
V,+,10564680,0.00286123,0.0,699,697,2,2,0,gene,F32G8.6,0,10564713,1.46245,2636,10562044,33,10564678,-2,-35
V,+,10572720,0.0,0.0,269,269,0,0,0,gene,T21C9.3,0,10572720,2.28581,6482,10566238,0,10572720,0,0
V,+,10579111,0.00426743,0.0,2109,2100,9,4,1,gene,T21C9.5,0,10579121,6.95888,3737,10575374,10,10579109,-2,-12
V,+,10581687,0.00980392,2.0116e-29,102,101,1,1,0,gene,T21C9.6,0,10581691,0.214904,1212,10580475,4,10581687,0,-4
V,+,10597212,0.0,0.015625,6,6,0,0,6,gene,T21C9.13,0,10597274,1.32277,10336,10586876,62,10597117,-95,-157
V,+,10597323,0.0,0.0625,4,4,0,0,353,gene,T21C9.13,0,10597347,1.32277,10447,10586876,24,10597117,-206,-230
V,+,10597343,0.0,3.05176e-05,15,15,0,0,753,gene,T21C9.13,0,10597347,1.32277,10467,10586876,4,10597117,-226,-230
V,+,10598907,0.0060423,0.0,331,329,2,1,3,gene,T21C9.12,1,10598913,1.49192,440,10598467,6,10598907,0,-6
V,+,10602243,0.5,0.5,2,1,1,1,4,gene,H27A22.1,2,10602356,1.00579,302,10601941,113,10602260,17,-96
V,+,10602260,0.921951,4.9592e-39,205,16,189,139,39,gene,H27A22.1,2,10602356,1.00579,319,10601941,96,10602260,0,-96
V,+,10603895,0.0,2.1684e-19,62,62,0,0,0,gene,H27A22.1,2,10603930,1.00579,1954,10601941,35,10603895,0,-35
V,+,10650509,0.0,4.76837e-07,21,21,0,0,1,gene,C32C4.2,0,10650535,0.101983,552,10649957,26,10650514,5,-21
V,+,10657651,0.0,1.38778e-17,56,56,0,0,5,gene,F29F11.3,0,10657723,0.575763,6028,10651623,72,10657996,345,273
V,+,10658025,0.0,0.000976562,10,10,0,0,3,gene,F29F11.3,0,10658051,0.575763,6402,10651623,26,10657996,-29,-55
V,+,10667388,0.0,0.000976562,10,10,0,0,0,gene,F29F11.4,0,10667502,0.0705867,7889,10659499,114,10667388,0,-114
V,+,10682224,0.00280308,0.0,2854,2846,8,7,1,gene,F29F11.6,0,10682330,4.57892,6808,10675416,106,10682224,0,-106
V,+,10702352,0.0,0.0,212,212,0,0,0,gene,C05A2.1,0,10702367,0.476813,16048,10686304,15,10702352,0,-15
V,+,10736919,0.00404858,0.0,741,738,3,3,3,gene,ZC302.2,0,10736920,0.649079,32210,10704709,1,10736919,0,-1
V,+,10758761,0.0,0.0,487,487,0,0,5,gene,F28H7.8,0,10758762,0.479138,10020,10748741,1,10758763,2,1
V,+,10764168,0.0,0.0625,4,4,0,0,0,gene,F28H7.10,0,10764168,0.0628143,3725,10760443,0,10764169,1,1
V,+,10768145,0.0,0.5,1,1,0,0,2,gene,F28H7.10,0,10768174,0.0628143,7702,10760443,29,10768175,30,1
V,+,10770154,0.0,0.0625,4,4,0,0,29,gene,D1054.2,1,10770184,5.75424,1896,10768258,30,10770172,18,-12
V,+,10770172,0.00908575,0.0,1761,1745,16,15,29,gene,D1054.2,1,10770184,5.75424,1914,10768258,12,10770172,0,-12
V,+,10771255,0.948379,0.0,833,43,790,521,5,gene,D1054.3,2,10771266,2.40353,102,10771153,11,10771255,0,-11
V,+,10813917,0.0,5.87747e-39,127,127,0,0,0,gene,C29A12.3,0,10813951,1.05676,1607,10812310,34,10813917,0,-34
V,+,10824817,0.0588235,0.0001297,17,16,1,0,2,gene,C29A12.4,0,10824827,0.187351,8294,10816523,10,10824828,11,1
V,+,10841838,0.0,1.49012e-08,26,26,0,0,0,gene,C29A12.7,0,10841856,None,25315,10816523,18,10841740,-98,-116
V,+,10880644,0.0,9.31323e-10,30,30,0,0,0,gene,F32D8.1,0,10880681,0.0949707,28338,10852306,37,10880682,38,1
V,+,10886775,0.0,5.42101e-20,64,64,0,0,24,gene,F32D8.3,0,10886838,0.407279,731,10886044,63,10886775,0,-63
V,+,10894709,0.0,0.125,3,3,0,0,216,gene,F32D8.5,0,10894731,0.726422,7065,10887644,22,10894672,-37,-59
V,+,10903859,0.0,5.96046e-08,24,24,0,0,0,gene,F32D8.15,0,10903863,None,3353,10900506,4,10903864,5,1
V,+,10925127,0.0,0.0,394,394,0,0,2,gene,F58B4.6,0,10925138,0.658985,18583,10906544,11,10925139,12,1
V,+,10925138,0.0,0.0625,4,4,0,0,456,gene,F58B4.6,0,10925138,0.658985,18594,10906544,0,10925139,1,1
V,+,10929616,0.00155885,0.0,1283,1281,2,1,4,gene,F58B4.3,0,10929616,0.853285,2953,10926663,0,10929617,1,1
V,+,10941255,0.00176211,0.0,1135,1133,2,1,89,gene,F17C11.1,0,10941367,2.32908,2772,10938483,112,10941255,0,-112
V,+,10941408,0.0,0.0625,4,4,0,0,1,gene,F17C11.1,0,10941410,2.32908,2925,10938483,2,10941408,0,-2
V,+,10942365,0.0,0.00390625,8,8,0,0,0,gene,F17C11.17,0,10942379,None,3882,10938483,14,10942363,-2,-16
V,+,10942841,0.0,0.000976562,10,10,0,0,607,gene,F17C11.17,0,10942963,None,4358,10938483,122,10942363,-478,-600
V,+,10948035,0.00356779,0.0,1962,1955,7,1,5,gene,F17C11.2,0,10948083,2.62857,3875,10944160,48,10948035,0,-48
V,+,10949617,0.0,0.03125,5,5,0,0,1,gene,F17C11.3,0,10949817,0.304414,733,10948884,200,10949703,86,-114
V,+,10949815,0.0,0.00195312,9,9,0,0,11,gene,F17C11.3,0,10949817,0.304414,931,10948884,2,10949703,-112,-114
V,+,10951625,0.0,9.53674e-07,20,20,0,0,3,gene,F17C11.4,0,10951638,1.76101,5,10951620,13,10951786,161,148
V,+,10951859,0.0,3.8147e-06,18,18,0,0,188,gene,F17C11.4,0,10951889,1.76101,239,10951620,30,10951786,-73,-103
V,+,10951867,0.0,0.00390625,8,8,0,0,146,gene,F17C11.4,0,10951889,1.76101,247,10951620,22,10951786,-81,-103
V,+,10954926,0.0,1.4013e-45,149,149,0,0,98,gene,F17C11.6,0,10954934,0.527043,1649,10953277,8,10954926,0,-8
V,+,10965780,0.0,7.62939e-06,17,17,0,0,1,gene,F17C11.9,0,10965786,42.8987,9084,10956696,6,10965780,0,-6
V,+,10991900,0.0,2.77556e-17,55,55,0,0,0,gene,F53B7.2,0,10991903,0.071051,22356,10969544,3,10991904,4,1
V,+,10998909,0.0,6.61744e-24,77,77,0,0,22,gene,F53B7.7,0,10998927,0.400083,4136,10994773,18,10998922,13,-5
V,+,11050541,0.0,0.03125,5,5,0,0,4,gene,C45B11.7,0,11050648,None,18,11050523,107,11050167,-374,-481
V,+,11053935,0.00217865,0.0,459,458,1,1,7,gene,T04C12.7,0,11053942,0.715289,1024,11052911,7,11053943,8,1
V,+,11080858,0.0116279,0.0,1290,1275,15,12,5,gene,T04C12.6,0,11080878,34.4741,25753,11055105,20,11080858,0,-20
V,+,11105280,0.0,0.00195312,9,9,0,0,1,gene,Y42A5A.4,0,11105304,0.106387,7496,11097784,24,11105305,25,1
V,+,11113720,0.00591716,0.0,507,504,3,2,0,gene,H19N07.2,0,11113849,2.08059,6581,11107139,129,11113720,0,-129
V,+,11124109,0.00573066,0.0,349,347,2,2,3,gene,C06H2.6,1,11124112,3.31977,5485,11118624,3,11124109,0,-3
V,+,11125028,0.803371,4.08621e-17,178,35,143,88,1,gene,C06H2.2,2,11125037,0.383673,169,11124859,9,11125028,0,-9
V,+,11127298,0.909091,0.00537109,11,1,10,8,0,gene,C06H2.3,3,11127302,0.244078,184,11127114,4,11127303,5,1
V,+,11127303,0.674121,1.83655e-10,313,102,211,136,0,gene,C06H2.3,3,11127398,0.244078,189,11127114,95,11127303,0,-95
V,+,11134408,0.153846,0.00952148,13,11,2,0,0,gene,C06H2.5,0,11134414,0.18878,4521,11129887,6,11134415,7,1
V,+,11141291,0.0,8.47033e-22,70,70,0,0,1,gene,C06H2.4,0,11141303,0.174269,678,11140613,12,11141304,13,1
V,+,11149511,0.0,0.0,389,389,0,0,3,gene,T19C4.1,0,11149512,1.02971,1924,11147587,1,11149513,2,1
V,+,11172021,0.0037594,0.0,266,265,1,1,0,gene,T19C4.5,0,11172026,0.230481,20893,11151128,5,11172027,6,1
V,+,11183032,0.00291262,0.0,1030,1027,3,2,4,gene,VK10D6R.1,0,11183044,2.03413,8788,11174244,12,11183045,13,1
V,+,11191089,0.0,0.000976562,10,10,0,0,0,gene,K10D6.1,0,11191159,0.0375477,7640,11183449,70,11191089,0,-70
V,+,11211586,0.00286533,0.0,349,348,1,1,0,gene,K10D6.4,0,11211713,0.821097,10337,11201249,127,11211586,0,-127
V,+,11217462,0.0,0.00195312,9,9,0,0,10,gene,T19B10.1,0,11217546,0.280632,882,11216580,84,11217389,-73,-157
V,+,11221108,0.00119976,0.0,3334,3330,4,2,21,gene,T19B10.2,0,11221110,8.42373,1400,11219708,2,11221108,0,-2
V,+,11234456,0.0,0.0,517,517,0,0,3,gene,T19B10.5,0,11234476,0.728533,11824,11222632,20,11234150,-306,-326
V,+,11239481,0.0,2.91038e-11,35,35,0,0,2,gene,T19B10.7,1,11239511,0.77968,2247,11237234,30,11239511,30,0
V,+,11239511,0.0160643,0.0,249,245,4,4,19,gene,T19B10.7,1,11239511,0.77968,2277,11237234,0,11239511,0,0
V,+,11241687,0.856667,1.12805e-38,300,43,257,219,4,gene,T19B10.8,2,11241708,0.813051,102,11241585,21,11241709,22,1
V,+,11241696,0.923077,4.97064e-23,117,9,108,72,1091,gene,T19B10.8,2,11241708,0.813051,111,11241585,12,11241709,13,1
V,+,11241703,0.857143,0.0546875,7,1,6,5,1517,gene,T19B10.8,2,11241708,0.813051,118,11241585,5,11241709,6,1
V,+,11244645,0.928643,0.0,2999,214,2785,2057,2,gene,T19B10.11,3,11244653,3.78575,113,11244532,8,11244645,0,-8
V,+,11248182,0.0526316,3.62396e-05,19,18,1,0,0,gene,T19B10.9,0,11248198,0.0887799,2449,11245733,16,11247952,-230,-246
V,+,11271164,0.0,0.5,1,1,0,0,4,gene,C03E10.6,0,11271174,0.399657,1435,11269729,10,11271157,-7,-17
V,+,11282378,0.00350467,0.0,856,853,3,3,1,gene,C03E10.4,0,11282457,1.04356,4411,11277967,79,11282378,0,-79
V,+,11286625,0.0,0.5,1,1,0,0,1,gene,C03E10.3,0,11286650,0.0405744,780,11285845,25,11286812,187,162
V,+,11311230,0.0,2.32831e-10,32,32,0,0,3,gene,T03F7.7,0,11311327,0.532898,14862,11296368,97,11311328,98,1
V,+,11311264,0.0,5.16988e-26,84,84,0,0,62,gene,T03F7.7,0,11311327,0.532898,14896,11296368,63,11311328,64,1
V,+,11342039,0.000787402,0.0,1270,1269,1,1,1,gene,T02E9.5,0,11342056,4.26219,11452,11330587,17,11342039,0,-17
V,+,11375550,0.000316756,0.0,3157,3156,1,1,0,gene,F55C10.1,0,11375596,1.85379,30954,11344596,46,11375588,38,-8
V,+,11382913,0.0,0.0,423,423,0,0,1,gene,F55C10.5,0,11382915,1.3907,5085,11377828,2,11382916,3,1
V,+,11407390,0.0,0.0,195,195,0,0,21,gene,K03B8.6,0,11407390,0.800693,7020,11400370,0,11407390,0,0
V,+,11438576,0.0,2.06795e-25,82,82,0,0,0,gene,F57B7.1,0,11438623,0.380804,26001,11412575,47,11438576,0,-47
V,+,11459367,0.0,9.53674e-07,20,20,0,0,0,gene,T11F9.1,0,11459378,0.0204403,10316,11449051,11,11459386,19,8
V,+,11492627,0.0,0.125,3,3,0,0,0,gene,T11F9.21,0,11492706,None,441,11492186,79,11492562,-65,-144
V,+,11505161,0.0,1.17549e-38,126,126,0,0,0,gene,C55A6.10,1,11505167,0.55777,11942,11493219,6,11505161,0,-6
V,+,11508916,0.0,0.5,1,1,0,0,24,gene,C55A6.2,2,11508942,1.22017,838,11508078,26,11509032,116,90
V,+,11509032,0.574669,9.40687e-05,529,225,304,226,0,gene,C55A6.2,2,11509167,1.22017,954,11508078,135,11509032,0,-135
V,+,11527638,0.0,2.1684e-19,62,62,0,0,1,gene,F38B7.1,0,11527702,3.59497,4403,11523235,64,11527638,0,-64
V,+,11543769,0.0,0.0078125,7,7,0,0,18,gene,F38B7.2,0,11543824,0.284037,2745,11541024,55,11543741,-28,-83
V,+,11545432,0.0,0.0625,4,4,0,0,3,gene,F38B7.10,0,11545439,None,335,11545097,7,11545343,-89,-96
V,+,11546722,0.0,0.5,1,1,0,0,1,gene,F38B7.11,0,11546724,None,389,11546333,2,11546902,180,178
V,+,11549123,0.0,0.03125,5,5,0,0,53,gene,F38B7.3,0,11549127,0.625216,1160,11547963,4,11549108,-15,-19
V,+,11554444,0.00625,0.0,160,159,1,1,2,gene,F38B7.5,0,11554458,0.192079,415,11554029,14,11554609,165,151
V,+,11570289,0.0142857,5.92923e-20,70,69,1,1,114,gene,H12C20.6,0,11570299,0.424224,3711,11566578,10,11570243,-46,-56
V,+,11573247,0.0,0.0,569,569,0,0,9,gene,H12C20.3,0,11573266,1.16034,692,11572555,19,11573247,0,-19
V,+,11610554,0.0,1.19209e-07,23,23,0,0,379,gene,F35B12.5,0,11610564,0.97404,8389,11602165,10,11610515,-39,-49
V,+,11610563,0.0,5.82077e-11,34,34,0,0,558,gene,F35B12.5,0,11610564,0.97404,8398,11602165,1,11610515,-48,-49
V,+,11613114,0.0,3.15544e-30,98,98,0,0,4,gene,F35B12.6,0,11613115,0.315477,552,11612562,1,11613114,0,-1
V,+,11616183,0.00406298,0.0,3938,3922,16,11,13,gene,F35B12.7,0,11616183,11.3514,1503,11614680,0,11616090,-93,-93
V,+,11644567,0.00879121,0.0,455,451,4,3,7,gene,T27F2.3,1,11644569,2.73273,27935,11616632,2,11644567,0,-2
V,+,11645288,0.961511,0.0,1403,54,1349,1068,2,gene,T27F2.1,2,11645304,1.67545,117,11645171,16,11645288,0,-16
V,+,11667835,0.0,1.19209e-07,23,23,0,0,4,gene,F46F3.3,0,11667875,0.102621,17901,11649934,40,11667835,0,-40
V,+,11675751,0.0106383,0.0,564,558,6,4,0,gene,F46F3.4,0,11675768,1.92196,6583,11669168,17,11675749,-2,-19
V,+,11688134,0.0,0.03125,5,5,0,0,0,gene,W05E10.2,0,11688222,0.125573,3054,11685080,88,11688223,89,1
V,+,11740050,0.0,3.00927e-36,118,118,0,0,11,gene,T04F3.1,0,11740124,0.493043,50962,11689088,74,11740037,-13,-87
V,+,11757469,0.0,5.42101e-20,64,64,0,0,2,gene,T04F3.2,0,11757474,0.218836,3469,11754000,5,11757475,6,1
V,+,11764711,0.00808081,0.0,495,491,4,4,0,gene,F55A11.2,1,11764718,1.35733,3010,11761701,7,11764711,0,-7
V,+,11767135,0.939286,0.0,560,34,526,348,2,gene,F55A11.3,2,11767150,2.33453,106,11767029,15,11767134,-1,-16
V,+,11770281,0.102273,1.84613e-15,88,79,9,7,3,gene,F55A11.4,3,11770310,None,575,11769706,29,11770339,58,29
V,+,11771055,0.0,7.34684e-40,130,130,0,0,1,gene,F55A11.4,3,11771061,None,1349,11769706,6,11771053,-2,-8
V,+,11781064,0.0,0.0,302,302,0,0,0,gene,F55A11.6,0,11781257,0.857446,3403,11777661,193,11781258,194,1
V,+,11782608,0.0,0.03125,5,5,0,0,1,gene,F55A11.11,0,11782612,0.457462,719,11781889,4,11782608,0,-4
V,+,11782917,0.0,0.5,1,1,0,0,2,gene,F55A11.11,0,11782942,0.457462,28,11782889,25,11782917,0,-25
V,+,11787963,0.00322581,0.0,620,618,2,2,0,gene,F55A11.8,0,11787993,0.383125,3561,11784402,30,11787963,0,-30
V,+,11795456,0.0,0.5,1,1,0,0,0,gene,D2023.1,0,11795528,1.09568,841,11794615,72,11795456,0,-72
V,+,11799652,0.0,0.0,442,442,0,0,2,gene,D2023.1,0,11799687,1.09568,5037,11794615,35,11799652,0,-35
V,+,11827155,0.0,0.000488281,11,11,0,0,27,gene,D2023.6,0,11827173,0.552705,26805,11800350,18,11827131,-24,-42
V,+,11827165,0.2,0.15625,5,4,1,1,106,gene,D2023.6,0,11827173,0.552705,26815,11800350,8,11827131,-34,-42
V,+,11833433,0.0263158,1.38243e-10,38,37,1,1,3,gene,R13H4.3,0,11833450,0.188759,2407,11831026,17,11833448,15,-2
V,+,11845683,0.0206186,0.0,291,285,6,5,0,gene,R13H4.4,0,11845683,1.35755,5571,11840112,0,11845683,0,0
V,+,11860481,0.0,0.0,230,230,0,0,8,gene,R13H4.5,0,11860489,0.743469,8466,11852015,8,11860481,0,-8
V,+,11875166,0.0,1.86265e-09,29,29,0,0,2,gene,K12G11.1,0,11875173,0.0800566,10555,11864611,7,11875166,0,-7
V,+,11879838,0.0,6.10352e-05,14,14,0,0,0,gene,K12G11.2,0,11879873,0.0640668,898,11878940,35,11879874,36,1
V,+,11900914,0.00584795,0.0,342,340,2,2,0,gene,R31.1,1,11901155,1.74474,5130,11895784,241,11900914,0,-241
V,+,11917370,0.0516129,0.0,310,294,16,7,1,gene,R31.2,2,11917378,3.54229,961,11916409,8,11917370,0,-8
V,+,11919963,0.0,8.88178e-16,50,50,0,0,2,gene,R31.2,2,11920181,3.54229,3554,11916409,218,11919963,0,-218
V,+,11923144,0.00605327,0.0,826,821,5,5,2,gene,R31.2,2,11923161,3.54229,6735,11916409,17,11923144,0,-17
V,+,11933771,0.00441826,0.0,679,676,3,3,13,gene,F58H1.3,1,11933783,0.556684,3972,11929799,12,11933429,-342,-354
V,+,11933782,0.0,0.0625,4,4,0,0,739,gene,F58H1.3,1,11933783,0.556684,3983,11929799,1,11933429,-353,-354
V,+,11934954,0.972477,3.23455e-28,109,3,106,69,0,gene,F58H1.8,2,11934954,None,90,11934864,0,11934955,1,1
V,+,11958199,0.0,0.0,170,170,0,0,1,gene,F58H1.5,0,11958201,0.598684,13777,11944422,2,11958199,0,-2
V,+,12002851,0.0,0.5,1,1,0,0,1,gene,F57F5.1,0,12002979,21.9561,6478,11996373,128,12002834,-17,-145
V,+,12021061,0.0,0.03125,5,5,0,0,34,gene,F10C2.3,0,12021236,0.0662486,16655,12004406,175,12020999,-62,-237
V,+,12041414,0.00124069,0.0,806,805,1,1,124,gene,F10C2.4,1,12041415,0.672629,5768,12035646,1,12041413,-1,-2
V,+,12045238,0.964706,2.55314e-21,85,3,82,51,1,gene,F10C2.5,2,12045295,0.308837,99,12045139,57,12045238,0,-57
V,+,12048551,0.969697,2.90702e-17,66,2,64,49,0,gene,F10C2.6,3,12048551,0.314139,114,12048437,0,12048551,0,0
V,+,12087040,0.00840336,0.0,357,354,3,1,1,gene,R07B7.11,0,12087043,0.648397,871,12086169,3,12087040,0,-3
V,+,12091468,0.0,4.65661e-10,31,31,0,0,0,gene,R07B7.12,0,12091490,0.000888632,2700,12088768,22,12091491,23,1
V,+,12101099,0.0,2.38419e-07,22,22,0,0,1,gene,C13C4.2,0,12101111,0.23172,1204,12099895,12,12101099,0,-12
V,+,12103792,1.0,0.5,1,0,1,0,0,gene,C13C4.1,0,12103920,0.110242,591,12103201,128,12104234,442,314
V,+,12114799,0.0,0.0,357,357,0,0,35,gene,C13C4.5,0,12114806,0.594441,5856,12108943,7,12114799,0,-7
V,+,12121382,0.0,1.45519e-11,36,36,0,0,16,gene,C13C4.6,0,12121394,0.0567647,2859,12118523,12,12121475,93,81
V,+,12132754,0.0,2.38419e-07,22,22,0,0,1,gene,C27A7.1,0,12132759,0.238636,8013,12124741,5,12132751,-3,-8
V,+,12133294,0.0,0.00195312,9,9,0,0,0,gene,C27A7.1,0,12133373,0.238636,8553,12124741,79,12133294,0,-79
V,+,12138362,0.0,0.5,1,1,0,0,5,gene,C27A7.2,0,12138367,0.0262692,1161,12137201,5,12138057,-305,-310
V,+,12141230,0.0,0.25,2,2,0,0,0,gene,C27A7.3,0,12141251,0.051541,1108,12140122,21,12141230,0,-21
V,+,12152982,0.0,3.55271e-15,48,48,0,0,293,gene,C27A7.8,0,12153007,0.682817,8886,12144096,25,12152882,-100,-125
V,+,12184847,0.0,0.125,3,3,0,0,0,gene,ZK863.5,0,12184902,0.0618931,18616,12166231,55,12184755,-92,-147
V,+,12191325,0.012352,0.0,1943,1919,24,19,5,gene,ZK863.6,1,12191343,8.22943,5198,12186127,18,12191325,0,-18
V,+,12192081,0.953297,0.0,364,17,347,227,1,gene,ZK863.7,2,12192117,1.80702,102,12191979,36,12192081,0,-36
V,+,12194313,0.841379,0.0,1015,161,854,657,52,gene,ZK836.2,3,12194341,1.27461,57,12194256,28,12194313,0,-28
V,+,12213133,0.0,2.64698e-23,75,75,0,0,0,gene,K12F2.2,0,12213137,0.686272,7833,12205300,4,12213133,0,-4
V,+,12215521,0.0,0.5,1,1,0,0,0,gene,K12F2.2,0,12215547,0.686272,10221,12205300,26,12215521,0,-26
V,+,12216343,0.0,0.25,2,2,0,0,0,gene,K12F2.2,0,12216345,0.686272,11043,12205300,2,12216343,0,-2
V,+,12219744,0.0,4.33681e-19,61,61,0,0,0,gene,K12F2.2,0,12219843,0.686272,14444,12205300,99,12219744,0,-99
V,+,12221947,0.0,1.19209e-07,23,23,0,0,0,gene,K12F2.2,0,12221997,0.686272,16647,12205300,50,12221947,0,-50
V,+,12246391,0.004329,0.0,231,230,1,1,0,gene,T04H1.4,1,12246421,0.513195,4643,12241748,30,12246391,0,-30
V,+,12251147,0.885057,0.0,435,50,385,287,1,gene,T04H1.5,2,12251152,0.5789,108,12251039,5,12251145,-2,-7
V,+,12256472,0.0,0.5,1,1,0,0,4,gene,T04H1.7,0,12256508,0.0997516,1216,12255256,36,12256472,0,-36
V,+,12261604,0.0,0.0,262,262,0,0,0,gene,T04H1.9,0,12261609,0.31638,593,12261011,5,12261610,6,1
V,+,12271679,0.0,0.0,201,201,0,0,36,gene,F55C5.4,0,12271689,0.831726,6370,12265309,10,12271690,11,1
V,+,12302290,0.00119048,0.0,840,839,1,1,4,gene,C51F7.1,0,12302346,2.02021,8590,12293700,56,12302290,0,-56
V,+,12318433,0.00272079,0.0,23155,23092,63,55,0,gene,R04F11.2,0,12318517,29.3883,10659,12307774,84,12318433,0,-84
V,+,12345743,0.0,2.32831e-10,32,32,0,0,0,gene,F23H12.3,0,12345759,0.321908,25716,12320027,16,12345741,-2,-18
V,+,12358453,0.0,5.42101e-20,64,64,0,0,0,gene,F23H12.5,0,12358510,0.435724,4335,12354118,57,12358453,0,-57
V,+,12365325,0.0,0.5,1,1,0,0,0,gene,F23H12.9,0,12365374,2.68344,1831,12363494,49,12365325,0,-49
V,+,12397653,0.0,3.23117e-27,88,88,0,0,1,gene,K01D12.5,0,12397655,0.427465,11082,12386571,2,12397656,3,1
V,+,12418398,0.0139594,0.0,788,777,11,7,0,gene,C54D10.3,0,12418407,2.815,11480,12406918,9,12418398,0,-9
V,+,12429151,0.0,1.77636e-15,49,49,0,0,1,gene,C54D10.5,0,12429162,0.118399,9924,12419227,11,12429163,12,1
V,+,12450613,0.00288184,0.0,347,346,1,1,5,gene,F28C1.1,0,12450615,0.492134,2103,12448510,2,12450613,0,-2
V,+,12468489,0.0,2.84217e-14,45,45,0,0,8,gene,F28C1.3,0,12468490,0.67386,15347,12453142,1,12468489,0,-1
V,+,12478219,0.00123457,0.0,1620,1618,2,2,0,gene,W04D2.1,1,12478221,2.06338,4883,12473336,2,12478219,0,-2
V,+,12489266,0.0,2.46519e-32,105,105,0,0,0,gene,W04D2.3,0,12489270,0.158975,1962,12487304,4,12489266,0,-4
V,+,12498061,0.00963855,0.0,415,411,4,3,2,gene,W04D2.6,1,12498098,1.74317,5114,12492947,37,12498061,0,-37
V,+,12500309,0.0,0.5,1,1,0,0,30,gene,W04D2.6,1,12500313,1.74317,7362,12492947,4,12499887,-422,-426
V,+,12503574,1.0,0.125,3,0,3,2,5,gene,T28H10.1,2,12503610,0.136544,25,12503549,36,12503611,37,1
V,+,12503607,0.887755,3.53551e-16,98,11,87,49,2,gene,T28H10.1,2,12503610,0.136544,58,12503549,3,12503611,4,1
V,+,12512969,0.0,0.00195312,9,9,0,0,338,gene,T28H10.3,0,12513012,3.26162,8057,12504912,43,12512827,-142,-185
V,+,12540846,0.0,0.0,169,169,0,0,1,gene,F45D3.2,0,12540883,0.782527,12921,12527925,37,12540846,0,-37
V,+,12560538,0.0015748,0.0,635,634,1,1,4,gene,F45D3.5,1,12560538,1.6723,17757,12542781,0,12560538,0,0
V,+,12563293,0.916139,0.0,632,53,579,399,1,gene,E02A10.1,2,12563346,2.01159,104,12563189,53,12563293,0,-53
V,+,12579420,0.0,4.44089e-16,51,51,0,0,0,gene,E02A10.5,0,12579479,None,13833,12565587,59,12579480,60,1
V,+,12599999,0.0157068,0.0,191,188,3,3,1,gene,C14C10.5,1,12600092,1.31737,10546,12589453,93,12600093,94,1
V,+,12600083,0.0425532,7.68097e-12,47,45,2,2,20,gene,C14C10.5,1,12600092,1.31737,10630,12589453,9,12600093,10,1
V,+,12607220,0.938053,3.719e-24,113,7,106,64,11,gene,C14C10.6,2,12607221,0.46979,110,12607110,1,12607222,2,1
V,+,12637470,0.000425742,0.0,44628,44609,19,13,24,gene,F56H9.2,0,12637492,58.8382,8925,12628545,22,12637468,-2,-24
V,+,12668034,0.0,2.84217e-14,45,45,0,0,0,gene,W05B10.4,0,12668038,0.369597,9496,12658538,4,12668033,-1,-5
V,+,12690315,0.0,0.000488281,11,11,0,0,0,gene,K10C8.2,0,12690320,0.0508918,17781,12672534,5,12690313,-2,-7
V,+,12696051,0.0,0.25,2,2,0,0,22,gene,K10C8.4,0,12696157,0.123468,3781,12692270,106,12696032,-19,-125
V,+,12696076,0.0,5.96046e-08,24,24,0,0,18,gene,K10C8.4,0,12696157,0.123468,3806,12692270,81,12696032,-44,-125
V,+,12697666,0.00799087,0.0,876,869,7,6,21,gene,K10C8.3,1,12697681,1.9381,999,12696667,15,12697666,0,-15
V,+,12703253,0.00714286,1.00445e-40,140,139,1,1,12,gene,K10C8.3,1,12703262,1.9381,6586,12696667,9,12703251,-2,-11
V,+,12704190,0.939655,5.61258e-25,116,7,109,74,9,gene,R11D1.1,2,12704196,0.455118,110,12704080,6,12704190,0,-6
V,+,12728439,0.025,1.79913e-41,160,156,4,4,1,gene,R11D1.9,1,12728539,1.20817,1000,12727439,100,12728439,0,-100
V,+,12729328,0.931818,1.75107e-18,88,6,82,57,32,gene,R11D1.10,2,12729328,0.447759,104,12729224,0,12729328,0,0
V,+,12741849,0.00167616,0.0,2983,2978,5,5,1,gene,C15C8.3,0,12741877,5.22039,830,12741019,28,12741849,0,-28
V,+,12763753,0.0105105,0.0,666,659,7,5,0,gene,F18E2.3,0,12763788,1.20019,13982,12749771,35,12763753,0,-35
V,+,12769061,0.0,0.25,2,2,0,0,1,gene,F18E2.4,0,12769075,0.0115692,1320,12767741,14,12769076,15,1
V,+,12773228,0.0,0.000976562,10,10,0,0,2,gene,F18E2.6,0,12773329,0.0149965,2575,12770653,101,12773330,102,1
V,+,12775185,0.0,7.62939e-06,17,17,0,0,0,gene,ZC455.1,0,12775185,0.184508,4532,12770653,0,12775186,1,1
V,+,12835272,0.0,0.5,1,1,0,0,0,gene,C44H9.4,0,12835327,0.0450423,1128,12834144,55,12835515,243,188
V,+,12835501,0.0,0.000488281,11,11,0,0,0,gene,C44H9.4,0,12835514,0.0450423,1357,12834144,13,12835515,14,1
V,+,12859341,0.00287356,0.0,348,347,1,1,0,gene,T07F10.1,0,12859375,0.426216,19751,12839590,34,12859341,0,-34
V,+,12878324,0.0277778,6.29104e-28,108,105,3,2,1,gene,T07F10.4,0,12878352,0.776723,11997,12866327,28,12878324,0,-28
V,+,12909921,0.00446429,0.0,224,223,1,0,1,gene,F54F3.1,0,12909925,1.42584,28013,12881908,4,12909921,0,-4
V,+,12922416,0.00294118,0.0,340,339,1,0,23,gene,F54F3.4,0,12922428,0.913532,907,12921509,12,12922429,13,1
V,+,12929292,0.0,4.48416e-44,144,144,0,0,3,gene,T16G1.2,0,12929294,0.43122,1310,12927982,2,12929295,3,1
V,+,12952444,0.0163934,0.0,183,180,3,2,6,gene,T16G1.10,1,12952445,0.515351,619,12951825,1,12952446,2,1
V,+,12953432,1.0,0.5,1,0,1,1,1,gene,T16G1.11,2,12953475,3.87845,416,12953016,43,12953810,378,335
V,+,12953810,0.802317,0.0,1381,273,1108,702,4,gene,T16G1.11,2,12953879,3.87845,794,12953016,69,12953810,0,-69
V,+,12965622,0.0,0.0625,4,4,0,0,0,gene,R186.2,0,12965650,0.00956147,10585,12955037,28,12965622,0,-28
V,+,12968663,0.0,1.52588e-05,16,16,0,0,4,gene,R186.4,0,12968698,0.0796382,2833,12965830,35,12968663,0,-35
V,+,12970918,0.0371058,0.0,539,519,20,12,3,gene,R186.7,0,12970924,1.26793,380,12970538,6,12970916,-2,-8
V,+,12988365,0.000734754,0.0,1361,1360,1,1,69,gene,F15B9.8,0,12988369,3.00538,15275,12973090,4,12988365,0,-4
V,+,13002128,0.0,0.0,399,399,0,0,6,gene,F15B9.4,0,13002150,0.498194,5483,12996645,22,13002151,23,1
V,+,13013953,0.0,0.0,156,156,0,0,1,gene,F15B9.6,0,13013962,0.204588,7157,13006796,9,13013953,0,-9
V,+,13043521,0.00273723,0.0,1096,1093,3,3,0,gene,W07G4.4,0,13043537,4.34347,9484,13034037,16,13043521,0,-16
V,+,13047789,0.00383877,0.0,521,519,2,2,0,gene,W07G4.5,0,13047807,2.4302,1619,13046170,18,13047787,-2,-20
V,+,13061958,0.0,0.125,3,3,0,0,0,gene,F42E8.1,0,13061971,0.0116958,12913,13049045,13,13062238,280,267
V,+,13085699,0.0,0.015625,6,6,0,0,17,gene,C34B4.2,0,13085780,1.34031,21694,13064005,81,13086004,305,224
V,+,13086518,0.00316456,0.0,632,630,2,1,9,gene,C34B4.2,0,13086553,1.34031,22513,13064005,35,13086518,0,-35
V,+,13116297,0.00639659,0.0,469,466,3,3,10,gene,B0365.1,0,13116316,1.15989,19031,13097266,19,13116312,15,-4
V,+,13152729,0.0,0.0,256,256,0,0,3,gene,K03H4.2,0,13152729,0.766902,453,13152276,0,13152704,-25,-25
V,+,13155111,0.0,5.68434e-14,44,44,0,0,2,gene,T09E8.1,0,13155132,2.69332,1321,13153790,21,13155133,22,1
V,+,13159382,0.05,1.90735e-05,20,19,1,1,2,gene,T09E8.1,0,13159384,2.69332,5592,13153790,2,13159380,-2,-4
V,+,13167211,0.0,1.90735e-06,19,19,0,0,2,gene,T09E8.1,0,13167217,2.69332,13421,13153790,6,13167346,135,129
V,+,13172420,0.0,1.61559e-27,89,89,0,0,1,gene,T09E8.1,0,13172558,2.69332,18630,13153790,138,13172420,0,-138
V,+,13176521,0.00515996,0.0,969,964,5,5,0,gene,T09E8.2,1,13176615,0.688084,600,13175921,94,13176521,0,-94
V,+,13180140,0.895954,0.0,865,90,775,483,28,gene,T09E8.3,2,13180142,2.27945,145,13179995,2,13180140,0,-2
V,+,13207542,0.0,1.52588e-05,16,16,0,0,0,gene,F57B1.5,0,13207567,0.247656,20441,13187101,25,13207573,31,6
V,+,13211984,0.0,2.32831e-10,32,32,0,0,0,gene,F57B1.6,0,13211991,0.489068,3278,13208706,7,13211992,8,1
V,+,13264331,0.0,4.76837e-07,21,21,0,0,0,gene,C34D1.5,0,13264355,0.451837,51059,13213272,24,13264356,25,1
V,+,13268248,0.0022779,0.0,439,438,1,0,9,gene,C34D1.5,0,13268259,0.451837,54976,13213272,11,13268260,12,1
V,+,13268277,0.0,0.5,1,1,0,0,214,gene,C34D1.5,0,13268278,0.451837,55005,13213272,1,13268260,-17,-18
V,+,13301604,0.0,6.10352e-05,14,14,0,0,2,gene,C26E1.3,0,13301659,0.118638,3743,13297861,55,13301463,-141,-196
V,+,13301644,0.0,1.73472e-18,59,59,0,0,6,gene,C26E1.3,0,13301659,0.118638,3783,13297861,15,13301463,-181,-196
V,+,13304949,0.0,5.04871e-29,94,94,0,0,0,gene,C26E1.2,0,13304978,0.214634,353,13304596,29,13304979,30,1
V,+,13313386,0.00297619,0.0,336,335,1,1,0,gene,C50B6.3,0,13313408,0.628529,4152,13309234,22,13313409,23,1
V,+,13336180,0.04,7.45058e-07,25,24,1,1,3,gene,C50B6.9,0,13336184,0.0996299,7503,13328677,4,13336178,-2,-6
V,+,13360371,0.0,0.25,2,2,0,0,1,gene,F32H5.4,1,13360596,0.120775,536,13359835,225,13361015,644,419
V,+,13361014,0.0,1.73472e-18,59,59,0,0,0,gene,F32H5.4,1,13361014,0.120775,1179,13359835,0,13361015,1,1
V,+,13368809,0.0,0.25,2,2,0,0,1,gene,F32H5.6,0,13368862,0.0790502,5641,13363168,53,13368863,54,1
V,+,13406729,0.00497512,0.0,804,800,4,4,6,gene,F53F1.2,1,13406734,1.41456,23843,13382886,5,13406727,-2,-7
V,+,13408053,0.558559,0.035474,111,49,62,46,0,gene,F53F1.3,2,13408197,0.448832,30,13408023,144,13408053,0,-144
V,+,13414917,0.0,4.76837e-07,21,21,0,0,35019,gene,F53F1.5,0,13414987,9.29195,3395,13411522,70,13414873,-44,-114
V,+,13443893,0.0,0.000976562,10,10,0,0,0,gene,Y2H9A.6,0,13443906,None,669,13443224,13,13443645,-248,-261
V,+,13445708,0.0,0.5,1,1,0,0,2,gene,Y2H9A.4,0,13445708,0.142314,705,13445003,0,13445815,107,107
V,+,13445815,0.0,7.62939e-06,17,17,0,0,3,gene,Y2H9A.4,0,13445826,0.142314,812,13445003,11,13445815,0,-11
V,+,13459273,0.0,0.125,3,3,0,0,9,gene,F25H9.4,0,13459311,0.168553,37,13459236,38,13459312,39,1
V,+,13462844,0.0,1.38778e-17,56,56,0,0,2,gene,F25H9.5,0,13462906,1.22707,1290,13461554,62,13462960,116,54
V,+,13463017,0.0,4.23516e-22,71,71,0,0,195,gene,F25H9.5,0,13463087,1.22707,1463,13461554,70,13463030,13,-57
V,+,13463030,0.0,3.30872e-24,78,78,0,0,169,gene,F25H9.5,0,13463087,1.22707,1476,13461554,57,13463030,0,-57
V,+,13523314,0.0,0.0,167,167,0,0,1,gene,R11G10.3,0,13523331,0.0600433,24674,13498640,17,13523340,26,9
V,+,13527411,0.0,0.5,1,1,0,0,0,gene,C56A3.10,0,13527482,None,28771,13498640,71,13527411,0,-71
V,+,13551781,0.00442478,0.0,452,450,2,1,5,gene,C56A3.5,0,13551781,0.701633,22247,13529534,0,13551722,-59,-59
V,+,13560251,0.0,2.32831e-10,32,32,0,0,0,gene,C56A3.8,0,13560304,0.295836,518,13559733,53,13560305,54,1
V,+,13565674,0.00560853,0.0,1783,1773,10,7,3,gene,C50B8.1,0,13565675,2.86054,3871,13561803,1,13565674,0,-1
V,+,13568663,0.00928793,0.0,323,320,3,2,60,gene,C50B8.2,0,13568663,0.638743,1858,13566805,0,13568645,-18,-18
V,+,13578783,0.00460829,0.0,217,216,1,1,0,gene,C50B8.6,0,13578783,0.386615,5549,13573234,0,13578781,-2,-2
V,+,13591637,0.0,0.03125,5,5,0,0,0,gene,F53F4.3,0,13591720,1.16266,1034,13590603,83,13591944,307,224
V,+,13591935,0.00553506,0.0,1084,1078,6,4,4,gene,F53F4.3,0,13591943,1.16266,1332,13590603,8,13591944,9,1
V,+,13625858,0.0060241,0.0,332,330,2,2,9,gene,F53F4.12,1,13625885,0.496636,4604,13621254,27,13625842,-16,-43
V,+,13627384,0.012987,5.09543e-22,77,76,1,0,1,gene,F53F4.14,2,13627451,0.992855,91,13627293,67,13627384,0,-67
V,+,13627424,0.871264,0.0,435,56,379,313,16,gene,F53F4.14,2,13627451,0.992855,131,13627293,27,13627424,0,-27
V,+,13661072,0.0083682,0.0,239,237,2,2,0,gene,F58G11.1,1,13661101,1.16057,31430,13629642,29,13661072,0,-29
V,+,13665208,0.381657,1.57555e-10,676,418,258,191,0,gene,F58G11.2,2,13665211,1.8924,1164,13664044,3,13665212,4,1
V,+,13672405,0.0,0.0078125,7,7,0,0,0,gene,F58G11.4,0,13672411,0.0374549,3309,13669096,6,13672407,2,-4
V,+,13678685,0.00854701,0.0,234,232,2,2,14,gene,F58G11.6,0,13678685,0.483329,2949,13675736,0,13678686,1,1
V,+,13689702,0.0,1.0842e-19,63,63,0,0,0,gene,T01D3.1,0,13689740,0.110988,8353,13681349,38,13689702,0,-38
V,+,13704490,0.0,5.82077e-11,34,34,0,0,20,gene,T01D3.3,0,13704608,0.810692,1352,13703138,118,13704739,249,131
V,+,13704839,0.0,4.70198e-38,124,124,0,0,25,gene,T01D3.3,0,13704903,0.810692,1701,13703138,64,13704839,0,-64
V,+,13725683,0.0,0.00195312,9,9,0,0,0,gene,F35E12.3,0,13725713,0.0130181,3764,13721919,30,13725714,31,1
V,+,13757942,0.0,2.22045e-16,52,52,0,0,0,gene,F20G2.7,0,13757968,None,5536,13752406,26,13758140,198,172
V,+,13764376,0.0,3.05176e-05,15,15,0,0,0,gene,F20G2.6,0,13764417,0.194859,4518,13759858,41,13764376,0,-41
V,+,13775603,0.0,0.25,2,2,0,0,28,gene,F53C11.1,0,13775603,0.354721,2098,13773505,0,13775559,-44,-44
V,+,13775664,0.0,0.00012207,13,13,0,0,127,gene,F53C11.1,0,13775673,0.354721,2159,13773505,9,13775559,-105,-114
V,+,13782253,0.0,0.03125,5,5,0,0,15,gene,F53C11.3,0,13782296,1.92488,3820,13778433,43,13782210,-43,-86
V,+,13787346,0.00575264,0.0,1043,1037,6,6,22,gene,F53C11.5,0,13787356,1.54766,3049,13784297,10,13787357,11,1
V,+,13790825,0.0,7.70372e-34,110,110,0,0,4,gene,F53C11.5,0,13790832,1.54766,6528,13784297,7,13790825,0,-7
V,+,13813050,0.0,9.53674e-07,20,20,0,0,0,gene,F55B12.1,0,13813116,0.0839972,12625,13800425,66,13813117,67,1
V,+,13819169,0.00490196,0.0,612,609,3,2,2,gene,F55B12.3,1,13819172,1.72875,4013,13815156,3,13819169,0,-3
V,+,13822860,0.957983,2.74802e-28,119,5,114,77,0,gene,F55B12.4,2,13822877,0.563637,71,13822789,17,13822860,0,-17
V,+,13822922,1.0,0.000488281,11,0,11,9,11,gene,F55B12.4,2,13822967,0.563637,30,13822892,45,13822922,0,-45
V,+,13822934,0.863248,1.21152e-16,117,16,101,69,45,gene,F55B12.4,2,13822967,0.563637,42,13822892,33,13822934,0,-33
V,+,13828075,0.00416667,0.0,240,239,1,0,41,gene,F55B12.5,0,13828076,0.870023,3045,13825030,1,13828075,0,-1
V,+,13839548,0.0,4.23516e-22,71,71,0,0,8,gene,F55B12.10,0,13839576,None,1058,13838490,28,13839577,29,1
V,+,13873003,0.0,5.04871e-29,94,94,0,0,12,gene,F09F3.9,0,13873008,0.169547,881,13872122,5,13873003,0,-5
V,+,13876639,0.0018797,0.0,532,531,1,0,5,gene,T22G5.1,0,13876644,0.55728,941,13875698,5,13876645,6,1
V,+,13879360,0.00132979,0.0,1504,1502,2,2,6,gene,T22G5.2,0,13879363,1.98151,1546,13877814,3,13879364,4,1
V,+,13880722,0.0,2.29589e-41,135,135,0,0,1,gene,T22G5.3,0,13880723,0.231707,701,13880021,1,13880722,0,-1
V,+,13887464,0.0,3.05176e-05,15,15,0,0,1,gene,T22G5.4,0,13887465,0.0282786,3531,13883933,1,13887466,2,1
V,+,13889746,0.0,0.125,3,3,0,0,17,gene,T22G5.7,0,13889767,0.0591514,375,13889371,21,13889677,-69,-90
V,+,13893211,0.00362319,0.0,276,275,1,1,1,gene,T22G5.5,0,13893220,1.14102,2075,13891136,9,13893211,0,-9
V,+,13906300,0.125,0.00183105,16,14,2,2,10,gene,C06B3.4,0,13906304,0.810673,496,13905804,4,13906300,0,-4
V,+,13936868,0.0,0.5,1,1,0,0,0,gene,R10D12.17,0,13937047,0.0273653,4730,13932138,179,13937031,163,-16
V,+,13954164,0.00537634,0.0,186,185,1,0,3,gene,R10D12.9,0,13954172,0.624759,3962,13950202,8,13954164,0,-8
V,+,13962224,0.00970874,1.01566e-29,103,102,1,1,1,gene,R10D12.13,1,13962260,2.09882,6240,13955984,36,13962224,0,-36
V,+,13963742,0.861897,0.0,1202,166,1036,788,5,gene,R10D12.14,2,13963778,4.1288,1,13963741,36,13963779,37,1
V,+,13992469,0.0,0.03125,5,5,0,0,1,gene,F58E10.7,0,13992568,3.7207,5592,13986877,99,13992506,37,-62
V,+,14012384,0.00255754,0.0,391,390,1,1,66,gene,F58E10.4,0,14012385,1.15448,19102,13993282,1,14012140,-244,-245
V,+,14033804,0.0,7.45058e-09,27,27,0,0,65,gene,T08G5.12,0,14033814,0.101569,1538,14032266,10,14033815,11,1
V,+,14049144,0.0,0.0078125,7,7,0,0,0,gene,F58D12.1,0,14049213,0,749,14048395,69,14049457,313,244
V,+,14057647,0.0,0.25,2,2,0,0,0,gene,F58D12.3,0,14057681,0.00471295,9252,14048395,34,14057647,0,-34
V,+,14074411,0.0,0.000488281,11,11,0,0,4,gene,D1086.11,0,14074472,1.32958,2440,14071971,61,14074473,62,1
V,+,14074420,0.0,0.0,1349,1349,0,0,10,gene,D1086.11,0,14074472,1.32958,2449,14071971,52,14074473,53,1
V,+,14079608,0.0,0.0,263,263,0,0,0,gene,D1086.6,0,14079657,0.822509,3086,14076522,49,14079608,0,-49
V,+,14082560,0.0,0.00390625,8,8,0,0,0,gene,D1086.10,0,14082615,13.8946,990,14081570,55,14082560,0,-55
V,+,14084036,0.0,0.5,1,1,0,0,2,gene,D1086.7,0,14084041,0.338687,647,14083389,5,14084077,41,36
V,+,14086003,0.0,0.000244141,12,12,0,0,3,gene,D1086.18,0,14086004,None,53,14085950,1,14086005,2,1
V,+,14088149,0.0,2.91038e-11,35,35,0,0,1,gene,D1086.19,0,14088157,None,1152,14086997,8,14088158,9,1
V,+,14088350,0.0,0.0625,4,4,0,0,10,gene,D1086.19,0,14088452,None,1353,14086997,102,14088158,-192,-294
V,+,14094023,0.0,5.55112e-17,54,54,0,0,40,gene,D1086.8,0,14094029,0.814162,235,14093788,6,14093975,-48,-54
V,+,14094030,0.0,0.0,441,441,0,0,58,gene,D1086.8,0,14094075,0.814162,242,14093788,45,14093975,-55,-100
V,+,14098853,0.0,0.0625,4,4,0,0,64,gene,D1086.1,0,14098857,0.617964,1950,14096903,4,14098654,-199,-203
V,+,14101498,0.0,0.5,1,1,0,0,1,gene,D1086.12,0,14101524,0.453461,1223,14100275,26,14101496,-2,-28
V,+,14177886,0.0,1.2326e-32,106,106,0,0,1,gene,ZC376.4,0,14177898,0.180375,20457,14157429,12,14177886,0,-12
V,+,14185588,0.0,6.10352e-05,14,14,0,0,85,gene,ZC376.6,0,14185591,0.428358,4245,14181343,3,14185592,4,1
V,+,14194253,0.00588235,0.0,850,845,5,4,2,gene,ZC376.7,0,14194289,1.55443,2290,14191963,36,14194253,0,-36
V,+,14243996,0.0,0.5,1,1,0,0,0,gene,K02E11.2,0,14244010,0.000473105,35178,14208818,14,14244011,15,1
V,+,14256916,0.0,0.125,3,3,0,0,0,gene,F40G12.1,0,14256919,0.00131732,3832,14253084,3,14256920,4,1
V,+,14285978,0.0,0.0,305,305,0,0,0,gene,F40G12.11,0,14286009,0.244777,844,14285134,31,14285978,0,-31
V,+,14300872,1.0,0.5,1,0,1,0,0,gene,F14D7.6,0,14300897,0.191398,507,14300365,25,14301228,356,331
V,+,14301220,0.0232558,4.88853e-12,43,42,1,1,0,gene,F14D7.6,0,14301227,0.191398,855,14300365,7,14301228,8,1
V,+,14328954,0.0,0.00390625,8,8,0,0,7,gene,F47B8.6,0,14328972,0.0454127,7834,14321120,18,14328973,19,1
V,+,14342677,0.0,0.125,3,3,0,0,0,gene,F47B8.10,0,14342713,0.0780938,4062,14338615,36,14342875,198,162
V,+,14342978,0.0,9.53674e-07,20,20,0,0,11,gene,F47B8.10,0,14343003,0.0780938,4363,14338615,25,14342875,-103,-128
V,+,14347581,0.00909091,0.0,330,327,3,3,5,gene,Y49A3A.1,1,14347582,0.660903,779,14346802,1,14347581,0,-1
V,+,14351518,0.0755968,0.0,5278,4879,399,285,1,gene,Y49A3A.2,2,14351523,11.9,231,14351287,5,14351518,0,-5
V,+,14351524,0.0,0.5,1,1,0,0,553,gene,Y49A3A.2,2,14351589,11.9,237,14351287,65,14351524,0,-65
V,+,14354204,1.0,0.5,1,0,1,0,18,gene,Y49A3A.3,3,14354256,0.439563,18,14354186,52,14354217,13,-39
V,+,14354217,0.868421,8.4429e-22,152,20,132,94,23,gene,Y49A3A.3,3,14354256,0.439563,31,14354186,39,14354217,0,-39
V,+,14355883,0.00434227,0.0,3915,3898,17,15,125,gene,Y49A3A.5,4,14355887,4.76245,312,14355571,4,14355883,0,-4
V,+,14408883,0.0,4.44089e-16,51,51,0,0,2,gene,C15H11.2,0,14408884,0.0785353,13305,14395578,1,14408885,2,1
V,+,14417786,0.0,0.000244141,12,12,0,0,59,gene,C15H11.5,0,14417825,0.823186,1812,14415974,39,14417849,63,24
V,+,14440948,0.0034188,0.0,585,583,2,2,63,gene,F23B12.4,0,14440957,1.6453,10731,14430217,9,14440948,0,-9
V,+,14443134,0.0,0.000976562,10,10,0,0,19,gene,F23B12.4,0,14443163,1.6453,628,14442506,29,14443164,30,1
V,+,14447548,0.00635593,0.0,944,938,6,5,36,gene,F23B12.6,1,14447549,1.14419,2394,14445154,1,14447548,0,-1
V,+,14449505,0.918539,0.0,356,29,327,245,2,gene,F23B12.7,2,14449521,0.901435,102,14449403,16,14449505,0,-16
V,+,14449520,0.8,0.0439453,10,2,8,5,1247,gene,F23B12.7,2,14449521,0.901435,117,14449403,1,14449520,0,-1
V,+,14457237,0.0,0.000244141,12,12,0,0,11,gene,F08H9.1,0,14457282,0.229473,4458,14452779,45,14457283,46,1
V,+,14457250,0.00480769,0.0,208,207,1,1,18,gene,F08H9.1,0,14457282,0.229473,4471,14452779,32,14457283,33,1
V,+,14474282,0.0,0.5,1,1,0,0,49,gene,F08H9.7,0,14474326,0.965071,102,14474180,44,14474249,-33,-77
V,+,14482968,0.00483092,0.0,207,206,1,0,0,gene,R02D5.3,0,14483011,0.348763,323,14482645,43,14482968,0,-43
V,+,14508059,0.0,0.0,740,740,0,0,5,gene,R02D5.1,0,14508060,1.42855,23907,14484152,1,14508061,2,1
V,+,14525197,0.00189036,0.0,2116,2112,4,4,31,gene,C53A5.3,0,14525215,2.82833,15731,14509466,18,14525197,0,-18
V,+,14530925,0.0,7.62939e-06,17,17,0,0,0,gene,C53A5.5,0,14530931,0.0958988,3706,14527219,6,14530923,-2,-8
V,+,14597814,0.0,0.0,276,276,0,0,10,gene,R11H6.2,0,14597875,1.20425,33367,14564447,61,14597814,0,-61
V,+,14603896,0.0,7.10543e-15,47,47,0,0,1,gene,R11H6.3,0,14603903,0.12033,3998,14599898,7,14603715,-181,-188
V,+,14609844,0.0,0.125,3,3,0,0,125,gene,R11H6.4,0,14609878,0.306214,1830,14608014,34,14609797,-47,-81
V,+,14612345,0.0,0.00390625,8,8,0,0,15,gene,F43D2.1,0,14612364,1.73655,1832,14610513,19,14612246,-99,-118
V,+,14612356,0.00398406,0.0,502,500,2,2,29,gene,F43D2.1,0,14612364,1.73655,1843,14610513,8,14612246,-110,-118
V,+,14620943,0.0,2.93874e-39,128,128,0,0,0,gene,F43D2.4,0,14620958,0.320608,7429,14613514,15,14620949,6,-9
V,+,14627054,0.0,4.44089e-16,51,51,0,0,15,gene,F43D2.4,0,14627061,0.320608,13540,14613514,7,14627089,35,28
V,+,14631697,0.0,7.45058e-09,27,27,0,0,0,gene,F43D2.3,0,14631698,0.0264058,2451,14629246,1,14631699,2,1
V,+,14646547,0.0,0.0,186,186,0,0,5,gene,C54G10.3,0,14646560,1.32726,5357,14641190,13,14647007,460,447
V,+,14646998,0.0168539,0.0,178,175,3,3,1,gene,C54G10.3,0,14647032,1.32726,5808,14641190,34,14647007,9,-25
V,+,14680124,0.0,3.05176e-05,15,15,0,0,0,gene,C47E8.3,0,14680128,0.101189,13160,14666964,4,14680129,5,1
V,+,14684736,0.0163934,2.64545e-17,61,60,1,1,24,gene,C47E8.5,0,14684853,44.8104,1174,14683562,117,14684726,-10,-127
V,+,14685968,0.00312742,0.0,31016,30919,97,83,11,gene,C47E8.5,0,14685971,44.8104,2406,14683562,3,14685968,0,-3
V,+,14698767,0.0,6.61744e-24,77,77,0,0,0,gene,C47E8.8,0,14698777,0.110486,6989,14691778,10,14698778,11,1
V,+,14723124,0.0,0.125,3,3,0,0,0,gene,R08A2.7,0,14723149,0.150844,5861,14717263,25,14723150,26,1
V,+,14723134,0.0,1.49012e-08,26,26,0,0,0,gene,R08A2.7,0,14723149,0.150844,5871,14717263,15,14723150,16,1
V,+,14726710,0.0,0.0,464,464,0,0,1,gene,Y50E8A.1,0,14726714,0.676813,2157,14724553,4,14726715,5,1
V,+,14729451,0.00609756,0.0,328,326,2,1,14,gene,Y50E8A.3,0,14729464,0.849538,2322,14727129,13,14729465,14,1
V,+,14821663,0.00166389,0.0,601,600,1,0,0,gene,W06A7.2,0,14821666,0.56006,39579,14782084,3,14821667,4,1
V,+,14824429,0.0,1.86265e-09,29,29,0,0,10,gene,W06A7.4,0,14824444,3.54146,1010,14823419,15,14824472,43,28
V,+,14884426,0.0,0.0,152,152,0,0,0,gene,H12D21.13,0,14884523,0.225312,6166,14878260,97,14884426,0,-97
V,+,14895430,0.0,0.5,1,1,0,0,2,gene,H12D21.7,0,14895435,0.59947,769,14894661,5,14895455,25,20
V,+,14895607,0.0,0.5,1,1,0,0,5,gene,H12D21.7,0,14895671,0.59947,946,14894661,64,14895607,0,-64
V,+,14895806,0.0,0.0,192,192,0,0,16,gene,H12D21.7,0,14895809,0.59947,1145,14894661,3,14895806,0,-3
V,+,14915709,0.0,0.03125,5,5,0,0,1,gene,H12D21.11,0,14915713,0.00782011,3972,14911737,4,14915714,5,1
V,+,14936707,0.00299401,0.0,334,333,1,1,0,gene,C30G7.2,0,14936856,0.767044,19217,14917490,149,14936857,150,1
V,+,14949583,0.00200965,0.0,2488,2483,5,2,3,gene,C30G7.1,0,14949609,2.31246,10410,14939173,26,14949583,0,-26
V,+,14971244,0.0,0.0,441,441,0,0,2,gene,F02D8.5,0,14971256,0.651896,18642,14952602,12,14971257,13,1
V,+,14978311,0.0,1.16415e-10,33,33,0,0,0,gene,F02D8.2,0,14978312,0.136747,6086,14972225,1,14978313,2,1
V,+,14984715,0.0,4.76837e-07,21,21,0,0,6,gene,F02D8.4,0,14984751,0.859017,2249,14982466,36,14984715,0,-36
V,+,14990974,0.00575816,0.0,1042,1036,6,5,1,gene,T01C3.2,0,14990993,2.48239,3597,14987377,19,14990972,-2,-21
V,+,14999341,0.0,2.84217e-14,45,45,0,0,2,gene,T01C3.11,0,14999350,0.28794,1392,14997949,9,14999339,-2,-11
V,+,14999379,0.0,6.10352e-05,14,14,0,0,30,gene,T01C3.11,0,14999391,0.28794,1430,14997949,12,14999339,-40,-52
V,+,15004900,0.903226,2.09315e-06,31,3,28,20,0,gene,T01C3.9,2,15004924,0.956447,89,15004811,24,15004918,18,-6
V,+,15004908,0.812903,4.99946e-16,155,29,126,100,37,gene,T01C3.9,2,15004924,0.956447,97,15004811,16,15004918,10,-6
V,+,15053571,0.0,1.52588e-05,16,16,0,0,0,gene,C25D7.5,0,15053644,0.673482,18304,15035267,73,15053571,0,-73
V,+,15066104,0.00406631,0.0,3197,3184,13,12,1,gene,C25D7.8,1,15066115,1.99537,981,15065123,11,15066104,0,-11
V,+,15067271,0.891129,2.08912e-39,248,27,221,153,21,gene,C25D7.10,2,15067279,0.875845,32,15067239,8,15067271,0,-8
V,+,15067275,0.904762,0.000100136,21,2,19,9,34,gene,C25D7.10,2,15067279,0.875845,36,15067239,4,15067271,-4,-8
V,+,15068484,0.92,1.46797e-19,100,8,92,65,0,gene,C01G10.12,3,15068495,0.220533,98,15068386,11,15068496,12,1
V,+,15071682,0.0906801,0.0,397,361,36,28,71,gene,C01G10.11,0,15071689,1.81595,2372,15069310,7,15071682,0,-7
V,+,15082570,0.0,0.015625,6,6,0,0,46,gene,C01G10.9,0,15082592,1.22329,2615,15079955,22,15082570,0,-22
V,+,15085553,0.00312012,0.0,641,639,2,2,2,gene,C01G10.7,0,15085556,0.515868,1599,15083954,3,15085553,0,-3
V,+,15092887,0.0,2.71051e-20,65,65,0,0,3,gene,C01G10.16,0,15092981,0.19893,1981,15090906,94,15093016,129,35
V,+,15092990,0.0,0.0625,4,4,0,0,8,gene,C01G10.16,0,15093015,0.19893,2084,15090906,25,15093016,26,1
V,+,15093014,0.0,0.5,1,1,0,0,11,gene,C01G10.16,0,15093015,0.19893,2108,15090906,1,15093016,2,1
V,+,15111766,0.0,1.77636e-15,49,49,0,0,0,gene,T01G5.7,0,15111772,0.115731,1611,15110155,6,15111773,7,1
V,+,15184512,0.0118343,0.0,338,334,4,4,1,gene,Y75B12B.1,0,15184514,0.985037,667,15183845,2,15184512,0,-2
V,+,15189733,0.00411032,0.0,7542,7511,31,23,6,gene,Y75B12B.5,0,15189757,6.09781,295,15189438,24,15189733,0,-24
V,+,15190790,1.0,0.5,1,0,1,0,2,gene,Y75B12B.11,0,15191024,0.0489672,24,15190766,234,15191115,325,91
V,+,15241366,0.0,0.03125,5,5,0,0,0,gene,M01B2.6,0,15241389,0.0267069,7808,15233558,23,15241390,24,1
V,+,15244562,0.0,0.00390625,8,8,0,0,0,gene,M01B2.1,0,15244568,0.0210699,813,15243749,6,15244562,0,-6
V,+,15395502,0.00266756,0.0,2999,2991,8,7,17,gene,T06E6.2,0,15395518,15.5819,9152,15386350,16,15395502,0,-16
V,+,15395511,0.00326836,0.0,8567,8539,28,26,2138,gene,T06E6.2,0,15395518,15.5819,9161,15386350,7,15395511,0,-7
V,+,15417939,0.0,3.00927e-36,118,118,0,0,0,gene,T06E6.10,0,15417959,0.412564,846,15417093,20,15417960,21,1
V,+,15425844,0.0,0.03125,5,5,0,0,3,gene,Y36E3A.2,0,15425890,None,4560,15421284,46,15426005,161,115
V,+,15444572,0.0,0.25,2,2,0,0,0,gene,T26H5.9,0,15444591,19.2666,6165,15438407,19,15444715,143,124
V,+,15444723,0.00185153,0.0,11342,11321,21,12,68,gene,T26H5.9,0,15444728,19.2666,6316,15438407,5,15444715,-8,-13
V,+,15453268,0.0,0.5,1,1,0,0,0,gene,T23F1.2,0,15453285,None,3850,15449418,17,15453294,26,9
V,+,15471140,0.0,9.09495e-13,40,40,0,0,0,gene,T23F1.7,0,15471178,0.236698,4236,15466904,38,15471140,0,-38
V,+,15498540,0.0,1.11022e-16,53,53,0,0,0,gene,C06B8.7,0,15498543,0.314073,1168,15497372,3,15498548,8,5
V,+,15511984,0.0048711,0.0,85607,85190,417,368,2,gene,C06B8.8,0,15511999,257.621,758,15511226,15,15511984,0,-15
V,+,15517518,0.0,0.0,219,219,0,0,3,gene,F21A3.3,0,15517520,0.452709,4940,15512578,2,15517521,3,1
V,+,15538055,0.025641,7.09406e-11,39,38,1,1,5,gene,F21A3.5,0,15538061,0.148906,251,15537804,6,15538048,-7,-13
V,+,15567198,0.00106857,0.0,5615,5609,6,5,1,gene,F28F8.2,0,15567211,3.58474,20313,15546885,13,15567198,0,-13
V,+,15570179,0.0153971,0.0,1234,1215,19,7,4,gene,F28F8.3,0,15570183,2.64475,170,15570009,4,15570179,0,-4
V,+,15571284,0.0,2.24208e-44,145,145,0,0,4,gene,F28F8.4,1,15571292,0.148885,736,15570548,8,15571293,9,1
V,+,15572721,0.875,0.03125,8,1,7,7,0,gene,F28F8.8,2,15572729,0.0124141,200,15572521,8,15572738,17,9
V,+,15591400,0.0,0.00012207,13,13,0,0,2,gene,B0391.10,0,15591413,0.143934,1737,15589663,13,15591400,0,-13
V,+,15670662,0.0,0.5,1,1,0,0,0,gene,K06B4.15,0,15670673,None,701,15669961,11,15670662,0,-11
V,+,15704814,0.0,3.15544e-30,98,98,0,0,45,gene,K06B4.12,0,15704862,0.148606,8793,15696021,48,15704760,-54,-102
V,+,15719684,0.0,0.015625,6,6,0,0,1,gene,Y6E2A.7,0,15719729,0.0504491,10152,15709532,45,15719648,-36,-81
V,+,15769242,0.00995025,0.0,201,199,2,2,8,gene,F57A10.4,0,15769243,0.194179,2165,15767077,1,15769232,-10,-11
V,+,15782798,0.0,0.5,1,1,0,0,1,gene,T26E4.3,0,15782855,0.00935679,983,15781815,57,15782598,-200,-257
V,+,15816486,0.0,0.0,174,174,0,0,3,gene,F54B8.4,0,15816499,1.32481,3578,15812908,13,15816316,-170,-183
V,+,15867487,0.0,4.76837e-07,21,21,0,0,0,gene,T06C12.4,0,15867499,0.11175,662,15866825,12,15867500,13,1
V,+,15869092,0.0869565,3.016e-05,23,21,2,2,0,gene,T06C12.5,0,15869114,None,109,15868983,22,15869115,23,1
V,+,15869095,0.125,0.03125,8,7,1,1,0,gene,T06C12.5,0,15869114,None,112,15868983,19,15869115,20,1
V,+,15957209,0.0,1.52588e-05,16,16,0,0,6,gene,F36G9.3,0,15957224,0.0378179,378,15956831,15,15957225,16,1
V,+,15959611,0.0,0.000244141,12,12,0,0,0,gene,F36G9.4,0,15959632,None,278,15959333,21,15959611,0,-21
V,+,15976004,0.0,0.125,3,3,0,0,51,gene,F36G9.11,0,15976024,0.516983,14272,15961732,20,15975955,-49,-69
V,+,16002391,0.0285714,2.04558e-18,70,68,2,2,0,gene,C06C6.4,0,16002397,0.102312,4769,15997622,6,16002398,7,1
V,+,16023154,0.00294675,0.0,4751,4737,14,13,0,gene,T10C6.5,1,16023157,2.95361,713,16022441,3,16023154,0,-3
V,+,16024129,0.818182,0.0268555,11,2,9,8,14,gene,T10C6.6,2,16024139,0.970783,131,16023998,10,16024129,0,-10
V,+,16024140,0.724528,5.12243e-14,265,73,192,154,116,gene,T10C6.6,2,16024151,0.970783,142,16023998,11,16024140,0,-11
V,+,16024149,0.890675,0.0,311,34,277,170,506,gene,T10C6.6,2,16024151,0.970783,151,16023998,2,16024149,0,-2
V,+,16024742,0.0,1.61559e-27,89,89,0,0,0,gene,T10C6.6,2,16024845,0.970783,744,16023998,103,16024742,0,-103
V,+,16086358,0.0,0.000244141,12,12,0,0,0,gene,F22B8.4,0,16086374,0.00901642,7684,16078674,16,16086375,17,1
V,+,16095027,0.0117647,0.0,255,252,3,2,0,gene,F22B8.7,0,16095043,0.635158,7103,16087924,16,16095027,0,-16
V,+,16100483,0.0,1.43493e-42,139,139,0,0,61,gene,F22B8.6,0,16100500,0.673707,3360,16097123,17,16100483,0,-17
V,+,16103697,0.030303,2.90702e-17,66,64,2,1,1,gene,F44G3.2,0,16103737,0.0961163,1190,16102507,40,16103697,0,-40
V,+,16121627,0.000747384,0.0,1338,1337,1,1,2,gene,F44G3.6,0,16121655,2.61972,15726,16105901,28,16121627,0,-28
V,+,16143378,0.0,0.0625,4,4,0,0,7,gene,F10A3.3,0,16143417,0.0116064,20928,16122450,39,16143376,-2,-41
V,+,16149035,0.0,0.0625,4,4,0,0,0,gene,F10A3.4,0,16149044,0.259808,4572,16144463,9,16149043,8,-1
V,+,16149043,0.0,7.10543e-15,47,47,0,0,6,gene,F10A3.4,0,16149044,0.259808,4580,16144463,1,16149043,0,-1
V,+,16165886,0.0,0.5,1,1,0,0,0,gene,F10A3.13,0,16165899,0.00223753,610,16165276,13,16166039,153,140
V,+,16195492,0.5,0.5,2,1,1,0,0,gene,F11A5.4,0,16195494,0.000624053,145,16195347,2,16195482,-10,-12
V,+,16214686,0.0357143,1.04308e-07,28,27,1,1,4,gene,F11A5.9,0,16214701,0.656215,3429,16211257,15,16214696,10,-5
V,+,16214693,0.00955414,0.0,314,311,3,3,15,gene,F11A5.9,0,16214701,0.656215,3436,16211257,8,16214693,0,-8
V,+,16222498,0.0,0.25,2,2,0,0,0,gene,F11A5.11,0,16222657,None,778,16221720,159,16222126,-372,-531
V,+,16224132,0.0,0.5,1,1,0,0,0,gene,F11A5.12,0,16224136,0.00497863,1268,16222864,4,16224137,5,1
V,+,16230008,0.0,1.69407e-21,69,69,0,0,10,gene,F21H7.12,0,16230010,0.0937947,4665,16225343,2,16229962,-46,-48
V,+,16271394,0.0,0.125,3,3,0,0,12,gene,T13F3.8,0,16271442,0.134969,7643,16263751,48,16271372,-22,-70
V,+,16336413,0.0,0.25,2,2,0,0,0,gene,F57G8.4,0,16336428,0.00122884,1547,16334866,15,16336429,16,1
V,+,16338851,0.0,9.53674e-07,20,20,0,0,29,gene,F57G8.5,0,16338867,0.0838437,1195,16337656,16,16338827,-24,-40
V,+,16346873,0.0,0.000488281,11,11,0,0,18,gene,W08G11.1,0,16346877,0.108603,2795,16344078,4,16346863,-10,-14
V,+,16357324,0.00218818,0.0,914,912,2,1,0,gene,W08G11.4,1,16357454,1.57357,7622,16349702,130,16357324,0,-130
V,+,16367484,0.90411,1.35117e-25,146,14,132,91,10,gene,W08G11.3,2,16367511,0.552471,98,16367386,27,16367484,0,-27
V,+,16367494,0.836364,1.6351e-25,220,36,184,139,692,gene,W08G11.3,2,16367511,0.552471,108,16367386,17,16367494,0,-17
V,+,16401694,0.00220264,0.0,454,453,1,1,7,gene,F13A7.14,0,16401700,None,242,16401452,6,16401692,-2,-8
V,+,16402029,0.0,1.52588e-05,16,16,0,0,7,gene,F13A7.14,0,16402029,None,577,16401452,0,16402029,0,0
V,+,16405556,0.0121951,0.0,410,405,5,4,0,gene,F26D2.2,0,16405565,0.679553,484,16405072,9,16405566,10,1
V,+,16481427,0.0,0.000976562,10,10,0,0,118,gene,F57E7.1,0,16481450,0.141426,5442,16475985,23,16481382,-45,-68
V,+,16499154,0.0114943,5.62224e-25,87,86,1,1,5,gene,F36D3.1,0,16499171,0.384592,6013,16493141,17,16499154,0,-17
V,+,16538198,0.00436681,0.0,229,228,1,1,1,gene,Y32B12B.2,2,16538207,0.398534,830,16537368,9,16538198,0,-9
V,+,16553131,0.534483,0.0910809,58,27,31,25,0,gene,Y32B12B.4,2,16553136,0.212794,1047,16552084,5,16553137,6,1
V,+,16583055,0.0,0.125,3,3,0,0,0,gene,T03E6.4,0,16583074,0.000554105,5127,16577928,19,16583075,20,1
V,+,16606421,0.0,8.88178e-16,50,50,0,0,1,gene,Y32B12C.1,0,16606451,0.0477546,21445,16584976,30,16606421,0,-30
V,+,16728525,0.0,1.52588e-05,16,16,0,0,0,gene,T25E12.12,0,16728531,0.0497854,819,16727706,6,16728532,7,1
V,+,16747360,0.0273973,2.7825e-19,73,71,2,2,2,gene,T25E12.4,0,16747422,0.585524,2694,16744666,62,16747360,0,-62
V,+,16763944,0.0,4.65661e-10,31,31,0,0,0,gene,T25E12.4,0,16763964,0.585524,19278,16744666,20,16764059,115,95
V,+,16784549,0.0,0.0,388,388,0,0,4,gene,T25E12.4,0,16784557,0.585524,9546,16775003,8,16784549,0,-8
V,+,16789162,0.00961538,5.1276e-30,104,103,1,0,401,gene,W06H3.1,0,16789179,0.700021,1048,16788114,17,16789131,-31,-48
V,+,16794681,0.0,1.52588e-05,16,16,0,0,158,gene,W06H3.3,1,16794708,1.52358,2109,16792572,27,16794679,-2,-29
V,+,16795132,0.00646831,0.0,773,768,5,5,0,gene,W06H3.3,1,16795133,1.52358,2560,16792572,1,16795130,-2,-3
V,+,16802657,0.2,0.15625,5,4,1,1,4,gene,Y102A5A.1,2,16802674,1.60497,99,16802558,17,16802675,18,1
V,+,16802675,0.906542,0.0,428,40,388,296,17,gene,Y102A5A.1,2,16802687,1.60497,117,16802558,12,16802675,0,-12
V,+,16802774,1.0,0.5,1,0,1,1,182,gene,Y102A5A.1,2,16803189,1.60497,216,16802558,415,16802675,-99,-514
V,+,16815368,0.00738007,0.0,271,269,2,0,2,gene,T20B3.1,0,16815377,0.593738,734,16814634,9,16815368,0,-9
V,+,16833108,0.0,0.5,1,1,0,0,1,gene,T20B3.7,0,16833116,0.0383064,12595,16820513,8,16833117,9,1
V,+,16841248,0.0,0.125,3,3,0,0,1,gene,T20B3.8,0,16841259,None,2306,16838942,11,16841260,12,1
V,+,16854435,0.0,0.25,2,2,0,0,0,gene,Y102A5B.1,0,16854446,0.00606147,4440,16849995,11,16854447,12,1
V,+,16873831,0.0,0.0625,4,4,0,0,1,gene,F49A5.8,0,16873835,0.00334637,6800,16867031,4,16873743,-88,-92
V,+,16880781,0.0,2.71051e-20,65,65,0,0,0,gene,F09C6.14,0,16880793,0.106421,4786,16875995,12,16880794,13,1
V,+,16882670,0.0,8.88178e-16,50,50,0,0,0,gene,F09C6.12,0,16882677,0.225951,1534,16881136,7,16882678,8,1
V,+,16884849,0.0,1.52588e-05,16,16,0,0,0,gene,F09C6.13,0,16884874,0.0195749,1798,16883051,25,16884875,26,1
V,+,16889075,0.0487805,3.72893e-10,41,39,2,2,1,gene,F09C6.2,0,16889086,0.037965,3811,16885264,11,16889087,12,1
V,+,16904712,0.0,0.5,1,1,0,0,0,gene,F09C6.8,0,16904716,0.000284947,7173,16897539,4,16904712,0,-4
V,+,16912033,0.0,1.19209e-07,23,23,0,0,0,gene,F09C6.9,0,16912039,0.114469,5751,16906282,6,16912033,0,-6
V,+,16918538,0.0,4.1359e-25,81,81,0,0,0,gene,Y102A5C.2,0,16918539,0.138786,3388,16915150,1,16918609,71,70
V,+,16928127,0.0138889,0.0,216,213,3,3,0,gene,Y102A5C.5,0,16928174,None,4070,16924057,47,16928127,0,-47
V,+,16951727,0.0,0.5,1,1,0,0,0,gene,Y102A5C.17,0,16951775,0.00878584,8231,16943496,48,16951926,199,151
V,+,16956081,0.0,0.125,3,3,0,0,0,gene,Y102A5C.16,0,16956089,0.0159837,2934,16953147,8,16956328,247,239
V,+,17023274,0.0,4.54747e-13,41,41,0,0,0,gene,F49H6.5,0,17023370,0.140848,3249,17020025,96,17023272,-2,-98
V,+,17023307,0.0,0.125,3,3,0,0,60,gene,F49H6.5,0,17023370,0.140848,3282,17020025,63,17023272,-35,-98
V,+,17090686,0.0,2.11758e-22,72,72,0,0,0,gene,T05E12.7,0,17090863,None,16900,17073786,177,17090190,-496,-673
V,+,17159673,0.0,0.0078125,7,7,0,0,0,gene,F40D4.12,0,17159679,0.00734,43738,17115935,6,17159673,0,-6
V,+,17209052,0.0,2.32831e-10,32,32,0,0,1,gene,Y68A4A.12,0,17209057,None,3914,17205138,5,17208863,-189,-194
V,+,17258973,0.0,0.015625,6,6,0,0,0,gene,Y61B8A.4,0,17258978,0.0301955,1981,17256992,5,17258979,6,1
V,+,17273322,0.0,0.015625,6,6,0,0,0,gene,K10G4.10,0,17273346,0.00350621,657,17272665,24,17273322,0,-24
V,+,17331370,0.0,0.00195312,9,9,0,0,0,gene,F47H4.4,0,17331437,0.00314142,962,17330408,67,17331368,-2,-69
V,+,17335916,0.0,0.125,3,3,0,0,0,gene,F47H4.6,0,17335935,0.00976374,572,17335344,19,17335936,20,1
V,+,17338865,0.0,0.03125,5,5,0,0,3,gene,F47H4.7,0,17338881,0.0218675,713,17338152,16,17338879,14,-2
V,+,17345017,0.0,2.06795e-25,82,82,0,0,2,gene,F47H4.9,0,17345025,0.0750987,2461,17342556,8,17345026,9,1
V,+,17353123,0.0,2.8026e-45,148,148,0,0,0,gene,F47H4.2,0,17353170,0.131832,4616,17348507,47,17353123,0,-47
V,+,17361336,0.5,0.5,2,1,1,1,0,gene,F47H4.12,0,17361338,None,1331,17360005,2,17361339,3,1
V,+,17514629,0.5,0.5,2,1,1,1,0,gene,K03D7.1,0,17514856,None,4618,17510011,227,17514603,-26,-253
V,+,17520834,0.0,0.000976562,10,10,0,0,0,gene,C18D4.2,0,17520840,0.0201374,1829,17519005,6,17520959,125,119
V,+,17532607,0.0,0.5,1,1,0,0,1,gene,C18D4.10,0,17532645,None,2900,17529707,38,17532618,11,-27
V,+,17559002,0.0,0.015625,6,6,0,0,0,gene,C38D9.6,0,17559067,0.00529916,8009,17550993,65,17559301,299,234
V,+,17623293,0.0,0.015625,6,6,0,0,0,gene,F57G4.1,0,17623326,0.0567192,1035,17622258,33,17623327,34,1
V,+,17660100,0.00269542,0.0,742,740,2,0,3,gene,F59A1.10,0,17660100,0.519226,16543,17643557,0,17660101,1,1
V,+,17668675,0.0,0.5,1,1,0,0,1,gene,F59A1.4,0,17668678,0.00108863,7070,17661605,3,17668679,4,1
V,+,17718736,0.0,0.0078125,7,7,0,0,1,gene,W06D12.4,0,17718743,0.00288705,9116,17709620,7,17718744,8,1
V,+,17724801,0.000876424,0.0,1141,1140,1,1,1,gene,W06D12.3,0,17724801,1.58157,3711,17721090,0,17724802,1,1
V,+,17755691,0.0,3.8147e-06,18,18,0,0,0,gene,C47A10.1,0,17755693,0.18497,29076,17726615,2,17755694,3,1
V,+,17831436,0.0,0.5,1,1,0,0,0,gene,Y94A7B.7,0,17831446,0.00141679,1656,17829780,10,17831447,11,1
V,+,17871200,0.00483092,0.0,207,206,1,1,0,gene,Y59A8A.2,0,17871210,0.395198,33559,17837641,10,17871202,2,-8
V,+,17899600,0.0,2.64698e-23,75,75,0,0,0,gene,C06H5.2,0,17899624,0.0953675,756,17898844,24,17899625,25,1
V,+,17910116,0.0,0.0,1554,1554,0,0,12,gene,C06H5.7,0,17910120,1.42765,8406,17901710,4,17910116,0,-4
V,+,17918825,0.0,7.10543e-15,47,47,0,0,1,gene,C06H5.8,0,17918833,0.0965969,1789,17917036,8,17918834,9,1
V,+,17921575,0.0283505,0.0,388,377,11,10,1,gene,E01B7.2,0,17921580,0.525506,28,17921547,5,17921581,6,1
V,+,17986056,0.0,0.0,205,205,0,0,0,gene,Y59A8B.21,0,17986073,0.22644,52037,17934019,17,17986054,-2,-19
V,+,18022274,0.00229709,0.0,1306,1303,3,1,0,gene,Y59A8B.6,1,18022281,1.12649,14589,18007685,7,18022274,0,-7
V,+,18043366,0.835694,9.59605e-40,353,58,295,163,1,gene,Y59A8B.7,2,18043386,1.38051,1222,18042144,20,18043366,0,-20
V,+,18086918,0.00321543,0.0,311,310,1,1,2,gene,Y59A8B.13,0,18086927,0.390112,25999,18060919,9,18086928,10,1
V,+,18098459,1.0,0.03125,5,0,5,4,0,gene,Y59A8B.14,0,18098481,0.365349,542,18097917,22,18098471,12,-10
V,+,18098471,0.91623,2.504e-35,191,16,175,142,30,gene,Y59A8B.14,0,18098481,0.365349,554,18097917,10,18098471,0,-10
V,+,18108064,0.726667,8.28782e-09,150,41,109,69,0,gene,Y37H2A.1,0,18108070,0.591467,1293,18106771,6,18108065,1,-5
V,+,18115199,0.0,0.0625,4,4,0,0,1,gene,Y37H2A.16,1,18115233,None,649,18114550,34,18115197,-2,-36
V,+,18123201,0.0,0.03125,5,5,0,0,0,gene,Y37H2A.15,2,18123258,None,1973,18121228,57,18123109,-92,-149
V,+,18123734,0.27907,0.00174381,43,31,12,9,0,gene,Y37H2A.4,3,18123771,0.1864,533,18123201,37,18123772,38,1
V,+,18125134,0.909091,6.35162e-07,33,3,30,26,2,gene,Y37H2A.5,4,18125155,0.509787,97,18125037,21,18125514,380,359
V,+,18125504,0.0,0.0,151,151,0,0,2,gene,Y37H2A.5,4,18125513,0.509787,467,18125037,9,18125514,10,1
V,+,18127314,0.642857,0.122192,14,5,9,8,2,gene,Y37H2A.6,5,18127333,0.0895215,314,18127000,19,18127128,-186,-205
V,+,18134512,0.0,0.0625,4,4,0,0,3,gene,Y37H2A.8,0,18134516,0.0259801,5832,18128680,4,18134517,5,1
V,+,18143570,0.0,0.00390625,8,8,0,0,1656,gene,Y37H2A.14,0,18143575,None,234,18143336,5,18143530,-40,-45
V,+,18278206,0.0,0.25,2,2,0,0,0,gene,Y37H2C.5,0,18278341,None,21344,18256862,135,18278209,3,-132
V,+,18310686,0.0,0.000976562,10,10,0,0,0,gene,Y51A2A.9,0,18310718,None,780,18309906,32,18310719,33,1
V,+,18349938,0.00694444,6.45718e-42,144,143,1,1,1,gene,C08E8.3,0,18349942,0.70871,21352,18328586,4,18349943,5,1
V,+,18371886,0.00826446,4.55151e-35,121,120,1,1,0,gene,C08E8.4,0,18371896,0.491412,12575,18359311,10,18371641,-245,-255
V,+,18371893,0.0,2.32831e-10,32,32,0,0,158,gene,C08E8.4,0,18371896,0.491412,12582,18359311,3,18371641,-252,-255
V,+,18438175,0.0,0.0625,4,4,0,0,0,gene,ZK262.8,0,18438175,0.000535526,4208,18433967,0,18438176,1,1
V,+,18462588,0.0163934,1.38821e-33,122,120,2,2,1,gene,ZK228.4,0,18462609,0.393437,5369,18457219,21,18462610,22,1
V,+,18492062,0.0,4.65661e-10,31,31,0,0,0,gene,Y51A2D.19,0,18492100,0.289889,14206,18477856,38,18492101,39,1
V,+,18533749,0.0,5.42101e-20,64,64,0,0,7,gene,Y51A2D.7,0,18533758,0.300042,4802,18528947,9,18533749,0,-9
V,+,18571630,0.0103093,6.12156e-28,97,96,1,1,1,gene,Y51A2D.21,0,18571632,0.430823,13736,18557894,2,18571633,3,1
V,+,18582455,0.00123153,0.0,30856,30818,38,26,5,gene,Y51A2D.14,0,18582463,38.9306,9640,18572815,8,18582423,-32,-40
V,+,18592554,0.0,2.8026e-45,148,148,0,0,0,gene,Y51A2D.15,0,18592555,0.521803,9794,18582760,1,18592594,40,39
V,+,18616388,0.0555556,6.86646e-05,18,17,1,1,0,gene,Y51A2D.17,0,18616403,0.476666,2482,18613906,15,18616395,7,-8
V,+,18616396,0.015625,3.46945e-18,64,63,1,1,26,gene,Y51A2D.17,0,18616403,0.476666,2490,18613906,7,18616395,-1,-8
V,+,18638279,0.00629723,0.0,1588,1578,10,7,11,gene,Y69H2.14,0,18638411,5.92548,18244,18620035,132,18638278,-1,-133
V,+,18689834,0.00840336,1.79051e-34,119,118,1,1,3,gene,Y69H2.7,0,18689858,0.484346,3743,18686091,24,18689833,-1,-25
V,+,18705386,0.0,0.125,3,3,0,0,12,gene,Y69H2.16,0,18705391,None,186,18705200,5,18705826,440,435
V,+,18713978,0.0,9.53674e-07,20,20,0,0,0,gene,Y17D7C.4,0,18714057,None,2330,18711648,79,18713523,-455,-534
V,+,18810798,0.0,0.25,2,2,0,0,0,gene,C54E10.3,0,18810798,0.00452253,16223,18794575,0,18810799,1,1
V,+,18839104,0.0,5.82077e-11,34,34,0,0,0,gene,Y17D7A.3,0,18839111,0.133037,7891,18831213,7,18839104,0,-7
V,+,18846588,0.333333,0.00655967,51,34,17,8,4,gene,Y17D7A.1,0,18846610,0.0577009,1368,18845220,22,18846611,23,1
V,+,18846647,0.5,0.5,2,1,1,1,10,gene,Y17D7A.1,0,18846928,0.0577009,1427,18845220,281,18846611,-36,-317
V,+,18903566,0.00215054,0.0,465,464,1,1,0,gene,Y80D3A.10,0,18903570,1.54134,27807,18875759,4,18903566,0,-4
V,+,18911832,0.00617284,0.0,162,161,1,1,1,gene,Y80D3A.5,0,18911835,0.411539,5787,18906045,3,18911833,1,-2
V,+,18981100,0.004914,0.0,407,405,2,2,2,gene,Y39B6A.39,0,18981112,0.94375,34401,18946699,12,18981113,13,1
V,+,18981107,0.0138889,1.52466e-20,72,71,1,0,52,gene,Y39B6A.39,0,18981112,0.94375,34408,18946699,5,18981113,6,1
V,+,18990646,0.154822,0.0,394,333,61,50,1,gene,Y39B6A.37,1,18990651,0.458457,4916,18985730,5,18990652,6,1
V,+,18993734,0.401074,1.56642e-13,1304,781,523,389,2,gene,Y39B6A.36,2,18993737,1.32598,435,18993299,3,18993734,0,-3
V,+,18998139,0.86087,0.0,460,64,396,293,1,gene,Y39B6A.35,3,18998139,0.707996,150,18997989,0,18998140,1,1
V,+,19000801,0.571429,0.273438,7,3,4,3,14,gene,Y39B6A.34,4,19000813,0.92092,89,19000712,12,19000812,11,-1
V,+,19000814,0.939791,0.0,382,23,359,247,12,gene,Y39B6A.34,4,19000841,0.92092,102,19000712,27,19000812,-2,-29
V,+,19001750,0.961625,0.0,886,34,852,452,5,gene,Y39B6A.33,5,19001828,1.49273,100,19001650,78,19001750,0,-78
V,+,19059976,0.0,0.00390625,8,8,0,0,0,gene,Y39B6A.19,0,19059983,0.146987,8836,19051140,7,19059974,-2,-9
V,+,19087517,0.00925926,3.32801e-31,108,107,1,1,2,gene,Y39B6A.47,0,19087517,0.0570203,20722,19066795,0,19087517,0,0
V,+,19094720,0.0,4.65661e-10,31,31,0,0,1,gene,Y39B6A.49,0,19094773,None,2265,19092455,53,19094733,13,-40
V,+,19127321,0.0,9.86076e-32,103,103,0,0,0,gene,Y39B6A.11,0,19127323,0.114687,30629,19096692,2,19127324,3,1
V,+,19136301,0.0,1.13687e-13,43,43,0,0,0,gene,Y39B6A.9,0,19136302,0.24057,5525,19130776,1,19136303,2,1
V,+,19153909,0.0,1.52588e-05,16,16,0,0,7,gene,Y39B6A.6,0,19153915,0.103078,8535,19145374,6,19153916,7,1
V,+,19174555,0.0,2.27374e-13,42,42,0,0,0,gene,Y39B6A.4,0,19174561,0.0541628,17057,19157498,6,19174600,45,39
V,+,19184949,0.0,0.000488281,11,11,0,0,1,gene,Y39B6A.48,0,19184963,0.203181,9864,19175085,14,19184949,0,-14
V,+,19184964,0.0144928,1.16891e-19,69,68,1,1,23,gene,Y39B6A.48,0,19184971,0.203181,9879,19175085,7,19184949,-15,-22
V,+,19190341,0.0,0.0,278,278,0,0,1,gene,Y39B6A.2,0,19190348,0.903474,2627,19187714,7,19190341,0,-7
V,+,19223669,0.0,0.5,1,1,0,0,50,gene,T26H2.10,0,19223697,0.0215128,1015,19222654,28,19223647,-22,-50
V,+,19233788,0.0,0.25,2,2,0,0,4,gene,T26H2.4,0,19233816,0.0360204,1974,19231814,28,19233687,-101,-129
V,+,19320413,0.0285714,1.01863e-09,35,34,1,0,0,gene,C43D7.5,0,19320417,0.244732,2119,19318294,4,19320418,5,1
V,+,19377240,0.0,0.0,257,257,0,0,2,gene,Y43F8A.3,0,19377243,0.256841,1199,19376041,3,19377240,0,-3
V,+,19468810,0.0,0.03125,5,5,0,0,0,gene,Y43F8B.12,0,19468860,0.0483509,5180,19463630,50,19468861,51,1
V,+,19470487,0.0084507,0.0,355,352,3,1,6,gene,Y43F8B.11,0,19470487,0.143767,930,19469557,0,19470488,1,1
V,+,19474260,0.0,0.015625,6,6,0,0,0,gene,Y43F8B.10,0,19474410,0.00831147,1944,19472316,150,19474258,-2,-152
V,+,19479592,0.0,0.25,2,2,0,0,5,gene,Y43F8B.9,0,19479596,0.212031,2856,19476736,4,19479592,0,-4
V,+,19491409,0.0,0.5,1,1,0,0,16,gene,Y43F8B.6,0,19491573,0.0122016,283,19491126,164,19491937,528,364
V,+,19502901,0.0,1.77636e-15,49,49,0,0,1,gene,Y43F8B.3,0,19502904,0.453954,11314,19491587,3,19502905,4,1
V,+,19565181,0.0,1.42109e-14,46,46,0,0,0,gene,B0399.1,0,19565183,0.372197,45371,19519810,2,19565184,3,1
V,+,19582089,0.0,0.5,1,1,0,0,0,gene,B0399.1,0,19582106,0.372197,12747,19569342,17,19582316,227,210
V,+,19590697,0.0,4.54747e-13,41,41,0,0,1,gene,B0399.1,0,19590774,0.372197,21355,19569342,77,19590697,0,-77
V,+,19595058,0.0,0.25,2,2,0,0,3,gene,B0399.1,0,19595129,0.372197,25716,19569342,71,19594997,-61,-132
V,+,19607290,0.0,0.0,388,388,0,0,34,gene,Y43F8C.1,0,19607303,0.664691,1377,19605913,13,19607304,14,1
V,+,19609955,0.0,0.0,1087,1087,0,0,3,gene,Y43F8C.20,0,19609955,1.42886,1746,19608209,0,19609956,1,1
V,+,19613321,0.00087184,0.0,1147,1146,1,0,11,gene,Y43F8C.2,0,19613324,1.4951,1346,19611975,3,19613321,0,-3
V,+,19624844,0.0,1.52588e-05,16,16,0,0,0,gene,Y43F8C.4,0,19624854,0.0772753,10518,19614326,10,19624855,11,1
V,+,19644032,0.00457666,0.0,437,435,2,2,9,gene,Y43F8C.8,0,19644252,0.934181,13516,19630516,220,19644032,0,-220
V,+,19645745,0.0,0.5,1,1,0,0,1,gene,Y43F8C.9,0,19645909,0.446582,249,19645496,164,19645885,140,-24
V,+,19670052,0.115385,3.8743e-05,26,23,3,2,29,gene,Y43F8C.11,0,19670052,0.594222,22921,19647131,0,19670053,1,1
V,+,19674638,0.0025974,0.0,385,384,1,1,1,gene,Y43F8C.12,0,19674686,0.429788,3438,19671200,48,19674667,29,-19
V,+,19722697,0.00961538,0.0,208,206,2,2,0,gene,Y116F11A.6,0,19722699,0.608948,9896,19712801,2,19722700,3,1
V,+,19736952,0.0,0.5,1,1,0,0,0,gene,W04E12.3,0,19737035,0.00482989,2340,19734612,83,19737170,218,135
V,+,19751893,0.0,0.0625,4,4,0,0,0,gene,W04E12.9,0,19751939,0.0983099,8135,19743758,46,19751505,-388,-434
V,+,19756270,0.0,2.38419e-07,22,22,0,0,0,gene,M162.5,0,19756277,0.0639504,2473,19753797,7,19756270,0,-7
V,+,19763481,0.0,3.05176e-05,15,15,0,0,0,gene,M162.12,0,19763586,None,1494,19761987,105,19763730,249,144
V,+,19779325,0.0,0.5,1,1,0,0,0,gene,M162.3,0,19779347,0.00657695,2706,19776619,22,19779348,23,1
V,+,19810351,0.0,0.0078125,7,7,0,0,0,gene,Y116F11B.1,0,19810369,0.570025,23884,19786467,18,19810663,312,294
V,+,19810625,0.00985222,0.0,203,201,2,2,0,gene,Y116F11B.1,0,19810662,0.570025,24158,19786467,37,19810663,38,1
V,+,19865241,0.0,5.82077e-11,34,34,0,0,0,gene,Y116F11B.10,0,19865355,None,9048,19856193,114,19865724,483,369
V,+,19911775,0.0,3.72529e-09,28,28,0,0,0,gene,Y60A3A.19,0,19911786,0.85942,16266,19895509,11,19911775,0,-11
V,+,19919442,0.00201207,0.0,497,496,1,1,0,gene,Y60A3A.18,0,19919470,0.539365,4228,19915214,28,19919442,0,-28
V,+,19945202,0.0181818,1.54143e-44,165,162,3,3,0,gene,Y60A3A.8,1,19945229,0.247725,5772,19939430,27,19945214,12,-15
V,+,19950706,0.278125,3.3485e-16,320,231,89,66,58,gene,Y60A3A.7,2,19950714,1.06455,366,19950340,8,19950678,-28,-36
V,+,20007179,0.00275862,0.0,1450,1446,4,4,3,gene,Y60A3A.21,0,20007185,2.10334,2668,20004511,6,20007177,-2,-8
V,+,20010102,0.166667,0.00311279,18,15,3,2,6,gene,Y60A3A.26,0,20010126,None,1396,20008706,24,20010102,0,-24
V,+,20018264,0.0,1.0842e-19,63,63,0,0,0,gene,Y113G7A.5,0,20018281,0.11512,7864,20010400,17,20018264,0,-17
V,+,20033029,0.0,0.000244141,12,12,0,0,36,gene,Y113G7A.16,0,20033081,0.372633,1146,20031883,52,20032805,-224,-276
V,+,20086481,0.00297796,0.0,1679,1674,5,3,10,gene,Y113G7A.3,0,20086485,2.14966,38698,20047783,4,20086481,0,-4
V,+,20143415,0.0,7.27596e-12,37,37,0,0,0,gene,Y113G7A.13,0,20143417,0.0497812,1102,20142313,2,20143418,3,1
V,+,20153734,0.0,0.5,1,1,0,0,0,gene,F19B2.6,0,20153743,0.0609376,3074,20150660,9,20153744,10,1
V,+,20153741,0.0,2.22045e-16,52,52,0,0,2,gene,F19B2.6,0,20153743,0.0609376,3081,20150660,2,20153744,3,1
V,+,20162771,0.0,0.0625,4,4,0,0,1,gene,F19B2.4,0,20162806,None,5700,20157071,35,20162527,-244,-279
V,+,20192189,0.0,0.0,254,254,0,0,0,gene,Y113G7B.4,1,20192221,0.187168,574,20191615,32,20192187,-2,-34
V,+,20194480,0.238494,7.15358e-17,239,182,57,42,0,gene,Y113G7B.5,2,20194511,0.260634,1024,20193456,31,20194480,0,-31
V,+,20196834,0.315457,1.20312e-11,317,217,100,85,0,gene,Y113G7B.7,3,20196867,0.207254,975,20195859,33,20196868,34,1
V,+,20222035,0.0,1.13687e-13,43,43,0,0,0,gene,Y113G7B.14,0,20222052,0.154298,19152,20202883,17,20222053,18,1
V,+,20265325,0.0097561,0.0,205,203,2,1,1,gene,Y113G7B.16,0,20265334,0.739227,41159,20224166,9,20265325,0,-9
V,+,20293168,0.0,0.25,2,2,0,0,1,gene,ZC15.5,0,20293171,0.0166841,22197,20270971,3,20293168,0,-3
V,+,20297329,0.0,0.5,1,1,0,0,1,gene,ZC15.4,0,20297352,None,2587,20294742,23,20297353,24,1
V,+,20305856,0.0,0.5,1,1,0,0,0,gene,ZC15.10,0,20305953,0.0733271,1719,20304137,97,20305954,98,1
V,+,20320933,0.0,0.25,2,2,0,0,0,gene,Y38H6A.1,0,20320945,0.00141732,1680,20319253,12,20320946,13,1
V,+,20346715,0.0,0.00390625,8,8,0,0,0,gene,K02E2.1,0,20346717,0.0151355,3370,20343345,2,20346718,3,1
V,+,20370756,0.0,0.0,901,901,0,0,0,gene,K02E2.4,0,20370757,0.97175,9528,20361228,1,20370758,2,1
V,+,20378564,0.0,0.015625,6,6,0,0,9,gene,K02E2.11,0,20378593,None,1312,20377252,29,20378580,16,-13
V,+,20382856,0.0,0.125,3,3,0,0,1,gene,F53H2.1,0,20382932,0.0388831,3234,20379622,76,20382933,77,1
V,+,20420519,0.0,0.0,154,154,0,0,0,gene,F48F5.5,0,20420559,0.575622,30568,20389951,40,20420519,0,-40
V,+,20474907,0.00996016,0.0,502,497,5,3,0,gene,B0250.1,0,20474912,14.8684,11453,20463454,5,20474907,0,-5
V,+,20489142,0.00347826,0.0,575,573,2,2,0,gene,B0250.5,0,20489148,1.63202,13077,20476065,6,20489142,0,-6
V,+,20517822,0.0,1.38778e-17,56,56,0,0,0,gene,Y38H6C.11,0,20517838,0.207611,2542,20515280,16,20517839,17,1
V,+,20562760,0.0,0.0078125,7,7,0,0,0,gene,F26F2.9,0,20562792,None,2770,20559990,32,20562793,33,1
V,+,20568912,0.0,4.70198e-38,124,124,0,0,1,gene,F26F2.5,0,20568934,0.219009,3503,20565409,22,20568935,23,1
V,+,20574785,0.0,0.0,292,292,0,0,6,gene,F26F2.8,0,20574792,0.254756,1939,20572846,7,20574793,8,1
V,+,20576214,0.0,3.00927e-36,118,118,0,0,2,gene,F26F2.7,0,20576258,0.365078,318,20575896,44,20576214,0,-44
V,+,20576254,0.0,0.5,1,1,0,0,51,gene,F26F2.7,0,20576258,0.365078,358,20575896,4,20576214,-40,-44
V,+,20600424,0.0,0.5,1,1,0,0,1,gene,F46B3.18,0,20600435,None,836,20599588,11,20600323,-101,-112
V,+,20649870,0.0,1.12104e-44,146,146,0,0,0,gene,W01F3.1,0,20649901,0.781706,10296,20639574,31,20649870,0,-31
V,+,20662429,0.00729927,0.0,274,272,2,2,0,gene,W01F3.3,0,20662451,2.20752,5180,20657249,22,20662429,0,-22
V,+,20703976,0.0,3.05176e-05,15,15,0,0,5,gene,F53F8.6,0,20703988,0.144122,19930,20684046,12,20703946,-30,-42
V,+,20709140,0.0,0.0,732,732,0,0,0,gene,Y44A6C.1,0,20709163,0.772378,4078,20705062,23,20709164,24,1
V,+,20750559,0.0,0.0,168,168,0,0,1,gene,F38A6.1,0,20750708,1.25151,19192,20731367,149,20750558,-1,-150
V,+,20752128,0.00318471,0.0,314,313,1,0,0,gene,F38A6.1,0,20752130,1.25151,20761,20731367,2,20752128,0,-2
V,+,20775631,0.0041958,0.0,1430,1424,6,2,1,gene,F38A6.3,0,20775719,4.97975,20100,20755531,88,20775631,0,-88
V,+,20784478,1.0,0.5,1,0,1,1,5,gene,Y44A6D.2,0,20784495,2.60023,4003,20780475,17,20784689,211,194
V,+,20802516,0.0,0.03125,5,5,0,0,0,gene,Y44A6D.6,0,20802555,0.0130829,6092,20796424,39,20802556,40,1
V,+,20810001,0.0,0.0625,4,4,0,0,3,gene,Y44A6D.7,0,20810080,None,2480,20807521,79,20809977,-24,-103
V,+,20827597,0.0,4.1359e-25,81,81,0,0,0,gene,T03D8.1,1,20827728,1.24377,4639,20822958,131,20827597,0,-131
V,+,20833096,1.0,0.125,3,0,3,1,1,gene,T03D8.2,2,20833198,1.68039,327,20832769,102,20833298,202,100
V,+,20833157,1.0,0.5,1,0,1,1,4,gene,T03D8.2,2,20833198,1.68039,388,20832769,41,20833298,141,100
V,+,20833298,0.796247,0.0,1119,228,891,594,13,gene,T03D8.2,2,20833462,1.68039,529,20832769,164,20833298,0,-164
V,+,20833339,0.5,0.5,2,1,1,0,227,gene,T03D8.2,2,20833462,1.68039,570,20832769,123,20833298,-41,-164
V,+,20834083,0.935361,0.0,263,17,246,176,4,gene,F31D4.1,3,20834086,1.10184,76,20834007,3,20834083,0,-3
V,+,20841376,0.00841852,0.0,1663,1649,14,13,0,gene,F31D4.3,0,20841397,3.54974,4536,20836840,21,20841376,0,-21
V,+,20849355,0.0,1.54074e-33,109,109,0,0,8,gene,F31D4.5,0,20849360,0.353739,6411,20842944,5,20849361,6,1
V,+,20858189,0.0,0.000244141,12,12,0,0,3,gene,F31D4.7,0,20858198,0.0244866,4255,20853934,9,20858199,10,1
V,+,20875093,0.0,4.65661e-10,31,31,0,0,12,gene,F25C8.3,0,20875125,0.217177,14132,20860961,32,20875093,0,-32
V,+,20899385,0.0,0.0,168,168,0,0,0,gene,F25C8.4,0,20899392,0.368604,5260,20894125,7,20899195,-190,-197
V,+,20905420,0.0,0.03125,5,5,0,0,0,gene,F25C8.5,0,20905496,0.00730858,2769,20902651,76,20905685,265,189
V,+,20910704,0.0,1.61559e-27,89,89,0,0,1,gene,Y44A6E.1,0,20910707,0.168382,1099,20909605,3,20910704,0,-3
X,+,47993,0.0,0.000976562,10,10,0,0,24,gene,Y73B3A.20,0,47997,0.0544671,6120,41873,4,47799,-194,-198
X,+,117386,0.0,0.5,1,1,0,0,0,gene,Y73B3A.22,0,117387,None,572,116814,1,117388,2,1
X,+,164061,0.0,0.125,3,3,0,0,0,gene,T08D2.2,0,164088,0.00605932,15134,148927,27,164089,28,1
X,+,177377,0.333333,0.375,3,2,1,1,0,gene,T08D2.4,1,177395,0.0128957,143,177234,18,177396,19,1
X,+,194038,0.0,0.25,2,2,0,0,0,gene,T08D2.8,0,194262,0.0316868,3479,190559,224,194448,410,186
X,+,199022,0.0,0.25,2,2,0,0,0,gene,Y73B3B.5,0,199027,None,8463,190559,5,199262,240,235
X,+,211908,1.0,0.5,1,0,1,0,0,gene,Y73B3B.3,0,211931,0.0177425,232,211676,23,211441,-467,-490
X,+,230389,0.0,4.23516e-22,71,71,0,0,0,gene,AC8.7,0,230403,0,18262,212127,14,230433,44,30
X,+,297234,0.0,9.40395e-38,123,123,0,0,2,gene,R57.2,0,297247,0.482618,19337,277897,13,297248,14,1
X,+,301832,0.025641,7.09406e-11,39,38,1,1,1,gene,R57.1,0,301844,1.1315,2545,299287,12,301832,0,-12
X,+,302741,0.0,5.73972e-42,137,137,0,0,0,gene,R57.1,0,302766,1.1315,3454,299287,25,302741,0,-25
X,+,322806,0.0,0.00390625,8,8,0,0,0,gene,M02E1.3,0,322850,0.286294,8149,314657,44,322523,-283,-327
X,+,353619,0.0,0.0,159,159,0,0,0,gene,C04E7.2,0,353619,0.320051,19019,334600,0,353620,1,1
X,+,372236,0.00115607,0.0,865,864,1,1,1,gene,R04A9.2,0,372254,0.974081,9271,362965,18,372236,0,-18
X,+,460652,0.0,6.46235e-27,87,87,0,0,1,gene,F52D1.1,0,460654,1.6669,37702,422950,2,460652,0,-2
X,+,476583,0.0,1.38778e-17,56,56,0,0,0,gene,F38G1.3,0,476700,0.226448,9665,466918,117,476562,-21,-138
X,+,481451,0.0,0.000488281,11,11,0,0,9,gene,F38G1.1,0,481451,0.0583199,1584,479867,0,481451,0,0
X,+,489688,0.0,4.76837e-07,21,21,0,0,0,gene,F38G1.2,0,489746,0.0554117,3185,486503,58,489696,8,-50
X,+,593960,0.00485437,0.0,412,410,2,1,0,gene,F13C5.2,0,593979,2.15043,30251,563709,19,593960,0,-19
X,+,629223,0.0,0.000976562,10,10,0,0,0,gene,M6.4,0,629235,0.0625816,24301,604922,12,629188,-35,-47
X,+,673028,0.0,4.44089e-16,51,51,0,0,0,gene,T19D7.1,0,673041,0.247892,14518,658510,13,672651,-377,-390
X,+,763758,0.0,1.77636e-15,49,49,0,0,0,gene,C02H7.1,0,763767,0.0617527,56083,707675,9,763768,10,1
X,+,768595,0.00436047,0.0,688,685,3,3,1,gene,T04G9.3,0,768598,1.84657,1864,766731,3,768595,0,-3
X,+,772286,1.0,0.5,1,0,1,1,3,gene,T04G9.4,0,772504,0.680429,322,771964,218,772404,118,-100
X,+,777720,0.0,0.0,194,194,0,0,1,gene,T04G9.2,0,777732,0.321877,2350,775370,12,777720,0,-12
X,+,788352,0.0,9.31323e-10,30,30,0,0,0,gene,T04G9.1,0,788409,0.112525,7831,780521,57,788352,0,-57
X,+,802783,0.0,0.0625,4,4,0,0,0,gene,F25E2.1,0,802794,0.0408761,6629,796154,11,802795,12,1
X,+,834777,0.0,2.98023e-08,25,25,0,0,2,gene,F39H12.1,0,834787,0.193194,977,833800,10,834777,0,-10
X,+,834783,0.0,3.8147e-06,18,18,0,0,9,gene,F39H12.1,0,834787,0.193194,983,833800,4,834777,-6,-10
X,+,872601,0.002457,0.0,407,406,1,1,104,gene,F56F10.1,0,872602,1.56835,10143,862458,1,872601,0,-1
X,+,877271,0.0,9.09495e-13,40,40,0,0,159,gene,ZC13.1,0,877277,0.294582,1323,875948,6,877271,0,-6
X,+,913290,0.0,9.31323e-10,30,30,0,0,1,gene,F35H12.6,0,913302,0.176661,30206,883084,12,913288,-2,-14
X,+,915872,0.0365854,1.83138e-20,82,79,3,2,10,gene,F35H12.3,1,915911,0.510799,1013,914859,39,915872,0,-39
X,+,918395,0.8,9.12362e-06,50,10,40,22,5,gene,F35H12.5,2,918550,0.184609,107,918288,155,918395,0,-155
X,+,924962,0.0,2.52435e-29,95,95,0,0,1,gene,F35H12.2,0,925008,0.353865,4765,920197,46,925009,47,1
X,+,928945,0.0,2.77556e-17,55,55,0,0,0,gene,F35H12.2,0,929055,0.353865,8748,920197,110,928945,0,-110
X,+,933773,0.0,0.125,3,3,0,0,0,gene,F35H12.7,0,933800,0.0565652,1522,932251,27,933801,28,1
X,+,933801,0.0222222,1.27898e-12,45,44,1,0,4,gene,F35H12.7,0,933875,0.0565652,1550,932251,74,933801,0,-74
X,+,935536,0.0,0.5,1,1,0,0,0,gene,F35H12.1,0,935562,0.0841333,3285,932251,26,935457,-79,-105
X,+,950779,0.0130435,0.0,230,227,3,3,2,gene,F53H8.2,0,950804,0.64178,8170,942609,25,950779,0,-25
X,+,954514,0.0,0.25,2,2,0,0,46,gene,F53H8.1,1,954671,0.677192,284,954230,157,954932,418,261
X,+,957885,0.986486,3.04866e-41,148,2,146,80,43,gene,C44C1.2,2,957923,0.650264,126,957759,38,957883,-2,-40
X,+,980773,0.0,0.0,360,360,0,0,1,gene,C44C1.1,0,980791,1.39529,20187,960586,18,980773,0,-18
X,+,1004334,0.0,1.13687e-13,43,43,0,0,0,gene,F55A4.10,0,1004342,0.0895568,21272,983062,8,1004334,0,-8
X,+,1035545,0.00377358,0.0,265,264,1,0,0,gene,F55A4.1,0,1035548,1.31841,23213,1012332,3,1035545,0,-3
X,+,1097149,0.025,2.11281e-31,120,117,3,3,1,gene,F49E7.1,0,1097152,0.298558,17701,1079448,3,1097149,0,-3
X,+,1104209,0.00617284,0.0,162,161,1,1,2,gene,C05D9.5,0,1104210,0.633127,892,1103317,1,1104209,0,-1
X,+,1111900,0.0,0.0,194,194,0,0,0,gene,C05D9.3,0,1111912,0.755348,1763,1110137,12,1111900,0,-12
X,+,1128983,0.001002,0.0,998,997,1,1,1,gene,C05D9.1,0,1129007,0.873411,700,1128283,24,1128983,0,-24
X,+,1163150,0.0,0.125,3,3,0,0,0,gene,T13G4.3,0,1163229,0.126629,7540,1155610,79,1163150,0,-79
X,+,1246012,0.0102041,0.0,392,388,4,3,3,gene,C25G6.2,0,1246020,0.767926,35174,1210838,8,1246012,0,-8
X,+,1285198,0.0,0.5,1,1,0,0,0,gene,C52B11.4,0,1285203,0,9792,1275406,5,1285204,6,1
X,+,1295255,0.0,1.90735e-06,19,19,0,0,0,gene,C52B11.3,0,1295272,0.0518349,9864,1285391,17,1295273,18,1
X,+,1300202,0.0,0.125,3,3,0,0,0,gene,C52B11.2,0,1300483,0.702545,1549,1298653,281,1300144,-58,-339
X,+,1304290,0.0,0.25,2,2,0,0,1,gene,C52B11.2,0,1304536,0.702545,5637,1298653,246,1304558,268,22
X,+,1304558,0.0135135,3.04866e-41,148,146,2,2,0,gene,C52B11.2,0,1304579,0.702545,5905,1298653,21,1304558,0,-21
X,+,1311600,0.0,0.0,806,806,0,0,10,gene,H42K12.3,0,1311615,2.27626,2102,1309498,15,1311600,0,-15
X,+,1311603,0.0,1.90735e-06,19,19,0,0,8,gene,H42K12.3,0,1311615,2.27626,2105,1309498,12,1311603,0,-12
X,+,1321348,0.0128617,0.0,311,307,4,3,1,gene,H42K12.1,0,1321357,0.547752,4717,1316631,9,1321348,0,-9
X,+,1372007,0.0,3.55271e-15,48,48,0,0,2,gene,F56C3.2,0,1372021,0.0606195,44029,1327978,14,1372007,0,-14
X,+,1417404,0.0,0.125,3,3,0,0,13,gene,F19G12.4,0,1417404,0.0481405,10593,1406811,0,1417299,-105,-105
X,+,1425643,0.0,0.25,2,2,0,0,7,gene,F19G12.3,0,1425668,0.114306,2120,1423523,25,1425722,79,54
X,+,1450765,0.0028169,0.0,355,354,1,1,2,gene,W05H7.1,0,1450778,0.397226,3173,1447592,13,1450763,-2,-15
X,+,1459094,0.0,0.000976562,10,10,0,0,180,gene,D1005.2,0,1459114,0.283374,6797,1452297,20,1459093,-1,-21
X,+,1479537,0.0106952,0.0,187,185,2,1,0,gene,D1005.1,0,1479566,1.07343,16766,1462771,29,1479537,0,-29
X,+,1547502,0.0277778,5.23869e-10,36,35,1,0,0,gene,K06A9.1,0,1547503,0.432126,7407,1540095,1,1547504,2,1
X,+,1568671,0.0,0.00012207,13,13,0,0,0,gene,H02F09.3,0,1568672,0.0982836,8534,1560137,1,1568673,2,1
X,+,1576632,0.0,0.0,194,194,0,0,0,gene,B0344.2,0,1576632,0.308647,2627,1574005,0,1576630,-2,-2
X,+,1604901,0.00900901,4.27556e-32,111,110,1,1,0,gene,H11E01.3,0,1604937,0.475226,13587,1591314,36,1604901,0,-36
X,+,1610246,0.0,0.25,2,2,0,0,0,gene,H11E01.3,0,1610267,0.475226,18932,1591314,21,1610246,0,-21
X,+,1621058,0.0,1.11022e-16,53,53,0,0,0,gene,H11E01.2,0,1621080,0.106912,1916,1619142,22,1621476,418,396
X,+,1621513,0.0,0.5,1,1,0,0,0,gene,H11E01.2,0,1621519,0.106912,2371,1619142,6,1621476,-37,-43
X,+,1655508,0.0,0.25,2,2,0,0,1,gene,ZK380.1,0,1655516,0.00245489,19957,1635551,8,1655517,9,1
X,+,1682949,0.0,2.46519e-32,105,105,0,0,0,gene,C36C9.1,0,1682950,0.212915,26018,1656931,1,1682947,-2,-3
X,+,1737976,0.0,0.125,3,3,0,0,278,gene,F07G6.10,0,1737992,None,1508,1736468,16,1737904,-72,-88
X,+,1742831,0.0,0.125,3,3,0,0,0,gene,Y75D11A.2,0,1742842,0,3626,1739205,11,1742843,12,1
X,+,1795223,0.0,0.5,1,1,0,0,1,gene,F31A9.2,0,1795393,0.0382469,6763,1788460,170,1795223,0,-170
X,+,1816400,0.0,0.00195312,9,9,0,0,1,gene,C14E2.7,0,1816487,0.0204195,11116,1805284,87,1816355,-45,-132
X,+,1917433,0.5,0.176197,20,10,10,8,0,gene,ZC53.6,0,1917462,0.0159002,361,1917072,29,1917463,30,1
X,+,1962567,0.00862069,1.3963e-33,116,115,1,1,0,gene,F52D2.7,0,1962582,0.221685,24884,1937683,15,1962567,0,-15
X,+,2019142,0.0,0.0,182,182,0,0,1,gene,Y102A11A.3,0,2019153,0.574403,1064,2018078,11,2019165,23,12
X,+,2026636,0.0,0.000976562,10,10,0,0,0,gene,Y102A11A.2,0,2026646,0.175905,845,2025791,10,2026636,0,-10
X,+,2065034,0.0,0.015625,6,6,0,0,0,gene,F49H12.7,0,2065036,0.0127736,10993,2054041,2,2065037,3,1
X,+,2074446,0.000896861,0.0,1115,1114,1,1,9,gene,F49H12.5,0,2074448,2.38203,7363,2067083,2,2074442,-4,-6
X,+,2080360,0.0,0.125,3,3,0,0,53,gene,F49H12.4,0,2080482,0.10268,4422,2075938,122,2080350,-10,-132
X,+,2084369,0.0,0.0,205,205,0,0,3,gene,F49H12.3,0,2084369,0.142477,2690,2081679,0,2084367,-2,-2
X,+,2089982,0.0,0.00012207,13,13,0,0,0,gene,F49H12.1,0,2090049,1.00039,3078,2086904,67,2089988,6,-61
X,+,2089999,0.00613497,0.0,163,162,1,0,16,gene,F49H12.1,0,2090049,1.00039,3095,2086904,50,2089999,0,-50
X,+,2105605,0.0178571,7.77156e-16,56,55,1,0,1,gene,F53B1.3,0,2105625,0.115177,10769,2094836,20,2105623,18,-2
X,+,2108976,0.0,0.0,287,287,0,0,0,gene,F53B1.2,0,2109013,0.389053,1443,2107533,37,2108976,0,-37
X,+,2163378,0.00260417,0.0,1536,1532,4,0,6,gene,F48B9.4,0,2163428,6.11188,51947,2111431,50,2163378,0,-50
X,+,2180881,0.0,1.90735e-06,19,19,0,0,0,gene,F48B9.1,0,2180885,0.0826843,7051,2173830,4,2180891,10,6
X,+,2192514,0.0,0.0078125,7,7,0,0,0,gene,T24C12.2,0,2192708,0.15075,18684,2173830,194,2192497,-17,-211
X,+,2215623,0.0,5.55112e-17,54,54,0,0,0,gene,T14F9.4,0,2215625,0.509656,14424,2201199,2,2215623,0,-2
X,+,2223471,0.0,7.62939e-06,17,17,0,0,3,gene,T14F9.3,0,2223478,1.43411,4495,2218976,7,2223476,5,-2
X,+,2223476,0.0,0.0,1183,1183,0,0,4,gene,T14F9.3,0,2223478,1.43411,4500,2218976,2,2223476,0,-2
X,+,2237904,0.00608447,0.0,2794,2777,17,10,2,gene,T14F9.1,0,2237905,7.04684,1352,2236552,1,2237904,0,-1
X,+,2294743,0.0,8.96831e-44,143,143,0,0,8,gene,T10H10.2,0,2294794,0.451196,50234,2244509,51,2294743,0,-51
X,+,2303077,0.0,0.0,186,186,0,0,1,gene,T10H10.1,0,2303091,0.470664,4891,2298186,14,2303075,-2,-16
X,+,2335677,0.0,0.0,169,169,0,0,0,gene,T01B6.1,0,2335734,0.477292,20770,2314907,57,2335677,0,-57
X,+,2360090,0.0,4.33681e-19,61,61,0,0,0,gene,T24D8.1,0,2360098,0.12134,11382,2348708,8,2360090,0,-8
X,+,2375986,0.0,7.27596e-12,37,37,0,0,0,gene,F47G3.3,0,2375990,0.168608,11174,2364812,4,2375991,5,1
X,+,2381578,0.0,1.52588e-05,16,16,0,0,1,gene,F47G3.4,0,2381583,None,2525,2379053,5,2381584,6,1
X,+,2381584,0.037037,7.94365e-14,54,52,2,2,33,gene,F47G3.4,0,2381593,None,2531,2379053,9,2381584,0,-9
X,+,2382685,0.0,0.00390625,8,8,0,0,0,gene,F47G3.2,0,2382689,0.0393101,356,2382329,4,2382685,0,-4
X,+,2395277,0.0,7.27596e-12,37,37,0,0,0,gene,C43H6.6,0,2395498,0.0377433,2570,2392707,221,2395499,222,1
X,+,2404018,0.025,2.61389e-21,80,78,2,2,0,gene,C43H6.4,1,2404025,0.299885,5157,2398861,7,2404018,0,-7
X,+,2407461,0.78714,2.00142e-36,451,96,355,161,2,gene,C43H6.3,2,2407497,0.759799,103,2407358,36,2407461,0,-36
X,+,2409686,0.784615,1.62079e-11,130,28,102,41,6,gene,C43H6.1,3,2409704,0.39283,119,2409567,18,2409705,19,1
X,+,2409699,0.333333,0.375,3,2,1,0,473,gene,C43H6.1,3,2409704,0.39283,132,2409567,5,2409705,6,1
X,+,2489039,0.00671141,0.0,298,296,2,1,1,gene,K02E10.2,0,2489082,0.702805,748,2488291,43,2489083,44,1
X,+,2496405,0.0277778,5.41254e-19,72,70,2,2,59,gene,K02E10.1,0,2496412,0.338745,2077,2494328,7,2496176,-229,-236
X,+,2554225,0.015625,0.0,192,189,3,3,0,gene,F52H2.2,0,2554231,1.22382,53231,2500994,6,2554225,0,-6
X,+,2577804,0.0,3.05176e-05,15,15,0,0,675,gene,H01M10.3,0,2577876,None,869,2576935,72,2577736,-68,-140
X,+,2593997,0.00854701,7.04168e-34,117,116,1,1,0,gene,T03G6.2,0,2594035,0.600025,15754,2578243,38,2593997,0,-38
X,+,2599401,0.0,1.2326e-32,106,106,0,0,2,gene,T03G6.2,0,2599421,0.600025,21158,2578243,20,2599401,0,-20
X,+,2608221,0.0,0.0,486,486,0,0,1,gene,T03G6.1,0,2608224,1.16262,1497,2606724,3,2608221,0,-3
X,+,2668191,0.00306748,0.0,326,325,1,1,12,gene,C09B7.2,0,2668193,0.749324,58206,2609985,2,2668191,0,-2
X,+,2688983,0.0,0.0,174,174,0,0,19,gene,T14G11.1,0,2688985,0.704526,6623,2682360,2,2688986,3,1
X,+,2772038,0.0,1.86265e-09,29,29,0,0,1,gene,F55F1.5,0,2772071,None,73775,2698263,33,2772036,-2,-35
X,+,2785570,0.0,1.90735e-06,19,19,0,0,0,gene,C14A11.3,0,2785593,0.725969,87307,2698263,23,2785594,24,1
X,+,2793979,0.0,1.19209e-07,23,23,0,0,42,gene,C14A11.3,0,2794004,0.725969,95716,2698263,25,2794005,26,1
X,+,2803105,0.0,2.38419e-07,22,22,0,0,0,gene,C14A11.2,0,2803133,0.13534,3865,2799240,28,2803105,0,-28
X,+,2885858,0.00374532,0.0,267,266,1,1,0,gene,B0410.2,0,2885864,0.445068,20182,2865676,6,2885863,5,-1
X,+,2909529,0.00341297,0.0,293,292,1,1,0,gene,F52B10.1,0,2909546,2.06975,18956,2890573,17,2909547,18,1
X,+,2933352,0.0,0.5,1,1,0,0,67,gene,Y71H10A.2,0,2933364,0.517212,6549,2926803,12,2933352,0,-12
X,+,2940863,0.00276498,0.0,1085,1082,3,3,0,gene,Y71H10A.1,0,2940880,1.30343,3131,2937732,17,2940863,0,-17
X,+,2941196,1.0,0.5,1,0,1,0,0,gene,Y71H10A.1,0,2941197,1.30343,3464,2937732,1,2941196,0,-1
X,+,2957927,0.0,1.90735e-06,19,19,0,0,0,gene,Y41G9A.4,0,2957934,0.215842,8911,2949016,7,2957925,-2,-9
X,+,2957933,0.0,0.000244141,12,12,0,0,14,gene,Y41G9A.4,0,2957934,0.215842,8917,2949016,1,2957925,-8,-9
X,+,2976227,0.0,0.125,3,3,0,0,0,gene,Y41G9A.3,0,2976255,0.0853481,8041,2968186,28,2976464,237,209
X,+,2976441,0.0,4.1359e-25,81,81,0,0,1,gene,Y41G9A.3,0,2976449,0.0853481,8255,2968186,8,2976464,23,15
X,+,3025052,0.0,0.5,1,1,0,0,9,gene,M02F4.8,0,3025115,5.49605,13391,3011661,63,3025053,1,-62
X,+,3025527,0.0137741,0.0,363,358,5,5,17,gene,M02F4.8,0,3025596,5.49605,13866,3011661,69,3025527,0,-69
X,+,3063770,0.0,0.25,2,2,0,0,26,gene,C33D12.7,0,3063985,0.125858,30497,3033273,215,3063565,-205,-420
X,+,3081116,0.0,0.00195312,9,9,0,0,0,gene,F52E4.4,0,3081123,0.0383209,15572,3065544,7,3081124,8,1
X,+,3090418,0.0101597,0.0,689,682,7,7,101,gene,F52E4.1,0,3090427,7.2937,5056,3085362,9,3090418,0,-9
X,+,3135495,0.00295421,0.0,1354,1350,4,3,9,gene,K10B3.1,0,3135495,3.1846,43018,3092477,0,3135496,1,1
X,+,3146464,0.0,2.38419e-07,22,22,0,0,4,gene,C15C7.4,0,3146464,0.762264,9810,3136654,0,3146564,100,100
X,+,3159931,0.0,1.05879e-22,73,73,0,0,3,gene,C15C7.2,1,3159946,0.278844,12004,3147927,15,3159931,0,-15
X,+,3164516,0.711392,6.62863e-18,395,114,281,159,2,gene,C15C7.1,2,3164527,0.450636,101,3164415,11,3164516,0,-11
X,+,3165819,0.558824,0.0605672,68,30,38,18,32,gene,C15C7.7,3,3165843,0.498376,173,3165646,24,3165787,-32,-56
X,+,3257435,0.0,0.0,198,198,0,0,45,gene,F40F4.4,0,3257439,4.13795,1180,3256255,4,3257440,5,1
X,+,3257468,0.0,0.5,1,1,0,0,714,gene,F40F4.4,0,3257485,4.13795,1213,3256255,17,3257440,-28,-45
X,+,3260599,0.0,1.49012e-08,26,26,0,0,1,gene,F40F4.2,0,3260790,18.2637,733,3259866,191,3260599,0,-191
X,+,3262718,0.0,0.00390625,8,8,0,0,2,gene,F40F4.1,0,3262991,0.0524006,1261,3261457,273,3262923,205,-68
X,+,3293275,0.0,0.000488281,11,11,0,0,0,gene,K09C4.3,0,3293277,None,877,3292398,2,3293278,3,1
X,+,3300922,0.0,0.015625,6,6,0,0,2,gene,K09C4.1,0,3300924,0.0973883,3030,3297892,2,3300922,0,-2
X,+,3315310,0.0,1.38778e-17,56,56,0,0,0,gene,F11D5.3,0,3315327,0.370423,8463,3306847,17,3315310,0,-17
X,+,3333114,0.011236,1.43787e-25,89,88,1,1,0,gene,F11D5.1,0,3333210,0.802835,8885,3324229,96,3333118,4,-92
X,+,3334497,0.0188679,5.88418e-15,53,52,1,1,0,gene,F11D5.1,0,3334513,0.802835,10268,3324229,16,3334514,17,1
X,+,3344673,0.0,0.0,216,216,0,0,3,gene,F11D5.1,0,3344678,0.802835,20444,3324229,5,3344679,6,1
X,+,3359063,0.0,2.91038e-11,35,35,0,0,3,gene,ZK816.1,0,3359064,0.153209,10433,3348630,1,3359050,-13,-14
X,+,3380461,0.0,3.8147e-06,18,18,0,0,0,gene,ZK563.7,0,3380568,0.0990079,7256,3373205,107,3380505,44,-63
X,+,3393851,0.0,2.84217e-14,45,45,0,0,1,gene,ZK563.1,0,3393929,0.134724,11026,3382825,78,3394345,494,416
X,+,3444769,0.0,0.0625,4,4,0,0,0,gene,ZK813.7,0,3444786,None,591,3444178,17,3444789,20,3
X,+,3480240,0.0,0.0,313,313,0,0,3,gene,ZK377.1,0,3480240,0.820064,31959,3448281,0,3480238,-2,-2
X,+,3489288,0.0,0.000488281,11,11,0,0,0,gene,C12D12.3,0,3489288,0.0386389,5642,3483646,0,3489289,1,1
X,+,3496013,0.0,1.16415e-10,33,33,0,0,2,gene,C12D12.2,0,3496076,1.84806,4457,3491556,63,3496013,0,-63
X,+,3496611,0.0262009,0.0,229,223,6,2,0,gene,C12D12.2,0,3496678,1.84806,5055,3491556,67,3496611,0,-67
X,+,3528799,0.0,1.19209e-07,23,23,0,0,0,gene,F56B6.5,0,3528799,0.0882859,23423,3505376,0,3528799,0,0
X,+,3537450,0.0,0.25,2,2,0,0,1,gene,F56B6.4,0,3537538,2.9292,5576,3531874,88,3537628,178,90
X,+,3537628,0.00606061,0.0,990,984,6,4,2,gene,F56B6.4,0,3537628,2.9292,5754,3531874,0,3537628,0,0
X,+,3542537,0.0,0.0,168,168,0,0,9,gene,F56B6.2,0,3542617,0.80706,1610,3540927,80,3542618,81,1
X,+,3547434,0.0434783,2.74181e-06,23,22,1,1,2,gene,F56B6.2,0,3547480,0.80706,6507,3540927,46,3547434,0,-46
X,+,3576595,0.00151515,0.0,660,659,1,1,2,gene,T27A10.3,0,3576600,0.636826,4039,3572556,5,3576595,0,-5
X,+,3601818,0.00118273,0.0,1691,1689,2,0,184,gene,C18B2.3,0,3601826,1.73149,15239,3586579,8,3601787,-31,-39
X,+,3651988,0.0,9.53674e-07,20,20,0,0,4,gene,R11G1.2,0,3652003,0.100004,21000,3630988,15,3652004,16,1
X,+,3656259,0.000820345,0.0,1219,1218,1,1,1,gene,R11G1.7,0,3656259,1.4731,853,3655406,0,3656260,1,1
X,+,3659387,0.0,3.05176e-05,15,15,0,0,0,gene,R11G1.1,0,3659415,0.0328009,2070,3657317,28,3659479,92,64
X,+,3681157,0.0,1.81899e-12,39,39,0,0,1,gene,C02F12.1,0,3681163,0.113545,14290,3666867,6,3681313,156,150
X,+,3709259,0.0,2.98023e-08,25,25,0,0,1,gene,C01C4.3,0,3709259,0.366891,8465,3700794,0,3709257,-2,-2
X,+,3716265,0.0,0.5,1,1,0,0,1,gene,C01C4.2,0,3716286,0.00298389,68,3716197,21,3716301,36,15
X,+,3727560,0.0040568,0.0,493,491,2,1,25,gene,C01C4.1,0,3727578,0.905143,8931,3718629,18,3727560,0,-18
X,+,3772747,0.0,0.0,214,214,0,0,0,gene,F47B7.2,0,3772760,1.48151,40803,3731944,13,3772747,0,-13
X,+,3788010,0.00290192,0.0,8615,8590,25,13,17,gene,F47B7.1,0,3788015,18.8544,9964,3778046,5,3787771,-239,-244
X,+,3807443,0.0,3.58732e-43,141,141,0,0,1,gene,F35A5.1,0,3807448,0.202974,1710,3805733,5,3807449,6,1
X,+,3888467,0.00268817,0.0,372,371,1,0,1,gene,F47F2.1,0,3888503,0.402058,72058,3816409,36,3888467,0,-36
X,+,3904570,0.00536193,0.0,373,371,2,1,0,gene,T22B2.4,0,3904617,1.20438,11281,3893289,47,3904570,0,-47
X,+,3917281,0.0,0.125,3,3,0,0,0,gene,T22B2.3,0,3917290,0.000446263,9631,3907650,9,3917279,-2,-11
X,+,3926061,0.0,6.77626e-21,67,67,0,0,0,gene,T22B2.1,0,3926083,0.0785697,2595,3923466,22,3926059,-2,-24
X,+,3958530,0.0133333,1.98523e-21,75,74,1,1,0,gene,C16B8.1,0,3958532,0.310692,18412,3940118,2,3958530,0,-2
X,+,3997317,0.0,3.08149e-33,108,108,0,0,0,gene,R02E12.5,0,3997357,0.18486,35398,3961919,40,3997358,41,1
X,+,4003508,0.0,0.015625,6,6,0,0,0,gene,R02E12.4,0,4003508,0.0268557,4193,3999315,0,4003509,1,1
X,+,4012196,0.00322581,0.0,310,309,1,1,0,gene,R02E12.2,0,4012206,1.63912,4572,4007624,10,4012207,11,1
X,+,4019218,0.0,6.10352e-05,14,14,0,0,3,gene,R02E12.2,0,4019281,1.63912,5832,4013386,63,4019221,3,-60
X,+,4019223,0.00109529,0.0,913,912,1,1,8,gene,R02E12.2,0,4019281,1.63912,5837,4013386,58,4019223,0,-58
X,+,4107436,0.0,0.00195312,9,9,0,0,1,gene,R02E4.2,0,4107461,0.0832511,81877,4025559,25,4107450,14,-11
X,+,4115306,0.0,0.0,216,216,0,0,8,gene,F09F9.1,0,4115311,0.157499,4920,4110386,5,4115312,6,1
X,+,4117921,0.0,6.10352e-05,14,14,0,0,13,gene,F09F9.5,0,4117924,None,968,4116953,3,4117925,4,1
X,+,4135107,0.0101351,0.0,296,293,3,2,3,gene,ZK470.2,0,4135133,4.14934,15617,4119490,26,4135107,0,-26
X,+,4136901,0.0714286,0.000854492,14,13,1,0,1,gene,ZK470.2,0,4136918,4.14934,17411,4119490,17,4136900,-1,-18
X,+,4137488,0.0,0.00012207,13,13,0,0,5,gene,ZK470.2,0,4137510,4.14934,17998,4119490,22,4137488,0,-22
X,+,4137833,0.0,0.125,3,3,0,0,0,gene,ZK470.2,0,4137935,4.14934,18343,4119490,102,4137833,0,-102
X,+,4145470,0.0,0.5,1,1,0,0,136,gene,ZK470.2,0,4145474,4.14934,25980,4119490,4,4145389,-81,-85
X,+,4146422,0.0,0.0,444,444,0,0,3,gene,ZK470.2,0,4146549,4.14934,26932,4119490,127,4146422,0,-127
X,+,4146735,0.0,0.5,1,1,0,0,10,gene,ZK470.2,0,4146830,4.14934,27245,4119490,95,4146735,0,-95
X,+,4191068,0.00267738,0.0,2988,2980,8,5,2,gene,F20B6.2,0,4191069,12.2414,21298,4169770,1,4191067,-1,-2
X,+,4255144,0.00361011,0.0,277,276,1,1,4,gene,F48D6.1,0,4255150,0.406266,995,4254149,6,4255144,0,-6
X,+,4260626,0.0035461,0.0,282,281,1,1,0,gene,C52B9.4,0,4260627,0.883998,1500,4259126,1,4260626,0,-1
X,+,4280954,0.0,1.61559e-27,89,89,0,0,4,gene,C52B9.2,0,4281049,0.287523,6247,4274707,95,4280954,0,-95
X,+,4287547,0.0606061,6.14673e-08,33,31,2,0,2,gene,C52B9.1,0,4287595,0.403375,2645,4284902,48,4287547,0,-48
X,+,4320826,0.0,3.05176e-05,15,15,0,0,0,gene,C24A8.1,0,4320836,0.0483519,29358,4291468,10,4320837,11,1
X,+,4339608,0.0,0.000976562,10,10,0,0,0,gene,F14H12.4,0,4339617,0.577327,13176,4326432,9,4339618,10,1
X,+,4350358,0.0,0.5,1,1,0,0,0,gene,F14H12.2,0,4350470,0.00159563,4734,4345624,112,4350471,113,1
X,+,4389338,0.00554017,0.0,361,359,2,1,1,gene,R160.1,0,4389348,1.64313,34522,4354816,10,4389338,0,-10
X,+,4454093,0.0105263,2.39814e-27,95,94,1,1,0,gene,F02E8.4,0,4454100,0.258581,12362,4441731,7,4454101,8,1
X,+,4458245,0.00342466,0.0,1752,1746,6,2,2,gene,F02E8.3,0,4458297,1.574,969,4457276,52,4458245,0,-52
X,+,4466796,0.0,1.19209e-07,23,23,0,0,3,gene,F02E8.2,0,4466797,0.0541697,3705,4463091,1,4466798,2,1
X,+,4469739,0.00425804,0.0,4697,4677,20,15,2,gene,F02E8.1,0,4469747,14.8402,761,4468978,8,4469739,0,-8
X,+,4508480,0.00465658,0.0,859,855,4,4,2,gene,F46H6.1,0,4508486,2.39732,37033,4471447,6,4508480,0,-6
X,+,4514069,0.0,2.24208e-44,145,145,0,0,2,gene,C07A12.5,0,4514077,0.407009,3145,4510924,8,4514069,0,-8
X,+,4532822,0.0,0.0,464,464,0,0,7,gene,C07A12.3,0,4532828,0.71791,6319,4526503,6,4532822,0,-6
X,+,4544821,0.0,2.52435e-29,95,95,0,0,4,gene,C07A12.2,0,4544845,0.247172,7309,4537512,24,4544846,25,1
X,+,4554663,0.0,1.65436e-24,79,79,0,0,0,gene,C07A12.1,0,4554665,0.470544,9005,4545658,2,4554663,0,-2
X,+,4557084,0.0,0.03125,5,5,0,0,2,gene,C07A12.1,0,4557106,0.470544,11426,4545658,22,4557107,23,1
X,+,4562137,0.0,2.27374e-13,42,42,0,0,0,gene,C05E11.6,0,4562166,0.11342,2761,4559376,29,4562167,30,1
X,+,4565274,0.0,0.0,410,410,0,0,4,gene,C05E11.5,0,4565280,0.503175,2402,4562872,6,4565274,0,-6
X,+,4579477,0.0,2.52435e-29,95,95,0,0,8,gene,C05E11.3,0,4579503,0.551657,5592,4573885,26,4579477,0,-26
X,+,4588738,0.0,2.86986e-42,138,138,0,0,0,gene,C05E11.1,0,4588804,0.915491,775,4587963,66,4588738,0,-66
X,+,4629010,0.00649351,7.00649e-45,154,153,1,0,8,gene,C46C11.3,0,4629026,0.52786,38594,4590416,16,4629027,17,1
X,+,4631942,1.0,0.5,1,0,1,0,0,gene,C46C11.2,0,4631951,0.190527,134,4631808,9,4632331,389,380
X,+,4632341,0.0327869,7.93636e-16,61,59,2,2,23,gene,C46C11.2,0,4632348,0.190527,533,4631808,7,4632331,-10,-17
X,+,4637389,0.0,4.48416e-44,144,144,0,0,7,gene,C46C11.1,0,4637410,0.312907,1638,4635751,21,4637411,22,1
X,+,4668059,0.0,7.45058e-09,27,27,0,0,0,gene,F16H11.1,0,4668059,0.115926,5120,4662939,0,4668059,0,0
X,+,4673778,0.0,0.0,176,176,0,0,58,gene,K02G10.3,0,4673838,0.359599,573,4673205,60,4673778,0,-60
X,+,4707149,0.00211864,0.0,472,471,1,1,58,gene,K02G10.1,0,4707156,0.537918,29839,4677310,7,4707157,8,1
X,+,4712248,0.0,0.0,237,237,0,0,1,gene,F55D10.3,1,4712259,0.480891,2465,4709783,11,4712248,0,-11
X,+,4715147,0.892418,0.0,23080,2483,20597,11365,22,gene,F55D10.2,2,4715152,81.9374,100,4715047,5,4715147,0,-5
X,+,4818567,0.0,3.55271e-15,48,48,0,0,0,gene,R08E3.3,0,4818585,0.358814,22439,4796128,18,4818567,0,-18
X,+,4822629,0.0,0.0,353,353,0,0,3,gene,R08E3.2,0,4822629,1.08385,949,4821680,0,4822627,-2,-2
X,+,4894025,0.0421053,8.0364e-23,95,91,4,3,0,gene,T07F12.1,0,4894028,0.253251,1727,4892298,3,4894029,4,1
X,+,4907258,0.00246914,0.0,405,404,1,1,1,gene,K05B2.2,0,4907259,0.576572,10668,4896590,1,4907258,0,-1
X,+,4908224,0.0,0.25,2,2,0,0,0,gene,K05B2.2,0,4908270,0.576572,11634,4896590,46,4908224,0,-46
X,+,4911173,0.0,0.5,1,1,0,0,3,gene,K05B2.2,0,4911177,0.576572,14583,4896590,4,4911173,0,-4
X,+,4948016,0.0588235,0.0001297,17,16,1,1,0,gene,M03F4.3,0,4948085,0.069479,35726,4912290,69,4948016,0,-69
X,+,4951794,0.0,0.25,2,2,0,0,1,gene,M03F4.3,0,4951984,0.069479,39504,4912290,190,4951794,0,-190
X,+,4962767,0.0,0.0625,4,4,0,0,1,gene,M03F4.2,0,4962785,56.1392,7459,4955308,18,4962766,-1,-19
X,+,4983530,0.0,2.27374e-13,42,42,0,0,11,gene,ZC8.4,0,4983530,2.45311,2064,4981466,0,4983530,0,0
X,+,4984034,0.0,0.0,323,323,0,0,1,gene,ZC8.4,0,4984044,2.45311,2568,4981466,10,4984045,11,1
X,+,4999237,0.00840336,1.79051e-34,119,118,1,1,1,gene,ZC8.3,0,4999243,0.874954,6039,4993198,6,4999237,0,-6
X,+,5005207,0.0,0.0625,4,4,0,0,0,gene,ZC8.1,0,5005250,0.0698787,1725,5003482,43,5005236,29,-14
X,+,5014047,0.0,0.000488281,11,11,0,0,19,gene,ZC449.7,0,5014086,None,2694,5011353,39,5014007,-40,-79
X,+,5018362,0.0,0.00012207,13,13,0,0,2,gene,ZC449.3,0,5018375,0.739195,573,5017789,13,5018362,0,-13
X,+,5018564,0.00452489,0.0,442,440,2,2,4,gene,ZC449.3,0,5018600,0.739195,775,5017789,36,5018564,0,-36
X,+,5024594,0.0,0.0625,4,4,0,0,62,gene,ZC449.1,0,5024594,0.16816,369,5024225,0,5024387,-207,-207
X,+,5044079,0.0,0.0078125,7,7,0,0,154,gene,Y64H9A.2,0,5044082,0.649875,15928,5028151,3,5043977,-102,-105
X,+,5061023,0.00806452,5.83045e-36,124,123,1,1,2,gene,C24H10.3,0,5061035,0.239311,3475,5057548,12,5061021,-2,-14
X,+,5064587,0.00909091,8.47409e-32,110,109,1,1,0,gene,C24H10.2,0,5064610,0.373906,2411,5062176,23,5064611,24,1
X,+,5071993,0.0,0.0,157,157,0,0,0,gene,C24H10.1,0,5072003,0.388421,5370,5066623,10,5072004,11,1
X,+,5087809,0.00847458,3.55093e-34,118,117,1,1,0,gene,C42D8.3,0,5087822,0.165464,13521,5074288,13,5087807,-2,-15
X,+,5109473,0.00808625,0.0,371,368,3,1,0,gene,C42D8.1,0,5109476,0.528677,3337,5106136,3,5109473,0,-3
X,+,5138958,0.0,2.1684e-19,62,62,0,0,0,gene,C31H2.1,0,5138983,0.702959,26608,5112350,25,5138958,0,-25
X,+,5163022,0.0166667,5.20417e-17,60,59,1,0,2,gene,EGAP5.1,0,5163033,0.259833,14145,5148877,11,5163022,0,-11
X,+,5165362,0.0,0.0,174,174,0,0,0,gene,T03G11.4,0,5165377,0.366135,1931,5163431,15,5165362,0,-15
X,+,5211102,0.0,1.81899e-12,39,39,0,0,1,gene,H28G03.2,1,5211217,1.44489,6890,5204212,115,5211102,0,-115
X,+,5211418,0.0,0.25,2,2,0,0,2,gene,H28G03.2,1,5211419,1.44489,7206,5204212,1,5211418,0,-1
X,+,5214288,0.0384615,3.8743e-07,26,25,1,1,4,gene,H28G03.2,1,5214306,1.44489,10076,5204212,18,5214288,0,-18
X,+,5216328,0.747981,9.87778e-37,619,156,463,210,6,gene,H28G03.1,2,5216357,3.92051,1,5216327,29,5216328,0,-29
X,+,5244302,0.0,0.5,1,1,0,0,1,gene,Y34B4A.7,0,5244333,0.481549,25244,5219058,31,5244302,0,-31
X,+,5244327,0.0,0.0,213,213,0,0,6,gene,Y34B4A.7,0,5244333,0.481549,25269,5219058,6,5244327,0,-6
X,+,5249868,0.00724638,3.96041e-40,138,137,1,1,15,gene,Y34B4A.10,0,5249891,0.41164,2984,5246884,23,5249868,0,-23
X,+,5255159,0.920024,0.0,3301,264,3037,1868,1,gene,Y34B4A.9,2,5255334,7.10648,139,5255020,175,5255159,0,-175
X,+,5257181,0.0,0.125,3,3,0,0,0,gene,Y34B4A.5,0,5257239,0.430068,361,5256820,58,5257254,73,15
X,+,5264293,0.0,3.72529e-09,28,28,0,0,0,gene,Y34B4A.4,0,5264294,0.213085,5944,5258349,1,5264295,2,1
X,+,5275532,0.0,7.27596e-12,37,37,0,0,3,gene,Y34B4A.3,0,5275536,0.289582,3762,5271770,4,5275532,0,-4
X,+,5279252,0.0,0.25,2,2,0,0,8,gene,Y34B4A.2,0,5279259,0.339205,770,5278482,7,5279494,242,235
X,+,5279560,0.0,1.12104e-44,146,146,0,0,60,gene,Y34B4A.2,0,5279587,0.339205,1078,5278482,27,5279494,-66,-93
X,+,5283067,0.0,0.5,1,1,0,0,1,gene,Y34B4A.11,1,5283081,None,2966,5280101,14,5283067,0,-14
X,+,5283789,0.833333,0.09375,6,1,5,1,0,gene,F32A6.3,2,5283800,0.269063,106,5283683,11,5283796,7,-4
X,+,5283796,0.861842,5.30697e-21,152,21,131,79,16,gene,F32A6.3,2,5283800,0.269063,113,5283683,4,5283796,0,-4
X,+,5344552,0.0,2.22045e-16,52,52,0,0,0,gene,C26B9.1,1,5344581,0.39738,1743,5342809,29,5344552,0,-29
X,+,5344831,0.0,9.09495e-13,40,40,0,0,2,gene,C26B9.1,1,5344831,0.39738,2022,5342809,0,5344831,0,0
X,+,5345104,0.0,0.5,1,1,0,0,4,gene,C26B9.1,1,5345231,0.39738,2295,5342809,127,5345104,0,-127
X,+,5349063,0.642857,0.00279825,84,30,54,22,0,gene,F35C8.4,2,5349081,0.329092,663,5348400,18,5349063,0,-18
X,+,5365780,0.0,0.0,644,644,0,0,35,gene,F35C8.5,0,5365859,1.3861,13468,5352312,79,5365780,0,-79
X,+,5372970,0.0,0.000488281,11,11,0,0,1,gene,F35C8.9,0,5372996,None,953,5372017,26,5372903,-67,-93
X,+,5375030,0.0,5.42101e-20,64,64,0,0,1,gene,F35C8.2,0,5375034,0.194879,1559,5373471,4,5375035,5,1
X,+,5377567,0.5,0.375,4,2,2,0,1,gene,F35C8.1,0,5377571,0.0114865,669,5376898,4,5377572,5,1
X,+,5461203,0.00653595,1.4013e-44,153,152,1,1,0,gene,C25F6.4,0,5461215,0.192476,11208,5449995,12,5461221,18,6
X,+,5467834,0.0,0.0,797,797,0,0,1,gene,C25F6.3,0,5467835,1.51016,1568,5466266,1,5467834,0,-1
X,+,5479664,0.00524934,0.0,762,758,4,4,0,gene,C25F6.2,0,5479724,3.00072,7020,5472644,60,5479664,0,-60
X,+,5486453,0.00203252,0.0,492,491,1,1,1,gene,C25F6.1,0,5486459,0.468637,1554,5484899,6,5486460,7,1
X,+,5493296,0.0,0.25,2,2,0,0,0,gene,T23F2.1,0,5493353,0.912448,3219,5490077,57,5493296,0,-57
X,+,5493724,0.0,0.000976562,10,10,0,0,0,gene,T23F2.1,0,5493752,0.912448,3647,5490077,28,5493724,0,-28
X,+,5558879,0.0,0.015625,6,6,0,0,0,gene,C38C5.1,0,5558908,0.0282091,13390,5545489,29,5558981,102,73
X,+,5582372,0.0,0.25,2,2,0,0,0,gene,F14D12.4,0,5582421,0.392949,14592,5567780,49,5582569,197,148
X,+,5593092,0.0381944,0.0,288,277,11,9,29,gene,F14D12.2,0,5593105,1.9252,2330,5590762,13,5593092,0,-13
X,+,5603746,0.0,1.73472e-18,59,59,0,0,1,gene,F14D12.1,0,5603753,0.185833,8806,5594940,7,5603724,-22,-29
X,+,5629985,0.0,0.000488281,11,11,0,0,0,gene,T21F4.1,0,5630097,1.68922,20892,5609093,112,5630314,329,217
X,+,5630299,0.00195695,0.0,1022,1020,2,1,7,gene,T21F4.1,0,5630316,1.68922,21206,5609093,17,5630314,15,-2
X,+,5631398,0.0,0.5,1,1,0,0,3,gene,T22B7.8,0,5631432,0.133101,22305,5609093,34,5631398,0,-34
X,+,5637750,0.0,0.25,2,2,0,0,2,gene,T22B7.8,0,5637785,0.133101,859,5636891,35,5637750,0,-35
X,+,5647338,0.00226757,0.0,441,440,1,1,0,gene,T22B7.3,0,5647338,1.07754,9284,5638054,0,5647339,1,1
X,+,5663795,0.0,2.46519e-32,105,105,0,0,0,gene,T22B7.1,0,5663854,0.765832,13612,5650183,59,5663795,0,-59
X,+,5668278,0.015625,3.46945e-18,64,63,1,0,0,gene,T22B7.1,0,5668278,0.765832,18095,5650183,0,5668278,0,0
X,+,5669645,0.0,2.46519e-32,105,105,0,0,0,gene,T22B7.1,0,5669745,0.765832,19462,5650183,100,5669645,0,-100
X,+,5671331,0.0,5.96046e-08,24,24,0,0,2,gene,T22B7.1,0,5671689,0.765832,21148,5650183,358,5671331,0,-358
X,+,5714480,0.0,0.00012207,13,13,0,0,9,gene,E03E2.1,0,5714541,0.386737,20115,5694365,61,5714480,0,-61
X,+,5776209,0.0,7.10543e-15,47,47,0,0,6,gene,C54H2.1,0,5776227,0.938814,58584,5717625,18,5776209,0,-18
X,+,5783363,0.0,2.84217e-14,45,45,0,0,4,gene,F46G11.3,0,5783518,0.356872,4528,5778835,155,5783363,0,-155
X,+,5786459,0.666667,0.375,3,1,2,1,8,gene,F46G11.6,0,5786459,None,36,5786423,0,5786457,-2,-2
X,+,5788121,0.0,4.44089e-16,51,51,0,0,28,gene,F46G11.2,0,5788125,0.202992,810,5787311,4,5788081,-40,-44
X,+,5791661,0.0,2.77556e-17,55,55,0,0,0,gene,F46G11.1,0,5791701,0.12064,1357,5790304,40,5791661,0,-40
X,+,5822106,0.0,1.97215e-31,102,102,0,0,1,gene,F13D11.2,0,5822184,2.69156,24968,5797138,78,5822235,129,51
X,+,5823027,0.0,0.0,283,283,0,0,1,gene,F13D11.2,0,5823089,2.69156,25889,5797138,62,5823026,-1,-63
X,+,5841550,0.0153061,0.0,196,193,3,2,0,gene,W06B11.2,0,5841574,1.49855,9565,5831985,24,5841550,0,-24
X,+,5849062,0.0277778,6.29104e-28,108,105,3,2,2,gene,W06B11.1,0,5849065,0.366859,3117,5845945,3,5849062,0,-3
X,+,5885823,0.0,0.0,458,458,0,0,2,gene,F49E10.3,0,5885824,1.23399,4299,5881524,1,5885823,0,-1
X,+,5897302,0.0,2.91038e-11,35,35,0,0,0,gene,F49E10.1,0,5897348,0.128045,2586,5894716,46,5897300,-2,-48
X,+,5904611,0.00126072,0.0,3966,3961,5,3,1,gene,H05L03.3,0,5904627,4.73928,2506,5902105,16,5904611,0,-16
X,+,5931080,0.0,2.22045e-16,52,52,0,0,0,gene,C46F4.1,0,5931101,0.08156,10628,5920452,21,5931080,0,-21
X,+,5953410,0.00701403,0.0,998,991,7,5,14,gene,R07E4.3,0,5953415,4.88807,15903,5937507,5,5953408,-2,-7
X,+,5959012,0.0,0.015625,6,6,0,0,0,gene,R07E4.1,0,5959072,0.132561,5239,5953773,60,5959073,61,1
X,+,5963345,0.0,1.52588e-05,16,16,0,0,0,gene,R07E4.1,0,5963358,0.132561,9572,5953773,13,5963359,14,1
X,+,5996114,0.00116279,0.0,860,859,1,1,2,gene,F22F4.2,0,5996126,4.08561,4009,5992105,12,5996114,0,-12
X,+,6004240,0.0,0.5,1,1,0,0,3,gene,F22F4.1,0,6004245,0.550462,5984,5998256,5,6004441,201,196
X,+,6015472,0.0,3.63798e-12,38,38,0,0,0,gene,C09B8.8,0,6015476,0.0890368,8412,6007060,4,6015450,-22,-26
X,+,6031427,0.00238663,0.0,419,418,1,1,4,gene,C09B8.1,0,6031429,0.535221,13787,6017640,2,6031427,0,-2
X,+,6053016,0.0192308,1.15463e-14,52,51,1,1,14,gene,C45B2.6,0,6053027,0.244314,18446,6034570,11,6053058,42,31
X,+,6058213,0.0306748,0.0,326,316,10,7,3,gene,C45B2.5,0,6058239,0.871044,1082,6057131,26,6058212,-1,-27
X,+,6070456,0.0,0.25,2,2,0,0,0,gene,C45B2.4,0,6070588,0.0422392,10255,6060201,132,6070456,0,-132
X,+,6075538,0.0,0.015625,6,6,0,0,31,gene,C45B2.4,0,6075581,0.0422392,15337,6060201,43,6075538,0,-43
X,+,6093258,0.0,0.0,165,165,0,0,38,gene,C15H9.5,0,6093269,0.436596,4897,6088361,11,6093258,0,-11
X,+,6101175,0.00668151,0.0,449,446,3,3,10,gene,C15H9.4,0,6101215,0.751537,3640,6097535,40,6101175,0,-40
X,+,6118486,0.0,1.52588e-05,16,16,0,0,0,gene,C15H9.2,0,6118538,0.0335479,477,6118009,52,6118669,183,131
X,+,6122271,0.0,0.015625,6,6,0,0,6,gene,C15H9.1,0,6122279,0.294031,1848,6120423,8,6122273,2,-6
X,+,6122279,0.0,4.1359e-25,81,81,0,0,10,gene,C15H9.1,0,6122279,0.294031,1856,6120423,0,6122273,-6,-6
X,+,6169263,0.0,0.25,2,2,0,0,0,gene,T25B2.2,0,6169439,0.128226,41755,6127508,176,6169263,0,-176
X,+,6240940,0.00127497,0.0,2353,2350,3,3,35,gene,C14F11.1,0,6240960,7.40065,40168,6200772,20,6240940,0,-20
X,+,6263605,0.00806452,0.0,248,246,2,2,0,gene,W05H9.4,1,6263609,0.383171,11041,6252564,4,6263603,-2,-6
X,+,6267000,0.910112,1.14101e-16,89,8,81,48,11,gene,W05H9.2,2,6267005,0.348539,130,6266870,5,6267006,6,1
X,+,6271822,1.0,0.25,2,0,2,2,1,gene,W05H9.1,3,6271830,3.17453,781,6271041,8,6272032,210,202
X,+,6272046,0.00193986,0.0,1031,1029,2,1,20,gene,W05H9.1,3,6272046,3.17453,1005,6271041,0,6272046,0,0
X,+,6279973,0.00125839,0.0,2384,2381,3,3,8,gene,T07H6.3,0,6280083,16.1728,6248,6273725,110,6279973,0,-110
X,+,6293080,0.0,3.05176e-05,15,15,0,0,0,gene,T07H6.2,0,6293082,0.124311,12108,6280972,2,6293083,3,1
X,+,6300096,0.0,0.00195312,9,9,0,0,0,gene,T07H6.1,0,6300216,0.124822,1939,6298157,120,6300096,0,-120
X,+,6323444,0.0019802,0.0,505,504,1,0,4,gene,T10E10.2,0,6323554,3.7803,9594,6313850,110,6323444,0,-110
X,+,6326149,0.0,0.0625,4,4,0,0,6,gene,T10E10.1,0,6326237,0,1658,6324491,88,6326147,-2,-90
X,+,6329116,0.00366972,0.0,1635,1629,6,5,0,gene,T10E10.5,0,6329241,1.70426,1787,6327329,125,6329116,0,-125
X,+,6341776,0.0,9.31323e-10,30,30,0,0,0,gene,C03B1.7,0,6341790,0.0824583,6599,6335177,14,6342112,336,322
X,+,6350239,0.0,0.25,2,2,0,0,0,gene,C03B1.6,0,6350245,0.00238584,4520,6345719,6,6350143,-96,-102
X,+,6350261,0.0,0.25,2,2,0,0,0,gene,C03B1.6,0,6350271,0.00238584,4542,6345719,10,6350143,-118,-128
X,+,6355541,0.0,0.015625,6,6,0,0,0,gene,C03B1.5,0,6355603,0.0328407,3709,6351832,62,6355541,0,-62
X,+,6403379,0.0322581,1.44355e-08,31,30,1,0,0,gene,T22E5.2,0,6403384,0.144117,15545,6387834,5,6403377,-2,-7
X,+,6413237,0.0588235,3.26545e-08,34,32,2,2,3,gene,T22E5.1,0,6413240,0.611967,6327,6406910,3,6413234,-3,-6
X,+,6468754,0.0,0.015625,6,6,0,0,0,gene,C15B12.9,0,6468757,0.00816711,2853,6465901,3,6468754,0,-3
X,+,6474227,0.0,0.5,1,1,0,0,1,gene,C15B12.8,0,6474228,0.0318835,4202,6470025,1,6474229,2,1
X,+,6510886,0.00123916,0.0,807,806,1,1,27,gene,F22A3.7,1,6510891,1.79576,971,6509915,5,6510888,2,-3
X,+,6512240,0.897638,0.0,635,65,570,271,1,gene,F22A3.2,2,6512241,1.67287,90,6512150,1,6512240,0,-1
X,+,6519062,0.0,1.17549e-38,126,126,0,0,0,gene,F22A3.1,0,6519076,0.674837,6189,6512873,14,6519062,0,-14
X,+,6519750,0.0,3.8147e-06,18,18,0,0,11,gene,F22A3.1,0,6519773,0.674837,6877,6512873,23,6519774,24,1
X,+,6553243,0.0021097,0.0,474,473,1,1,4,gene,T14E8.1,0,6553249,0.690395,9305,6543938,6,6553243,0,-6
X,+,6592539,0.00304878,0.0,328,327,1,1,0,gene,T28B4.1,0,6592542,0.429129,4760,6587779,3,6592532,-7,-10
X,+,6606970,0.0,0.000244141,12,12,0,0,2,gene,C25B8.3,0,6607049,14.6599,10880,6596090,79,6607158,188,109
X,+,6609978,0.0,0.125,3,3,0,0,0,gene,C25B8.8,0,6610008,0.0716698,981,6608997,30,6610009,31,1
X,+,6618975,0.0,2.98023e-08,25,25,0,0,10,gene,C25B8.1,0,6618976,0.147025,3656,6615319,1,6618977,2,1
X,+,6645424,0.0,0.000976562,10,10,0,0,0,gene,C56E10.3,0,6645618,0.0146113,17486,6627938,194,6645609,185,-9
X,+,6646943,0.0,0.5,1,1,0,0,2,gene,C56E10.3,0,6647027,0.0146113,19005,6627938,84,6647033,90,6
X,+,6655482,0.0,1.61559e-27,89,89,0,0,0,gene,C56E10.1,0,6655501,0.0828921,3774,6651708,19,6655502,20,1
X,+,6673215,0.0,0.5,1,1,0,0,0,gene,F38B6.5,0,6673376,0.303958,13460,6659755,161,6673377,162,1
X,+,6674825,0.00347222,0.0,288,287,1,1,0,gene,F38B6.4,0,6674830,0.350477,453,6674372,5,6674831,6,1
X,+,6713530,0.0,0.0,331,331,0,0,1,gene,K11G12.1,0,6713530,0.628111,682,6712848,0,6713530,0,0
X,+,6783190,0.0,0.015625,6,6,0,0,1,gene,H22K11.3,0,6783210,0.0863568,7680,6775510,20,6783211,21,1
X,+,6791019,0.0,3.46945e-18,58,58,0,0,10,gene,H22K11.1,0,6791143,30.7338,3762,6787257,124,6791126,107,-17
X,+,6800641,0.0,1.38778e-17,56,56,0,0,0,gene,M03A8.3,0,6800679,0.185994,8027,6792614,38,6800641,0,-38
X,+,6809049,0.0,3.58732e-43,141,141,0,0,0,gene,M03A8.2,0,6809056,0.839172,2040,6807009,7,6809057,8,1
X,+,6818391,0.00485437,0.0,1442,1435,7,6,15,gene,M03A8.1,0,6818397,3.94422,1224,6817167,6,6818391,0,-6
X,+,6840872,0.0,0.0078125,7,7,0,0,0,gene,C53B7.4,0,6840954,13.3792,20841,6820031,82,6841210,338,256
X,+,6841210,0.00359777,0.0,5559,5539,20,15,1,gene,C53B7.4,0,6841210,13.3792,21179,6820031,0,6841210,0,0
X,+,6853570,0.0,0.0,189,189,0,0,0,gene,C53B7.1,0,6853595,0.487365,6167,6847403,25,6853570,0,-25
X,+,6889628,0.0,1.2326e-32,106,106,0,0,2,gene,F41C6.1,0,6889691,0.569094,28754,6860874,63,6889641,13,-50
X,+,6904704,0.011194,0.0,268,265,3,3,478,gene,F14B8.2,2,6904726,1.51198,767,6903937,22,6904688,-16,-38
X,+,6914241,0.0,2.58494e-26,85,85,0,0,1,gene,F14B8.1,0,6914326,0.279136,8452,6905789,85,6914241,0,-85
X,+,6914895,0.0,0.5,1,1,0,0,0,gene,F14B8.1,0,6914966,0.279136,9106,6905789,71,6914895,0,-71
X,+,6917280,0.0,6.93889e-18,57,57,0,0,0,gene,F14B8.1,0,6917280,0.279136,11491,6905789,0,6917280,0,0
X,+,6935683,0.0454545,5.24521e-06,22,21,1,0,0,gene,C16E9.2,0,6935690,0.353448,14568,6921115,7,6935696,13,6
X,+,6940408,0.0,7.27596e-12,37,37,0,0,3,gene,C16E9.1,0,6940429,0.389113,1420,6938988,21,6940430,22,1
X,+,6967497,0.0,0.0625,4,4,0,0,6,gene,F01E11.3,0,6967629,0.0556152,23833,6943664,132,6967319,-178,-310
X,+,7019975,0.0,1.90735e-06,19,19,0,0,3,gene,R173.1,0,7020038,0.941102,25863,6994112,63,7019979,4,-59
X,+,7019982,0.00675676,0.0,444,441,3,3,8,gene,R173.1,0,7020038,0.941102,25870,6994112,56,7019979,-3,-59
X,+,7029092,0.00160901,0.0,1243,1241,2,1,0,gene,R173.4,0,7029123,1.09067,5174,7023918,31,7029085,-7,-38
X,+,7050538,0.1,0.00976562,10,9,1,1,0,gene,B0403.2,0,7050575,0.0694363,20951,7029587,37,7050576,38,1
X,+,7057678,0.0,0.0,163,163,0,0,1,gene,B0403.5,0,7057732,0.445326,2049,7055629,54,7057756,78,24
X,+,7101775,0.0,0.000488281,11,11,0,0,9,gene,C36B7.3,0,7101794,0.157345,16188,7085587,19,7101726,-49,-68
X,+,7126597,0.0,0.015625,6,6,0,0,0,gene,C36B7.8,0,7126599,0.0639578,11785,7114812,2,7126600,3,1
X,+,7132101,0.0,6.10352e-05,14,14,0,0,0,gene,C54D1.3,0,7132155,0.13,17289,7114812,54,7132156,55,1
X,+,7158985,0.0126582,1.30695e-22,79,78,1,1,0,gene,C54D1.1,0,7158991,0.21396,18541,7140444,6,7158985,0,-6
X,+,7194513,0.002331,0.0,858,856,2,2,4,gene,C55B6.2,1,7194528,1.48086,28539,7165974,15,7194513,0,-15
X,+,7200313,0.0,0.0,156,156,0,0,0,gene,C55B6.1,2,7200335,0.211161,2074,7198239,22,7200319,6,-16
X,+,7200319,0.0,4.03897e-28,91,91,0,0,21,gene,C55B6.1,2,7200335,0.211161,2080,7198239,16,7200319,0,-16
X,+,7201227,0.0,0.5,1,1,0,0,3,gene,C55B6.1,2,7201244,0.211161,2988,7198239,17,7201227,0,-17
X,+,7211656,0.0,0.0,409,409,0,0,0,gene,ZK867.3,0,7211710,0.572233,915,7210741,54,7211656,0,-54
X,+,7223820,0.0,0.5,1,1,0,0,1,gene,ZK867.1,0,7223866,1.17227,9914,7213906,46,7223820,0,-46
X,+,7265601,0.00241546,0.0,414,413,1,0,2,gene,F46H5.2,0,7265611,0.76799,38827,7226774,10,7265601,0,-10
X,+,7292085,0.00271739,0.0,368,367,1,0,32,gene,K03A1.2,0,7292232,1.75461,24245,7267840,147,7292085,0,-147
X,+,7312154,0.0,0.5,1,1,0,0,10,gene,T08A9.5,0,7312410,0.0324278,16170,7295984,256,7312138,-16,-272
X,+,7327553,0.0,2.06795e-25,82,82,0,0,0,gene,T08A9.3,0,7327553,0.391679,9897,7317656,0,7327554,1,1
X,+,7331137,0.0017094,0.0,585,584,1,0,0,gene,T08A9.2,0,7331153,0.696537,542,7330595,16,7331135,-2,-18
X,+,7334717,0.0,0.0,153,153,0,0,0,gene,T08A9.1,0,7334724,0.572121,2933,7331784,7,7334660,-57,-64
X,+,7341455,0.00392542,0.0,3057,3045,12,9,0,gene,C07D8.6,0,7341481,4.82206,1317,7340138,26,7341455,0,-26
X,+,7343992,0.0,0.0625,4,4,0,0,0,gene,C07D8.5,0,7343992,0.00594042,1266,7342726,0,7343993,1,1
X,+,7377248,0.0,0.5,1,1,0,0,2,gene,C56G3.1,0,7377264,0.0839541,11004,7366244,16,7377248,0,-16
X,+,7390522,0.0,0.000244141,12,12,0,0,0,gene,C10A4.6,0,7390545,0.00584716,2198,7388324,23,7390520,-2,-25
X,+,7394094,0.0,1.90735e-06,19,19,0,0,0,gene,C10A4.5,0,7394119,0.0424649,682,7393412,25,7393863,-231,-256
X,+,7398916,0.0,1.81899e-12,39,39,0,0,2,gene,C10A4.10,0,7398943,None,2976,7395940,27,7398914,-2,-29
X,+,7402079,0.0232558,4.88853e-12,43,42,1,1,1,gene,C10A4.4,0,7402120,0.0429047,1577,7400502,41,7402121,42,1
X,+,7407398,0.0,1.50463e-36,119,119,0,0,3,gene,C10A4.3,0,7407401,0.11039,3843,7403555,3,7407402,4,1
X,+,7431419,0.0,0.0,371,371,0,0,0,gene,C01C10.1,1,7431420,0.33745,8781,7422638,1,7431417,-2,-3
X,+,7433581,0.920455,2.05126e-17,88,7,81,35,0,gene,C01C10.4,2,7433591,0.522185,108,7433473,10,7433592,11,1
X,+,7478866,0.0,9.53674e-07,20,20,0,0,3,gene,K08A8.1,0,7478938,1.57349,43186,7435680,72,7479194,328,256
X,+,7479194,0.0042796,0.0,701,698,3,3,2,gene,K08A8.1,0,7479201,1.57349,43514,7435680,7,7479194,0,-7
X,+,7525516,0.00671141,2.08793e-43,149,148,1,0,2,gene,F46C8.3,0,7525517,0.788861,34866,7490650,1,7525518,2,1
X,+,7559868,0.0,0.0078125,7,7,0,0,14,gene,F08C6.5,0,7559915,0.121467,405,7559463,47,7560074,206,159
X,+,7562592,0.0,0.0078125,7,7,0,0,3,gene,F08C6.4,0,7562831,2.0275,531,7562061,239,7562835,243,4
X,+,7562865,0.0,0.0,415,415,0,0,381,gene,F08C6.4,0,7562867,2.0275,804,7562061,2,7562835,-30,-32
X,+,7565267,0.00518135,0.0,193,192,1,1,10,gene,F08C6.3,0,7565274,0.305851,516,7564751,7,7565267,0,-7
X,+,7578711,0.00126422,0.0,1582,1580,2,2,3,gene,F08C6.2,0,7578714,1.36767,10616,7568095,3,7578711,0,-3
X,+,7586053,0.0,8.07794e-28,90,90,0,0,1,gene,F08C6.1,0,7586151,0.598837,5055,7580998,98,7586053,0,-98
X,+,7593356,0.0,0.25,2,2,0,0,0,gene,F08C6.1,0,7593360,0.598837,194,7593162,4,7593356,0,-4
X,+,7596870,0.0243161,0.0,329,321,8,2,2,gene,C44E12.1,0,7596900,0.47237,1525,7595345,30,7596870,0,-30
X,+,7627594,0.00240385,0.0,832,830,2,1,0,gene,F26A10.1,0,7627623,1.12922,27827,7599767,29,7627624,30,1
X,+,7672933,0.0,2.01948e-28,92,92,0,0,0,gene,F27D9.2,0,7672934,0.203124,6703,7666230,1,7672933,0,-1
X,+,7682836,0.00341297,0.0,293,292,1,1,0,gene,F27D9.1,0,7682871,1.40472,6594,7676242,35,7682836,0,-35
X,+,7719212,0.01,7.88861e-29,100,99,1,1,1,gene,K09F5.6,0,7719215,0.576256,33222,7685990,3,7719212,0,-3
X,+,7725919,0.00249869,0.0,24813,24751,62,51,75,gene,K09F5.3,0,7725919,62.9268,359,7725560,0,7725919,0,0
X,+,7725926,0.5,0.5,2,1,1,1,22803,gene,K09F5.3,0,7725992,62.9268,366,7725560,66,7725919,-7,-73
X,+,7745741,0.0,0.015625,6,6,0,0,0,gene,C47C12.3,0,7745759,0.317228,4711,7741030,18,7745755,14,-4
X,+,7745755,0.0075188,1.22141e-38,133,132,1,1,7,gene,C47C12.3,0,7745759,0.317228,4725,7741030,4,7745755,0,-4
X,+,7753933,0.0,0.03125,5,5,0,0,1,gene,C47C12.2,0,7753985,0,3983,7749950,52,7753986,53,1
X,+,7763149,0.0,0.00012207,13,13,0,0,2,gene,C47C12.6,0,7763158,0.0924567,7962,7755187,9,7763149,0,-9
X,+,7779562,0.00429185,0.0,466,464,2,1,6,gene,ZK154.1,0,7779565,1.64432,4788,7774774,3,7779566,4,1
X,+,7816674,0.00552486,0.0,543,540,3,1,2,gene,R03G5.2,0,7816703,0.973498,11060,7805614,29,7816674,0,-29
X,+,7823594,0.00449236,0.0,7791,7756,35,23,0,gene,R03G5.1,0,7823616,33.193,2614,7820980,22,7823594,0,-22
X,+,7838841,0.0,0.0,343,343,0,0,9,gene,C54D2.2,0,7838876,0.524251,13136,7825705,35,7838626,-215,-250
X,+,7885340,0.0,0.00195312,9,9,0,0,4,gene,C39D10.3,0,7885357,0.201465,39848,7845492,17,7885358,18,1
X,+,7903225,0.0,3.63798e-12,38,38,0,0,0,gene,C39D10.11,0,7903265,0.2628,13517,7889708,40,7903223,-2,-42
X,+,7954299,0.013468,0.0,297,293,4,4,3,gene,C14F5.1,0,7954317,1.60534,22548,7931751,18,7954320,21,3
X,+,7976643,0.0,2.38419e-07,22,22,0,0,0,gene,F45E1.5,0,7976697,0.0677195,20511,7956132,54,7976643,0,-54
X,+,7985923,0.0,0.0,544,544,0,0,0,gene,F45E1.4,0,7985924,1.32903,5450,7980473,1,7985925,2,1
X,+,8003627,0.0,3.85186e-34,111,111,0,0,0,gene,F45E1.2,0,8003675,0.0851462,14782,7988845,48,8003676,49,1
X,+,8007748,0.0,0.0,228,228,0,0,0,gene,F45E1.1,0,8007750,0.88232,3728,8004020,2,8007751,3,1
X,+,8017882,0.0121951,1.69572e-23,82,81,1,0,38,gene,C34D10.2,0,8018028,1.49494,8541,8009341,146,8017962,80,-66
X,+,8019097,0.0,2.35099e-38,125,125,0,0,3,gene,C34D10.2,0,8019170,1.49494,9756,8009341,73,8019097,0,-73
X,+,8029421,0.00510204,0.0,392,390,2,0,4,gene,C34D10.1,0,8029440,0.65161,2612,8026809,19,8029419,-2,-21
X,+,8041255,0.0,9.53674e-07,20,20,0,0,1,gene,C18A11.5,0,8041267,0.0660034,9699,8031556,12,8041268,13,1
X,+,8061071,0.0,0.0,269,269,0,0,11,gene,C18A11.3,0,8061119,0.606247,13714,8047357,48,8061063,-8,-56
X,+,8067613,0.0,0.0,257,257,0,0,26,gene,C18A11.2,0,8067627,0.597082,1980,8065633,14,8067628,15,1
X,+,8078006,0.0,2.1684e-19,62,62,0,0,0,gene,C46F2.1,0,8078015,0.351811,7780,8070226,9,8077686,-320,-329
X,+,8104248,0.0,2.64698e-23,75,75,0,0,1,gene,K07E3.2,0,8104248,0.199798,18442,8085806,0,8104249,1,1
X,+,8110380,0.0,4.33681e-19,61,61,0,0,1,gene,K07E3.1,0,8110389,0.581735,1100,8109280,9,8110390,10,1
X,+,8116579,0.0,3.8147e-06,18,18,0,0,0,gene,C02B8.4,0,8116618,0.121935,1881,8114698,39,8116579,0,-39
X,+,8139434,0.0,0.0625,4,4,0,0,193,gene,C02B8.3,0,8139456,0.24139,19249,8120185,22,8139463,29,7
X,+,8169870,0.00497512,0.0,201,200,1,0,1,gene,C17H11.2,0,8169880,0.220078,9845,8160025,10,8169870,0,-10
X,+,8215009,0.0,0.0,312,312,0,0,0,gene,C47D2.1,0,8215016,0.556573,34164,8180845,7,8215017,8,1
X,+,8242240,0.00126582,0.0,790,789,1,1,4,gene,M60.2,0,8242261,2.86848,26631,8215609,21,8242240,0,-21
X,+,8275107,0.0,6.10352e-05,14,14,0,0,2,gene,F13B9.5,0,8275156,0.339052,27301,8247806,49,8275107,0,-49
X,+,8285623,0.0,1.0842e-19,63,63,0,0,4,gene,F13B9.2,0,8285654,0.129898,2351,8283272,31,8285621,-2,-33
X,+,8287189,0.00104822,0.0,954,953,1,1,3,gene,F13B9.1,1,8287198,1.56032,467,8286722,9,8287199,10,1
X,+,8294563,0.927083,1.50441e-19,96,7,89,51,21,gene,R09F10.3,2,8294656,0.462375,111,8294452,93,8294563,0,-93
X,+,8341911,0.0,0.25,2,2,0,0,0,gene,F55E10.1,0,8341913,0.00340747,986,8340925,2,8341914,3,1
X,+,8368475,0.00168919,0.0,592,591,1,1,3,gene,F40B5.2,0,8368477,0.532777,26250,8342225,2,8368478,3,1
X,+,8428782,0.0,0.0,200,200,0,0,0,gene,F08F1.3,0,8428799,0.272144,14649,8414133,17,8428822,40,23
X,+,8428934,0.0,0.5,1,1,0,0,49,gene,F08F1.3,0,8428962,0.272144,14801,8414133,28,8428822,-112,-140
X,+,8432601,0.04,7.45058e-07,25,24,1,1,0,gene,F08F1.1,0,8432631,0.0560257,2216,8430385,30,8432601,0,-30
X,+,8447207,0.0,0.0,260,260,0,0,0,gene,F16F9.1,0,8447211,0.409914,9923,8437284,4,8447212,5,1
X,+,8495245,0.0,7.10543e-15,47,47,0,0,1,gene,T01B10.5,0,8495259,0.119269,23971,8471274,14,8495260,15,1
X,+,8499945,0.0,9.09495e-13,40,40,0,0,146,gene,T01B10.2,0,8499975,4.34516,1932,8498013,30,8499602,-343,-373
X,+,8499959,0.000503398,0.0,3973,3971,2,1,143,gene,T01B10.2,0,8499975,4.34516,1946,8498013,16,8499602,-357,-373
X,+,8507814,0.0,0.0,178,178,0,0,0,gene,H03E18.1,0,8507850,0.506878,5591,8502223,36,8507814,0,-36
X,+,8528064,0.0,0.5,1,1,0,0,0,gene,C03G5.7,0,8528162,3.43697,5683,8522381,98,8528188,124,26
X,+,8552200,0.0,0.0,648,648,0,0,0,gene,D2021.2,0,8552215,0.826743,9983,8542217,15,8552200,0,-15
X,+,8557081,0.027027,2.6921e-10,37,36,1,1,0,gene,D2021.1,0,8557118,0.449942,785,8556296,37,8557090,9,-28
X,+,8557090,0.00526316,0.0,190,189,1,0,43,gene,D2021.1,0,8557118,0.449942,794,8556296,28,8557090,0,-28
X,+,8570678,0.0,0.000976562,10,10,0,0,0,gene,F18E9.5,0,8570686,0.835863,7504,8563174,8,8570988,310,302
X,+,8570988,0.0,0.0,374,374,0,0,1,gene,F18E9.5,0,8571012,0.835863,7814,8563174,24,8570988,0,-24
X,+,8586100,0.0,3.63798e-12,38,38,0,0,3,gene,F18E9.3,0,8586140,0.613065,2609,8583491,40,8586105,5,-35
X,+,8593126,0.00364964,0.0,274,273,1,1,2,gene,F18E9.2,0,8593133,1.00856,2899,8590227,7,8593134,8,1
X,+,8618469,0.0,2.27374e-13,42,42,0,0,1,gene,K01A12.2,0,8618515,0.0720888,7196,8611273,46,8618355,-114,-160
X,+,8661217,0.0,1.19209e-07,23,23,0,0,0,gene,K09E2.4,0,8661221,0.583897,41344,8619873,4,8661233,16,12
X,+,8669230,0.0,7.62939e-06,17,17,0,0,1,gene,K09E2.4,0,8669237,0.583897,49357,8619873,7,8669230,0,-7
X,+,8673029,0.285714,0.0610962,14,10,4,2,7,gene,K09E2.2,0,8673068,0.00901053,1332,8671697,39,8672999,-30,-69
X,+,8676563,0.005,0.0,600,597,3,2,2,gene,K09E2.3,0,8676612,1.17654,4866,8671697,49,8676566,3,-46
X,+,8676647,0.0,0.5,1,1,0,0,29,gene,K09E2.3,0,8676821,1.17654,4950,8671697,174,8676566,-81,-255
X,+,8697727,0.0,2.98023e-08,25,25,0,0,0,gene,F53A9.5,0,8697755,0.0485922,11635,8686092,28,8697756,29,1
X,+,8708298,0.0,2.38419e-07,22,22,0,0,0,gene,F53A9.3,0,8708303,0.0654742,1177,8707121,5,8708304,6,1
X,+,8711531,0.00255302,0.0,5092,5079,13,9,40,gene,F53A9.1,0,8711533,9.88391,1577,8709954,2,8711467,-64,-66
X,+,8739614,0.0,0.03125,5,5,0,0,2,gene,M02D8.2,0,8739676,0.108445,17325,8722289,62,8739659,45,-17
X,+,8739671,0.0,3.8147e-06,18,18,0,0,4,gene,M02D8.2,0,8739676,0.108445,17382,8722289,5,8739659,-12,-17
X,+,8763846,0.00143472,0.0,1394,1392,2,2,3,gene,M02D8.1,0,8763847,4.62132,9878,8753968,1,8763848,2,1
X,+,8778797,0.0,9.53674e-07,20,20,0,0,0,gene,ZK721.4,0,8778836,0.0453696,12578,8766219,39,8778797,0,-39
X,+,8789394,0.00649819,0.0,2770,2752,18,17,6,gene,ZK721.2,0,8789569,18.6094,2262,8787132,175,8789392,-2,-177
X,+,8789404,0.0,0.25,2,2,0,0,4342,gene,ZK721.2,0,8789569,18.6094,2272,8787132,165,8789392,-12,-177
X,+,8792098,0.0,9.09495e-13,40,40,0,0,0,gene,ZK721.1,0,8792102,0.162543,1540,8790558,4,8792098,0,-4
X,+,8844226,0.0,1.05879e-22,73,73,0,0,0,gene,C28G1.1,0,8844231,0.13384,6428,8837798,5,8844226,0,-5
X,+,8869600,0.0,0.0078125,7,7,0,0,0,gene,C06E2.3,0,8869604,0.0244203,7969,8861631,4,8869563,-37,-41
X,+,8893061,0.0,3.63798e-12,38,38,0,0,0,gene,C13E3.1,0,8893094,0.119018,12717,8880344,33,8893095,34,1
X,+,8907988,0.0,6.16298e-33,107,107,0,0,0,gene,D1009.3,0,8908021,0.175157,9690,8898298,33,8907988,0,-33
X,+,8934494,0.00505051,0.0,198,197,1,1,24,gene,D1009.1,0,8934497,0.96414,19692,8914802,3,8934507,13,10
X,+,8980901,0.0,0.00390625,8,8,0,0,0,gene,C48C5.1,0,8980912,0.0235559,24225,8956676,11,8980913,12,1
X,+,8988073,0.0272109,1.0466e-37,147,143,4,3,0,gene,C24A3.6,1,8988120,0.73133,3219,8984854,47,8988073,0,-47
X,+,8992342,0.0,6.46235e-27,87,87,0,0,1,gene,C24A3.4,2,8992342,0.220144,434,8991908,0,8992343,1,1
X,+,8997436,0.00650406,0.0,1230,1222,8,5,0,gene,C24A3.2,0,8997436,3.01297,2734,8994702,0,8997436,0,0
X,+,9015658,0.0,6.31089e-30,97,97,0,0,0,gene,T25B6.4,0,9015666,0.0848706,9649,9006009,8,9015709,51,43
X,+,9027531,0.0,0.25,2,2,0,0,0,gene,T25B6.3,0,9027539,0.00354558,10838,9016693,8,9027540,9,1
X,+,9029405,0.0,8.88178e-16,50,50,0,0,0,gene,T25B6.7,0,9029413,0.0908019,1184,9028221,8,9029414,9,1
X,+,9057588,0.0,2.32831e-10,32,32,0,0,2,gene,F47E1.2,0,9057595,0.170419,2681,9054907,7,9057588,0,-7
X,+,9062766,0.0,0.015625,6,6,0,0,0,gene,F47E1.4,0,9062779,0.0552508,970,9061796,13,9062770,4,-9
X,+,9062772,0.0,0.125,3,3,0,0,1,gene,F47E1.4,0,9062779,0.0552508,976,9061796,7,9062770,-2,-9
X,+,9082912,0.0,3.72529e-09,28,28,0,0,1,gene,F47E1.5,0,9082917,0.109218,5252,9077660,5,9082918,6,1
X,+,9087514,0.025641,7.09406e-11,39,38,1,1,0,gene,H08J11.2,0,9087531,1.02224,9854,9077660,17,9087511,-3,-20
X,+,9098268,0.0,6.61744e-24,77,77,0,0,1,gene,C25A11.4,0,9098280,2.548,20608,9077660,12,9098281,13,1
X,+,9100186,0.0204082,8.70415e-14,49,48,1,1,0,gene,C25A11.4,0,9100193,2.548,22526,9077660,7,9100186,0,-7
X,+,9103571,0.0,1.73472e-18,59,59,0,0,1,gene,C25A11.4,0,9103696,2.548,25911,9077660,125,9103571,0,-125
X,+,9104603,0.0,4.70198e-38,124,124,0,0,16,gene,C25A11.4,0,9104626,2.548,26943,9077660,23,9104603,0,-23
X,+,9105128,0.0,0.000976562,10,10,0,0,0,gene,C25A11.4,0,9105252,2.548,27468,9077660,124,9105128,0,-124
X,+,9114303,0.015625,0.0,192,189,3,2,0,gene,C25A11.2,0,9114309,0.27313,755,9113548,6,9114303,0,-6
X,+,9119709,0.0,5.55112e-17,54,54,0,0,0,gene,C25A11.1,0,9119748,0.0746982,2885,9116824,39,9119709,0,-39
X,+,9140377,0.0,0.00012207,13,13,0,0,0,gene,B0563.6,0,9140380,0.136558,16909,9123468,3,9140377,0,-3
X,+,9146057,0.0,0.0078125,7,7,0,0,80,gene,B0563.5,0,9146107,0.3934,467,9145590,50,9146050,-7,-57
X,+,9146084,0.00348432,0.0,287,286,1,0,49,gene,B0563.5,0,9146107,0.3934,494,9145590,23,9146050,-34,-57
X,+,9150628,0.00596303,0.0,1677,1667,10,6,0,gene,B0563.4,0,9150641,2.1911,3134,9147494,13,9150628,0,-13
X,+,9163109,0.0178571,7.77156e-16,56,55,1,1,1,gene,B0563.2,0,9163121,0.366848,2527,9160582,12,9163098,-11,-23
X,+,9171456,0.0,0.03125,5,5,0,0,0,gene,B0563.1,0,9171495,0.0314832,2427,9169029,39,9171496,40,1
X,+,9184073,0.0,0.015625,6,6,0,0,0,gene,Y81B9A.2,0,9184096,0,1239,9182834,23,9184097,24,1
X,+,9211077,0.0,0.0,365,365,0,0,1,gene,C35B8.4,0,9211137,0.643772,12253,9198824,60,9210941,-136,-196
X,+,9213857,0.0,0.000244141,12,12,0,0,1,gene,C35B8.3,0,9213913,0.312822,1603,9212254,56,9213914,57,1
X,+,9214261,0.0,0.0,168,168,0,0,1,gene,C35B8.3,0,9214264,0.312822,2007,9212254,3,9214261,0,-3
X,+,9246938,0.0,3.38813e-21,68,68,0,0,6,gene,F18G5.3,0,9246947,0.336007,14256,9232682,9,9246938,0,-9
X,+,9259753,0.0,0.5,1,1,0,0,0,gene,F18G5.1,0,9259774,0.00424189,4048,9255705,21,9259783,30,9
X,+,9278884,0.0,1.32349e-23,76,76,0,0,0,gene,B0416.4,0,9278892,0.179596,17887,9260997,8,9278893,9,1
X,+,9291580,0.0,3.46945e-18,58,58,0,0,1,gene,B0416.3,0,9291610,0.0628378,11702,9279878,30,9291582,2,-28
X,+,9303655,0.0,3.23117e-27,88,88,0,0,2,gene,B0416.1,0,9303712,0.188321,3593,9300062,57,9303655,0,-57
X,+,9336750,0.5,0.5,2,1,1,1,2,gene,T20B5.1,2,9336881,1.3275,187,9336563,131,9336750,0,-131
X,+,9338412,0.0,0.000976562,10,10,0,0,1,gene,T20B5.1,2,9338443,1.3275,1849,9336563,31,9338606,194,163
X,+,9338582,0.0,1.77636e-15,49,49,0,0,8,gene,T20B5.1,2,9338593,1.3275,2019,9336563,11,9338606,24,13
X,+,9338606,0.0,0.0,230,230,0,0,501,gene,T20B5.1,2,9338608,1.3275,2043,9336563,2,9338606,0,-2
X,+,9371061,0.00520833,0.0,192,191,1,0,1,gene,E01H11.1,0,9371086,0.689512,28156,9342905,25,9371061,0,-25
X,+,9391576,0.0333333,2.79397e-08,30,29,1,1,0,gene,C23F12.3,0,9391590,0.0161296,2440,9389136,14,9391576,0,-14
X,+,9397632,0.0,3.8147e-06,18,18,0,0,0,gene,C23F12.2,0,9397682,0.263331,2463,9395169,50,9397632,0,-50
X,+,9412178,0.0,0.000488281,11,11,0,0,0,gene,C23F12.1,0,9412215,1.54049,2304,9409874,37,9412607,429,392
X,+,9428362,0.0298507,5.89618e-34,134,130,4,3,11,gene,B0272.4,0,9428368,1.01937,1185,9427177,6,9428369,7,1
X,+,9431363,0.00109489,0.0,2740,2737,3,3,1,gene,B0272.3,0,9431363,2.78279,1110,9430253,0,9431363,0,0
X,+,9446577,0.00662252,5.32493e-44,151,150,1,1,2,gene,ZK899.1,0,9446594,0.61337,13901,9432676,17,9446595,18,1
X,+,9472400,0.0,0.03125,5,5,0,0,0,gene,ZK899.8,0,9472400,1.12306,7744,9464656,0,9472400,0,0
X,+,9475194,0.0,3.05176e-05,15,15,0,0,0,gene,ZK899.8,0,9475210,1.12306,10538,9464656,16,9475194,0,-16
X,+,9478940,0.0,0.000976562,10,10,0,0,0,gene,ZK899.8,0,9479432,1.12306,14284,9464656,492,9478940,0,-492
X,+,9480579,0.0,0.5,1,1,0,0,0,gene,ZK899.8,0,9480597,1.12306,15923,9464656,18,9480598,19,1
X,+,9487309,0.0,0.03125,5,5,0,0,0,gene,ZK899.8,0,9487327,1.12306,22653,9464656,18,9487311,2,-16
X,+,9501551,0.0,1.90735e-06,19,19,0,0,4,gene,ZK899.8,0,9501578,1.12306,36895,9464656,27,9501551,0,-27
X,+,9510458,0.0,0.0,833,833,0,0,3,gene,ZK899.8,0,9510470,1.12306,45802,9464656,12,9510458,0,-12
X,+,9512746,0.0,0.0625,4,4,0,0,4,gene,ZK899.8,0,9512751,1.12306,48090,9464656,5,9512746,0,-5
X,+,9518954,0.0,0.000976562,10,10,0,0,0,gene,C07B5.6,0,9518954,0.0211858,2581,9516373,0,9518955,1,1
X,+,9529593,0.0,1.45519e-11,36,36,0,0,0,gene,C07B5.4,0,9529658,0.240215,8174,9521419,65,9529593,0,-65
X,+,9531904,0.0,1.81899e-12,39,39,0,0,0,gene,C07B5.4,0,9531937,0.240215,10485,9521419,33,9531904,0,-33
X,+,9539831,0.0,0.000488281,11,11,0,0,1,gene,C07B5.5,0,9539878,3.60741,3201,9536630,47,9539838,7,-40
X,+,9539872,0.00719424,1.99455e-40,139,138,1,1,3494,gene,C07B5.5,0,9539878,3.60741,3242,9536630,6,9539838,-34,-40
X,+,9543603,0.00961538,5.1276e-30,104,103,1,1,7,gene,F49E2.5,0,9543977,2.15533,1372,9542231,374,9543603,0,-374
X,+,9552774,0.00788955,0.0,507,503,4,4,0,gene,F49E2.5,0,9552823,2.15533,10543,9542231,49,9552774,0,-49
X,+,9569312,0.00414938,0.0,241,240,1,1,0,gene,F49E2.2,0,9569340,0.754418,2350,9566962,28,9569312,0,-28
X,+,9584609,0.0,0.0625,4,4,0,0,357,gene,C11E4.1,0,9584627,2.87867,10943,9573666,18,9584605,-4,-22
X,+,9610496,0.0,1.73472e-18,59,59,0,0,2,gene,C11E4.6,0,9610503,0.332749,14876,9595620,7,9610496,0,-7
X,+,9616795,0.0,0.5,1,1,0,0,79,gene,C11E4.7,0,9616938,0.145343,21175,9595620,143,9617180,385,242
X,+,9623237,0.0,0.0078125,7,7,0,0,0,gene,C11E4.8,0,9623270,0.0257662,4129,9619108,33,9623237,0,-33
X,+,9630336,0.0,3.46945e-18,58,58,0,0,0,gene,F34H10.2,0,9630355,0.140465,3554,9626782,19,9630356,20,1
X,+,9630354,0.0,0.015625,6,6,0,0,72,gene,F34H10.2,0,9630355,0.140465,3572,9626782,1,9630356,2,1
X,+,9648463,0.0,1.52588e-05,16,16,0,0,1,gene,F34H10.4,0,9648464,0.024101,11639,9636824,1,9648465,2,1
X,+,9698597,0.0,0.03125,5,5,0,0,2,gene,C43C3.3,0,9698611,0.354127,1945,9696652,14,9698610,13,-1
X,+,9707294,0.0,0.0,806,806,0,0,4,gene,F15G9.1,0,9707298,2.72857,5639,9701655,4,9707299,5,1
X,+,9707297,0.0,0.0625,4,4,0,0,4,gene,F15G9.1,0,9707298,2.72857,5642,9701655,1,9707299,2,1
X,+,9709706,0.0,0.000488281,11,11,0,0,9,gene,F15G9.6,0,9709744,0.0501332,1211,9708495,38,9709689,-17,-55
X,+,9717503,0.0,8.47033e-22,70,70,0,0,0,gene,F15G9.4,0,9717557,0.269864,4465,9713038,54,9717558,55,1
X,+,9757203,0.0,9.86076e-32,103,103,0,0,0,gene,T09B9.1,0,9757248,0.27771,3510,9753693,45,9757203,0,-45
X,+,9798773,0.0,4.65661e-10,31,31,0,0,5,gene,F36G3.3,0,9798881,0.16425,18570,9780203,108,9798767,-6,-114
X,+,9847209,0.0,6.77626e-21,67,67,0,0,0,gene,R07B1.1,0,9847222,0.185216,46191,9801018,13,9847209,0,-13
X,+,9856852,0.0,1.81899e-12,39,39,0,0,0,gene,R07B1.11,0,9856852,0.166815,3929,9852923,0,9856850,-2,-2
X,+,9863871,0.0,0.5,1,1,0,0,5,gene,R07B1.5,1,9863915,0.0665196,2221,9861650,44,9864001,130,86
X,+,9864018,0.0,0.0078125,7,7,0,0,3,gene,R07B1.5,1,9864064,0.0665196,29,9863989,46,9864001,-17,-63
X,+,9864750,0.0,0.25,2,2,0,0,1,gene,R07B1.5,1,9864777,0.0665196,761,9863989,27,9864750,0,-27
X,+,9865010,0.0,0.03125,5,5,0,0,13,gene,R07B1.5,1,9865018,0.0665196,1021,9863989,8,9864750,-260,-268
X,+,9866594,0.873418,2.38341e-12,79,10,69,16,1,gene,R07B1.6,2,9866598,0.131244,106,9866488,4,9866599,5,1
X,+,9869758,0.736842,0.0221786,19,5,14,7,7,gene,R07B1.13,4,9869787,None,171,9869587,29,9869788,30,1
X,+,9869770,0.932692,0.0,312,21,291,128,62,gene,R07B1.13,4,9869787,None,183,9869587,17,9869788,18,1
X,+,9877349,0.0,0.000976562,10,10,0,0,0,gene,R07B1.9,0,9877410,0.189428,6615,9870734,61,9877406,57,-4
X,+,9884212,0.00877193,0.0,228,226,2,2,0,gene,F21G4.2,0,9884254,0.788234,2779,9881433,42,9884210,-2,-44
X,+,9895076,0.0,2.98023e-08,25,25,0,0,0,gene,F21G4.3,0,9895116,0.0153817,5440,9889636,40,9895076,0,-40
X,+,9906078,0.0,1.19209e-07,23,23,0,0,0,gene,F21G4.5,0,9906087,0.0614622,9089,9896989,9,9906088,10,1
X,+,9919232,0.0,0.0625,4,4,0,0,3,gene,C17G1.1,0,9919233,0.0241233,11298,9907934,1,9919234,2,1
X,+,9921489,0.0,3.23117e-27,88,88,0,0,33,gene,C17G1.2,0,9921489,0.259983,1024,9920465,0,9921490,1,1
X,+,9933179,0.0,0.0,293,293,0,0,1,gene,C17G1.8,0,9933186,0.468678,10404,9922775,7,9933179,0,-7
X,+,9941666,0.0,0.000244141,12,12,0,0,126,gene,C17G1.5,0,9941691,0.388591,1705,9939961,25,9941562,-104,-129
X,+,9958894,0.0110497,0.0,181,179,2,2,3,gene,ZC506.1,1,9958912,0.687074,14173,9944721,18,9958894,0,-18
X,+,9965521,0.285714,0.164062,7,5,2,0,3,gene,ZC506.3,2,9965530,0.827623,842,9964679,9,9965531,10,1
X,+,9965524,0.244048,6.69928e-12,168,127,41,28,7,gene,ZC506.3,2,9965530,0.827623,845,9964679,6,9965524,0,-6
X,+,9965531,0.48062,0.0636847,129,67,62,34,92,gene,ZC506.3,2,9965563,0.827623,852,9964679,32,9965531,0,-32
X,+,10000867,0.0258065,5.06439e-40,155,151,4,3,0,gene,F19C6.2,0,10000870,0.477191,2912,9997955,3,10000871,4,1
X,+,10027788,0.0151515,1.58802e-36,132,130,2,1,0,gene,F42G10.2,0,10027792,0.351197,22466,10005322,4,10027788,0,-4
X,+,10031081,0.0,3.05176e-05,15,15,0,0,48,gene,VZC374L.1,0,10031083,0.0799696,861,10030220,2,10031084,3,1
X,+,10054213,0.0,2.40741e-35,115,115,0,0,0,gene,ZC373.1,0,10054235,0.866478,1708,10052505,22,10054213,0,-22
X,+,10075354,0.0,9.53674e-07,20,20,0,0,56,gene,ZC373.6,0,10075422,0.93334,13730,10061624,68,10075219,-135,-203
X,+,10084559,0.0,0.0,508,508,0,0,0,gene,W07E11.1,0,10084597,0.919962,5891,10078668,38,10084598,39,1
X,+,10154754,0.0,1.2326e-32,106,106,0,0,0,gene,F09B9.5,0,10154786,0.124672,1683,10153071,32,10154754,0,-32
X,+,10160564,0.00555556,0.0,360,358,2,2,0,gene,F09B9.4,0,10160569,2.25145,3777,10156787,5,10160562,-2,-7
X,+,10174918,0.0,0.000244141,12,12,0,0,0,gene,C07A4.3,0,10174961,0.045825,830,10174088,43,10174962,44,1
X,+,10177161,0.0,0.00390625,8,8,0,0,3,gene,F21A10.1,0,10177167,0.159505,1385,10175776,6,10177168,7,1
X,+,10197636,0.0020284,0.0,1479,1476,3,3,0,gene,F44A6.1,0,10197638,1.61777,11478,10186158,2,10197636,0,-2
X,+,10212701,0.0,0.0078125,7,7,0,0,1,gene,F44A6.3,0,10212725,0.0486395,12369,10200332,24,10212701,0,-24
X,+,10273819,0.0,4.44089e-16,51,51,0,0,2,gene,F41E7.2,0,10273831,0.207647,59683,10214136,12,10273819,0,-12
X,+,10279530,0.0,3.76158e-37,121,121,0,0,0,gene,F41E7.1,0,10279563,0.25003,1302,10278228,33,10279530,0,-33
X,+,10311406,0.00247525,0.0,1616,1612,4,2,0,gene,F41E7.7,0,10311406,2.67295,4505,10306901,0,10311407,1,1
X,+,10317797,0.0,5.55112e-17,54,54,0,0,2,gene,R07E3.6,0,10317810,0.516346,5683,10312114,13,10317652,-145,-158
X,+,10397173,0.00754717,0.0,265,263,2,1,0,gene,F46F6.2,0,10397325,1.04409,36693,10360480,152,10397173,0,-152
X,+,10412655,0.0,1.46937e-39,129,129,0,0,0,gene,ZC504.2,0,10412754,0.120682,2919,10409736,99,10412693,38,-61
X,+,10412693,0.0,9.31323e-10,30,30,0,0,39,gene,ZC504.2,0,10412754,0.120682,2957,10409736,61,10412693,0,-61
X,+,10444073,0.0,8.07794e-28,90,90,0,0,0,gene,C39B10.3,0,10444098,0.0758718,27488,10416585,25,10444099,26,1
X,+,10447279,0.0,0.00012207,13,13,0,0,0,gene,C39B10.5,0,10447280,0.0656932,1910,10445369,1,10447281,2,1
X,+,10454198,0.0588235,0.0001297,17,16,1,0,0,gene,C39B10.2,0,10454238,0.0264241,6433,10447765,40,10454239,41,1
X,+,10475456,0.0,1.16415e-10,33,33,0,0,16,gene,C39B10.6,0,10475456,0.165648,15030,10460426,0,10475456,0,0
X,+,10475476,0.0,3.55271e-15,48,48,0,0,113,gene,C39B10.6,0,10475500,0.165648,15050,10460426,24,10475456,-20,-44
X,+,10476799,0.333333,0.375,3,2,1,0,2,gene,C39B10.7,0,10476869,None,927,10475872,70,10476990,191,121
X,+,10481169,0.0,0.0,270,270,0,0,5,gene,C33D3.1,0,10481169,0.444327,3350,10477819,0,10481167,-2,-2
X,+,10491266,0.0,0.25,2,2,0,0,0,gene,C33D3.5,0,10491272,0.00114637,1498,10489768,6,10491273,7,1
X,+,10505830,0.0,7.45058e-09,27,27,0,0,0,gene,F14F3.1,0,10505879,0.740368,8638,10497192,49,10505916,86,37
X,+,10524826,0.0052356,0.0,191,190,1,0,8,gene,F14F3.2,0,10524845,0.520733,2747,10522079,19,10524826,0,-19
X,+,10533698,0.0,0.000488281,11,11,0,0,5,gene,F59F5.2,0,10533712,0.190208,1489,10532209,14,10533713,15,1
X,+,10545950,0.0,2.38419e-07,22,22,0,0,4,gene,F59F5.5,0,10545953,0.0551686,2612,10543338,3,10545990,40,37
X,+,10569201,0.00835073,0.0,479,475,4,2,0,gene,F57C7.1,0,10569267,1.1848,2513,10566688,66,10569201,0,-66
X,+,10576888,0.0042735,0.0,234,233,1,1,1,gene,F57C7.2,0,10576974,0.412976,1242,10575646,86,10576888,0,-86
X,+,10604490,0.0,0.0625,4,4,0,0,4,gene,M79.4,0,10604752,2.06701,23526,10580964,262,10604738,248,-14
X,+,10604648,0.0,5.55112e-17,54,54,0,0,46,gene,M79.4,0,10604752,2.06701,23684,10580964,104,10604738,90,-14
X,+,10644336,0.0,5.29396e-23,74,74,0,0,0,gene,F11A1.3,0,10644366,0.829106,38581,10605755,30,10644334,-2,-32
X,+,10659267,0.0,1.83671e-40,132,132,0,0,1,gene,F11A1.3,0,10659284,0.829106,53512,10605755,17,10659267,0,-17
X,+,10660724,0.0,0.000488281,11,11,0,0,3,gene,F11A1.3,0,10660729,0.829106,54969,10605755,5,10660724,0,-5
X,+,10664333,0.0,0.000488281,11,11,0,0,0,gene,F11A1.3,0,10664345,0.829106,58578,10605755,12,10664333,0,-12
X,+,10691869,0.00275482,0.0,363,362,1,1,1,gene,F13E6.4,0,10691873,1.33369,9014,10682855,4,10691869,0,-4
X,+,10695226,0.0,0.125,3,3,0,0,0,gene,F13E6.5,0,10695244,0.717071,200,10695026,18,10695234,8,-10
X,+,10695238,0.0258621,3.05091e-30,116,113,3,2,6,gene,F13E6.5,0,10695244,0.717071,212,10695026,6,10695234,-4,-10
X,+,10734235,0.0,0.0078125,7,7,0,0,0,gene,R07A4.1,0,10734243,0.0678293,7504,10726731,8,10734251,16,8
X,+,10754830,0.0,0.015625,6,6,0,0,0,gene,R07A4.3,0,10754841,0.0798209,10550,10744280,11,10754842,12,1
X,+,10769213,0.0,9.86076e-32,103,103,0,0,0,gene,T05A10.1,0,10769218,1.39018,11136,10758077,5,10769213,0,-5
X,+,10773007,0.0,1.73472e-18,59,59,0,0,0,gene,T05A10.1,0,10773015,1.39018,3628,10769379,8,10773016,9,1
X,+,10804668,0.0,5.82077e-11,34,34,0,0,2,gene,F31B12.4,0,10804850,0.0719136,15026,10789642,182,10804851,183,1
X,+,10882110,0.0,0.25,2,2,0,0,0,gene,T21E8.6,0,10882208,None,748,10881362,98,10882209,99,1
X,+,10882308,0.0,0.03125,5,5,0,0,6,gene,T21E8.6,0,10882328,None,946,10881362,20,10882209,-99,-119
X,+,10903203,0.00159617,0.0,1253,1251,2,2,9,gene,F47B10.7,0,10903205,3.31587,9602,10893601,2,10903203,0,-2
X,+,10954058,0.0,0.0,169,169,0,0,0,gene,K09C8.1,0,10954121,0.456331,49053,10905005,63,10954058,0,-63
X,+,10958657,0.0153846,6.16033e-36,130,128,2,2,2,gene,K09C8.6,0,10958684,0.167142,499,10958158,27,10958685,28,1
X,+,10966480,0.0,7.62939e-06,17,17,0,0,1,gene,K09C8.4,0,10966481,0.0289834,5619,10960861,1,10966478,-2,-3
X,+,10982305,0.0,1.19209e-07,23,23,0,0,0,gene,F59F3.5,0,10982310,0.0307026,10210,10972095,5,10982303,-2,-7
X,+,10992409,0.00728597,0.0,549,545,4,3,0,gene,F59F3.1,0,10992419,0.443709,4214,10988195,10,10992434,25,15
X,+,11012568,0.0,5.55112e-17,54,54,0,0,1,gene,F58A3.3,0,11012585,0.0589849,14799,10997769,17,11012586,18,1
X,+,11016334,0.0,2.01948e-28,92,92,0,0,0,gene,F58A3.2,0,11016341,0.280482,1958,11014376,7,11016334,0,-7
X,+,11028878,0.0096463,0.0,311,308,3,2,0,gene,F58A3.1,0,11029004,2.07763,5557,11023321,126,11028878,0,-126
X,+,11029623,0.0,0.5,1,1,0,0,0,gene,F58A3.1,0,11029635,2.07763,6302,11023321,12,11029623,0,-12
X,+,11036931,0.0,9.53674e-07,20,20,0,0,17,gene,F58A3.1,0,11036985,2.07763,13610,11023321,54,11036978,47,-7
X,+,11036978,0.0,0.0,314,314,0,0,9,gene,F58A3.1,0,11036985,2.07763,13657,11023321,7,11036978,0,-7
X,+,11048160,0.00327869,0.0,305,304,1,1,0,gene,C09F12.1,0,11048166,1.7493,7624,11040536,6,11048160,0,-6
X,+,11062025,0.0,1.52588e-05,16,16,0,0,1,gene,W04G3.2,0,11062179,1.86459,235,11061790,154,11062056,31,-123
X,+,11073582,0.00236967,0.0,422,421,1,1,0,gene,W04G3.5,0,11073587,2.11319,1715,11071867,5,11073582,0,-5
X,+,11080602,0.0,5.96046e-08,24,24,0,0,3,gene,W04G3.6,0,11080603,0.161292,4576,11076026,1,11080602,0,-1
X,+,11080786,0.0,0.5,1,1,0,0,1,gene,W04G3.6,0,11080787,0.161292,4760,11076026,1,11080786,0,-1
X,+,11089169,0.0,0.125,3,3,0,0,5,gene,W04G3.11,0,11089171,0.0252656,1784,11087385,2,11089140,-29,-31
X,+,11152989,0.0,0.015625,6,6,0,0,0,gene,C05C9.2,0,11152989,0.0134447,37178,11115811,0,11152989,0,0
X,+,11160758,0.0,0.015625,6,6,0,0,3,gene,C05C9.1,0,11160904,0.0894179,3191,11157567,146,11160905,147,1
X,+,11160845,0.0,9.53674e-07,20,20,0,0,1,gene,C05C9.1,0,11160904,0.0894179,3278,11157567,59,11160905,60,1
X,+,11185734,0.0,0.125,3,3,0,0,0,gene,F13D2.3,0,11185736,0.0230236,4537,11181197,2,11185737,3,1
X,+,11215925,0.00352941,0.0,850,847,3,3,2,gene,C34F6.8,0,11215930,1.1727,43,11215882,5,11215925,0,-5
X,+,11262773,0.025,1.79913e-41,160,156,4,3,0,gene,C03A3.2,0,11262780,1.02856,2747,11260026,7,11262773,0,-7
X,+,11271110,0.0,0.0,181,181,0,0,0,gene,F38B2.1,0,11271173,1.58482,4841,11266269,63,11271110,0,-63
X,+,11273196,0.0027933,0.0,358,357,1,1,11,gene,F38B2.1,0,11273197,1.58482,6927,11266269,1,11273196,0,-1
X,+,11300189,0.0,4.81482e-35,114,114,0,0,2,gene,F08G12.3,0,11300229,0.124929,24781,11275408,40,11300179,-10,-50
X,+,11307288,0.00921659,0.0,217,215,2,2,0,gene,F08G12.4,0,11307294,0.291395,5196,11302092,6,11307293,5,-1
X,+,11318204,0.037037,2.01166e-07,27,26,1,1,0,gene,ZK455.6,0,11318217,0.0739977,254,11317950,13,11318204,0,-13
X,+,11339800,0.00172414,0.0,1160,1158,2,1,6,gene,ZK455.1,0,11339801,3.93032,8032,11331768,1,11339800,0,-1
X,+,11346381,0.0222222,1.27898e-12,45,44,1,1,0,gene,ZK455.8,0,11346381,0.211922,3143,11343238,0,11346381,0,0
X,+,11352082,0.0,7.45058e-09,27,27,0,0,0,gene,ZK455.7,0,11352087,0.155169,1916,11350166,5,11352082,0,-5
X,+,11359079,0.0,0.25,2,2,0,0,0,gene,F42E11.1,0,11359093,0.102933,2062,11357017,14,11359079,0,-14
X,+,11368645,0.00541272,0.0,739,735,4,2,1,gene,F42E11.2,0,11368653,1.88046,4677,11363968,8,11368645,0,-8
X,+,11385010,0.0,7.88861e-31,100,100,0,0,18,gene,F08B12.1,0,11385016,0.469096,10729,11374281,6,11385041,31,25
X,+,11393221,0.0,0.0,256,256,0,0,3,gene,F08B12.2,0,11393226,0.300544,517,11392704,5,11393227,6,1
X,+,11468410,0.0,5.68434e-14,44,44,0,0,1,gene,T25C12.1,0,11468423,1.04253,48403,11420007,13,11468424,14,1
X,+,11487714,0.0,1.13687e-13,43,43,0,0,2,gene,T25C12.2,0,11487719,0.0900448,1923,11485791,5,11487720,6,1
X,+,11490048,0.0,2.38419e-07,22,22,0,0,1,gene,T25C12.4,0,11490053,0.0271446,1935,11488113,5,11490054,6,1
X,+,11522636,0.0,3.55271e-15,48,48,0,0,0,gene,C35C5.1,0,11522661,0.212157,13279,11509357,25,11522636,0,-25
X,+,11536754,0.0,0.0625,4,4,0,0,2,gene,C35C5.9,0,11536775,8.48897,174,11536580,21,11536650,-104,-125
X,+,11548531,0.012987,0.0,308,304,4,4,0,gene,C35C5.4,0,11548556,1.25244,3547,11544984,25,11548531,0,-25
X,+,11556246,0.0,1.52588e-05,16,16,0,0,52,gene,C35C5.10,0,11556266,0.871395,5626,11550620,20,11556278,32,12
X,+,11557452,0.0,3.00927e-36,118,118,0,0,4,gene,C35C5.10,0,11557452,0.871395,6832,11550620,0,11557452,0,0
X,+,11560838,0.0,3.72529e-09,28,28,0,0,2,gene,C35C5.5,0,11560851,0.130928,1045,11559793,13,11560838,0,-13
X,+,11563911,0.0,9.62965e-35,113,113,0,0,12,gene,C35C5.6,0,11563941,0.257372,283,11563628,30,11563896,-15,-45
X,+,11576171,0.05,1.90735e-05,20,19,1,1,0,gene,H05G16.1,0,11576177,0.237946,6495,11569676,6,11576178,7,1
X,+,11585597,0.0,0.00195312,9,9,0,0,0,gene,F52D10.1,0,11585601,0.106997,549,11585048,4,11585597,0,-4
X,+,11617394,0.0,0.0625,4,4,0,0,0,gene,F52D10.4,0,11617431,0.0274577,27690,11589704,37,11617384,-10,-47
X,+,11632329,0.125,0.00183105,16,14,2,2,2,gene,Y71H9A.2,0,11632341,0.128047,12560,11619769,12,11632329,0,-12
X,+,11644301,0.00371747,0.0,538,536,2,1,1,gene,Y71H9A.3,0,11644321,0.858914,7849,11636452,20,11644301,0,-20
X,+,11667050,0.0,8.27181e-25,80,80,0,0,0,gene,T04F8.6,0,11667062,0.430547,7757,11659293,12,11667081,31,19
X,+,11674322,0.0,0.125,3,3,0,0,3,gene,T04F8.9,0,11674383,0.203821,2087,11672235,61,11674384,62,1
X,+,11674364,0.0,2.27374e-13,42,42,0,0,3,gene,T04F8.9,0,11674383,0.203821,2129,11672235,19,11674384,20,1
X,+,11693385,0.00549451,0.0,182,181,1,1,0,gene,C44C10.4,0,11693386,0.175574,472,11692913,1,11693387,2,1
X,+,11746000,0.0,0.000488281,11,11,0,0,0,gene,C40H5.7,0,11746029,0.0136011,6924,11739076,29,11746038,38,9
X,+,11746013,0.0,0.5,1,1,0,0,36,gene,C40H5.7,0,11746029,0.0136011,6937,11739076,16,11746038,25,9
X,+,11775110,0.0,0.0625,4,4,0,0,0,gene,C40H5.6,0,11775111,None,10944,11764166,1,11775112,2,1
X,+,11798426,0.00455581,0.0,439,437,2,2,1,gene,C34E11.1,0,11798448,1.26571,22560,11775866,22,11798426,0,-22
X,+,11824095,0.0,1.81899e-12,39,39,0,0,0,gene,C34E11.7,0,11824104,None,18885,11805210,9,11824105,10,1
X,+,11826004,0.0,0.25,2,2,0,0,0,gene,C34E11.3,0,11826013,0.322772,1648,11824356,9,11825947,-57,-66
X,+,11843584,0.00746269,6.15298e-39,134,133,1,1,0,gene,F54F7.2,0,11843586,0.188839,7536,11836048,2,11843587,3,1
X,+,11857334,0.0,0.25,2,2,0,0,2,gene,F54F7.5,0,11857351,0.117849,3683,11853651,17,11857416,82,65
X,+,11857402,0.0,4.44089e-16,51,51,0,0,3,gene,F54F7.5,0,11857414,0.117849,3751,11853651,12,11857416,14,2
X,+,11865305,0.00666667,0.0,300,298,2,2,1,gene,F54F7.6,0,11865307,0.102683,610,11864695,2,11865464,159,157
X,+,11914046,0.0,0.000488281,11,11,0,0,0,gene,Y62H9A.12,0,11914077,0.0385266,30099,11883947,31,11914078,32,1
X,+,11924362,0.0,0.00012207,13,13,0,0,0,gene,F55G7.1,0,11924382,0.0182035,1270,11923092,20,11924383,21,1
X,+,11948767,0.0,2.58494e-26,85,85,0,0,0,gene,T08D10.2,0,11948774,0.196608,19845,11928922,7,11948774,7,0
X,+,11955363,0.0,1.52588e-05,16,16,0,0,1,gene,T08D10.3,0,11955374,0.0114637,3501,11951862,11,11955363,0,-11
X,+,11988236,0.0,3.46945e-18,58,58,0,0,0,gene,C49F5.6,0,11988289,0.265859,963,11987273,53,11988236,0,-53
X,+,11994710,0.0,0.25,2,2,0,0,45,gene,C49F5.7,0,11994770,6.21486,3496,11991214,60,11994706,-4,-64
X,+,12018351,0.00314795,0.0,953,950,3,2,1,gene,VW06B3R.1,0,12018360,5.74832,22607,11995744,9,12018351,0,-9
X,+,12028635,0.0,5.82077e-11,34,34,0,0,0,gene,B0198.2,0,12028724,0.0872031,7503,12021132,89,12028633,-2,-91
X,+,12105062,0.000425351,0.0,4702,4700,2,0,25,gene,W03G11.1,0,12105067,12.2019,34577,12070485,5,12105062,0,-5
X,+,12146754,0.0,0.0,238,238,0,0,1,gene,M153.1,0,12146766,0.885049,874,12145880,12,12146739,-15,-27
X,+,12217165,0.0,1.11022e-16,53,53,0,0,2,gene,C23H4.8,0,12217178,0.0994632,66204,12150961,13,12217165,0,-13
X,+,12222997,0.0,0.5,1,1,0,0,17,gene,C23H4.7,0,12223005,0.177227,344,12222653,8,12222841,-156,-164
X,+,12235538,0.0,1.52588e-05,16,16,0,0,1,gene,C23H4.6,0,12235542,0.0684031,2527,12233011,4,12235543,5,1
X,+,12256566,0.016129,1.34441e-17,62,61,1,1,2,gene,E01G6.2,0,12256572,0.393323,12035,12244531,6,12256566,0,-6
X,+,12260803,0.0,8.27181e-25,80,80,0,0,0,gene,E01G6.1,0,12260805,0.212483,1918,12258885,2,12260806,3,1
X,+,12283209,0.0,0.0,233,233,0,0,1,gene,C04B4.2,0,12283242,0.346009,732,12282477,33,12283223,14,-19
X,+,12298605,0.0,2.93874e-39,128,128,0,0,1,gene,W06D11.3,0,12298612,0.270424,3138,12295467,7,12298613,8,1
X,+,12306746,0.0,0.125,3,3,0,0,0,gene,F17A2.3,0,12306854,0.00474426,6775,12299971,108,12306917,171,63
X,+,12321581,0.0,1.17549e-38,126,126,0,0,0,gene,F17A2.13,0,12321587,0.181223,3986,12317595,6,12321588,7,1
X,+,12350502,0.0,0.0,333,333,0,0,3,gene,F42F12.3,0,12350509,0.6592,1472,12349030,7,12350510,8,1
X,+,12365610,0.0,0.0,432,432,0,0,0,gene,F19H6.4,0,12365630,0.554066,2572,12363038,20,12365610,0,-20
X,+,12394187,0.0,3.67342e-40,131,131,0,0,1,gene,F17E5.2,0,12394236,0.321689,27011,12367176,49,12394187,0,-49
X,+,12425866,0.0,0.0,185,185,0,0,31,gene,T24D3.2,0,12425905,0.756491,26454,12399412,39,12425866,0,-39
X,+,12437382,0.0,2.58494e-26,85,85,0,0,3,gene,T18D3.8,0,12437405,0.242851,6326,12431056,23,12437406,24,1
X,+,12440640,0.0,4.1359e-25,81,81,0,0,0,gene,T18D3.7,0,12440682,0.373321,9584,12431056,42,12440683,43,1
X,+,12449820,0.0208333,1.7053e-13,48,47,1,1,0,gene,T18D3.6,0,12449838,0.32611,5986,12443834,18,12449839,19,1
X,+,12454667,0.00271003,0.0,369,368,1,1,0,gene,T18D3.1,0,12454686,0.495133,3369,12451298,19,12454667,0,-19
X,+,12468063,0.0,0.5,1,1,0,0,59,gene,T18D3.4,0,12468070,1.40441,3763,12464300,7,12467983,-80,-87
X,+,12480870,0.045045,4.93672e-26,111,106,5,4,0,gene,F45E6.2,1,12480891,0.496043,5600,12475270,21,12480870,0,-21
X,+,12484975,0.694915,0.00112327,59,18,41,21,1,gene,F45E6.3,2,12484975,0.252496,153,12484822,0,12484976,1,1
X,+,12602801,0.0,0.015625,6,6,0,0,0,gene,T24D5.6,0,12602817,0.0314446,5443,12597358,16,12602950,149,133
X,+,12619387,0.1875,0.00854492,16,13,3,2,1,gene,R09A8.2,0,12619393,0.0736078,1144,12618243,6,12619394,7,1
X,+,12678750,0.0,3.8147e-06,18,18,0,0,0,gene,C02B4.1,0,12679041,0.14378,27343,12651407,291,12678750,0,-291
X,+,12712572,0.0,1.19209e-07,23,23,0,0,0,gene,F16H9.1,0,12712579,0.399238,16977,12695595,7,12712572,0,-7
X,+,12731729,0.0,0.000244141,12,12,0,0,0,gene,F22E10.1,0,12731769,0.0292809,3420,12728309,40,12731770,41,1
X,+,12761998,0.00374532,0.0,267,266,1,0,1,gene,F22E10.5,0,12762004,0.583554,3391,12758607,6,12762005,7,1
X,+,12782316,0.00306748,0.0,652,650,2,2,2,gene,T22H6.2,0,12782330,1.32477,16470,12765846,14,12782316,0,-14
X,+,12794200,0.0,0.25,2,2,0,0,64,gene,T22H6.7,0,12794206,0.823295,894,12793306,6,12794097,-103,-109
X,+,12857928,0.0,0.000244141,12,12,0,0,2,gene,T14G8.2,0,12857938,0.0374161,12623,12845305,10,12857939,11,1
X,+,12861157,0.0169492,0.0,236,232,4,3,0,gene,T14G8.3,0,12861157,1.32174,1623,12859534,0,12861157,0,0
X,+,12877400,0.00210438,0.0,2376,2371,5,3,1,gene,K02A4.1,0,12877413,3.64105,7455,12869945,13,12877400,0,-13
X,+,12907752,0.0208333,5.75553e-26,96,94,2,0,8,gene,C34E7.1,0,12907840,1.49602,27505,12880247,88,12907752,0,-88
X,+,12913234,0.0,2.27374e-13,42,42,0,0,0,gene,C34E7.1,0,12913242,1.49602,1767,12911467,8,12913234,0,-8
X,+,12930188,0.0,1.16415e-10,33,33,0,0,0,gene,C34E7.3,0,12930190,0.122441,10009,12920179,2,12930256,68,66
X,+,12965385,0.0,2.98023e-08,25,25,0,0,0,gene,C05E7.4,0,12965391,0.0192485,33196,12932189,6,12965405,20,14
X,+,12981880,0.0,0.5,1,1,0,0,17,gene,F11C1.3,0,12981959,0.267564,2052,12979828,79,12981735,-145,-224
X,+,12990974,0.0,0.5,1,1,0,0,0,gene,F11C1.5,2,12991084,0.922084,5185,12985789,110,12991367,393,283
X,+,12991385,0.0,0.5,1,1,0,0,1,gene,F11C1.5,2,12991418,0.922084,88,12991297,33,12991409,24,-9
X,+,12991396,0.201794,2.48527e-20,223,178,45,25,1,gene,F11C1.5,2,12991418,0.922084,99,12991297,22,12991396,0,-22
X,+,12991409,0.888889,0.000583649,18,2,16,11,1087,gene,F11C1.5,2,12991418,0.922084,112,12991297,9,12991409,0,-9
X,+,13008414,0.0,1.86265e-09,29,29,0,0,0,gene,F11C1.6,0,13008511,0.724864,8856,12999558,97,13008414,0,-97
X,+,13008807,0.0,5.42101e-20,64,64,0,0,2,gene,F11C1.6,0,13008812,0.724864,9249,12999558,5,13008807,0,-5
X,+,13009187,0.0,1.81899e-12,39,39,0,0,1,gene,F11C1.6,0,13009233,0.724864,9629,12999558,46,13009187,0,-46
X,+,13051633,0.0,1.52588e-05,16,16,0,0,1,gene,K03A11.1,0,13051648,0.0989997,2734,13048899,15,13051717,84,69
X,+,13064115,0.0,2.58494e-26,85,85,0,0,7,gene,K03A11.5,0,13064179,0.274049,5691,13058424,64,13064203,88,24
X,+,13078123,0.0,0.015625,6,6,0,0,0,gene,K03A11.4,0,13078125,0.0110108,2110,13076013,2,13078093,-30,-32
X,+,13091037,0.0,8.67362e-19,60,60,0,0,1,gene,R03G8.3,0,13091051,0.115984,3694,13087343,14,13091052,15,1
X,+,13105162,0.00584795,0.0,342,340,2,2,58,gene,F17H10.1,0,13105199,0.55807,10820,13094342,37,13105162,0,-37
X,+,13113650,0.0,0.000488281,11,11,0,0,7,gene,F17H10.2,0,13113856,2.35381,5186,13108464,206,13113857,207,1
X,+,13113855,0.0,0.5,1,1,0,0,1618,gene,F17H10.2,0,13113856,2.35381,5391,13108464,1,13113857,2,1
X,+,13114078,0.0,0.0,172,172,0,0,0,gene,F17H10.2,0,13114085,2.35381,5614,13108464,7,13114086,8,1
X,+,13114084,0.0,0.0,1091,1091,0,0,65,gene,F17H10.2,0,13114085,2.35381,5620,13108464,1,13114086,2,1
X,+,13130175,0.0,5.68434e-14,44,44,0,0,2,gene,F09A5.1,0,13130182,0.151474,13897,13116278,7,13130183,8,1
X,+,13135009,0.0,0.5,1,1,0,0,0,gene,F09A5.2,0,13135026,0.0378607,968,13134041,17,13135027,18,1
X,+,13191139,0.0,0.03125,5,5,0,0,1,gene,F48C11.1,0,13191153,0.0264007,36797,13154342,14,13191167,28,14
X,+,13212311,0.00925926,3.32801e-31,108,107,1,1,1,gene,R12H7.1,0,13212342,0.661279,18314,13193997,31,13212311,0,-31
X,+,13237325,0.0,0.0,224,224,0,0,2,gene,K08H2.3,0,13237339,0.113085,18473,13218852,14,13237343,18,4
X,+,13245333,0.0,1.29247e-26,86,86,0,0,35,gene,K08H2.6,0,13245348,0.420182,5340,13239993,15,13245311,-22,-37
X,+,13251885,0.0,0.0,258,258,0,0,0,gene,K08H2.8,0,13251896,0.4172,5016,13246869,11,13251885,0,-11
X,+,13259170,0.0,7.62939e-06,17,17,0,0,0,gene,K08H2.10,0,13259172,None,2934,13256236,2,13259173,3,1
X,+,13262418,0.00462963,0.0,216,215,1,1,0,gene,K09A11.1,0,13262420,0.177234,1561,13260857,2,13262421,3,1
X,+,13322884,0.0,0.0,283,283,0,0,0,gene,F46G10.2,1,13323069,0.31615,10638,13312246,185,13323048,164,-21
X,+,13328252,0.0,0.125,3,3,0,0,33,gene,F46G10.7,2,13328270,0.462397,506,13327746,18,13328179,-73,-91
X,+,13329183,0.140625,1.49298e-09,64,55,9,2,1,gene,F46G10.7,2,13329184,0.462397,1437,13327746,1,13329183,0,-1
X,+,13331605,0.0,0.5,1,1,0,0,2,gene,F46G10.3,0,13331771,0.0305568,436,13331169,166,13331937,332,166
X,+,13331935,0.0,0.03125,5,5,0,0,0,gene,F46G10.3,0,13331936,0.0305568,766,13331169,1,13331937,2,1
X,+,13341998,0.0,5.68434e-14,44,44,0,0,3,gene,F46G10.5,0,13342101,0.5987,5331,13336667,103,13342102,104,1
X,+,13342102,0.0,7.17465e-43,140,140,0,0,26,gene,F46G10.5,0,13342154,0.5987,5435,13336667,52,13342102,0,-52
X,+,13396903,0.0,7.62939e-06,17,17,0,0,0,gene,F02C12.3,0,13396903,0.039115,48864,13348039,0,13396948,45,45
X,+,13402006,0.0,1.03398e-25,83,83,0,0,0,gene,F02C12.1,0,13402013,0.185742,4312,13397694,7,13402014,8,1
X,+,13416000,0.00341297,0.0,586,584,2,2,3,gene,C29F7.2,0,13416005,1.44353,1463,13414537,5,13416000,0,-5
X,+,13436334,0.0,0.00390625,8,8,0,0,0,gene,C29F7.6,0,13436375,0.0193157,18193,13418141,41,13436376,42,1
X,+,13469223,0.0,0.25,2,2,0,0,1,gene,F15A2.1,0,13469293,6.81038,1519,13467704,70,13469377,154,84
X,+,13469392,0.0,6.46235e-27,87,87,0,0,8,gene,F15A2.1,0,13469442,6.81038,1688,13467704,50,13469377,-15,-65
X,+,13472077,0.0,3.72529e-09,28,28,0,0,1,gene,F15A2.2,0,13472081,0.110968,1747,13470330,4,13472077,0,-4
X,+,13507603,0.0,0.125,3,3,0,0,10,gene,H06A10.1,0,13507631,0.162662,17550,13490053,28,13507486,-117,-145
X,+,13519583,0.0058309,0.0,343,341,2,2,1,gene,F18H3.1,0,13519608,0.430774,9582,13510001,25,13519583,0,-25
X,+,13529008,0.0,0.0,195,195,0,0,0,gene,F18H3.4,0,13529021,0.475781,7568,13521440,13,13529008,0,-13
X,+,13542494,0.000488043,0.0,2049,2048,1,1,3,gene,R01E6.3,0,13542545,4.94249,4473,13538021,51,13542494,0,-51
X,+,13584695,0.00162866,0.0,614,613,1,1,1,gene,F54B11.3,0,13584699,1.16437,2019,13582676,4,13584695,0,-4
X,+,13598369,0.0,1.77636e-15,49,49,0,0,2,gene,F54B11.6,0,13598390,0.69242,4804,13593565,21,13598391,22,1
X,+,13598389,0.00211864,0.0,472,471,1,1,122,gene,F54B11.6,0,13598390,0.69242,4824,13593565,1,13598391,2,1
X,+,13618794,0.0,5.16988e-26,84,84,0,0,0,gene,Y12A6A.2,0,13618801,0.700009,10403,13608391,7,13618794,0,-7
X,+,13651021,0.0,0.0078125,7,7,0,0,0,gene,C40C9.4,0,13651082,0.00858158,2752,13648269,61,13651168,147,86
X,+,13660428,0.0,3.63798e-12,38,38,0,0,3,gene,C04A11.1,0,13660466,0.168309,8744,13651684,38,13660439,11,-27
X,+,13664509,0.0,1.49012e-08,26,26,0,0,4,gene,C04A11.5,0,13664515,0.200299,1622,13662887,6,13664509,0,-6
X,+,13677114,0.00492611,0.0,203,202,1,1,0,gene,C04A11.3,0,13677179,0.681504,11814,13665300,65,13677112,-2,-67
X,+,13687881,0.00199203,0.0,502,501,1,1,0,gene,C04A11.4,0,13687881,0.377431,5203,13682678,0,13687893,12,12
X,+,13706843,0.0,9.86076e-32,103,103,0,0,0,gene,K02D3.1,0,13706847,0.225493,11130,13695713,4,13706848,5,1
X,+,13724574,0.0,0.0078125,7,7,0,0,2,gene,K11E4.6,0,13724584,None,5484,13719090,10,13724585,11,1
X,+,13727220,0.0120482,0.0,166,164,2,2,6,gene,K11E4.4,0,13727222,0.293768,1296,13725924,2,13727219,-1,-3
X,+,13747237,0.00492611,0.0,203,202,1,0,0,gene,K11E4.5,0,13747365,0.46565,12910,13734327,128,13747237,0,-128
X,+,13755693,0.0442478,0.0,339,324,15,6,0,gene,F55F3.1,0,13755756,1.04193,3976,13751717,63,13755693,0,-63
X,+,13834344,0.0,6.61744e-24,77,77,0,0,4,gene,F19D8.2,0,13834348,0.0174509,45163,13789181,4,13834349,5,1
X,+,13841539,0.0,5.29396e-23,74,74,0,0,2,gene,M03B6.1,0,13841549,0.246132,5095,13836444,10,13841550,11,1
X,+,13852828,0.0,0.0,200,200,0,0,1,gene,M03B6.2,0,13852855,0.906286,8233,13844595,27,13852828,0,-27
X,+,13934792,0.0,0.0078125,7,7,0,0,0,gene,K02B9.4,0,13934804,1.3076,2837,13931955,12,13934805,13,1
X,+,13934798,0.0,2.38419e-07,22,22,0,0,1,gene,K02B9.4,0,13934804,1.3076,2843,13931955,6,13934805,7,1
X,+,13938664,0.00199601,0.0,501,500,1,1,6,gene,K02B9.4,0,13938746,1.3076,6709,13931955,82,13938664,0,-82
X,+,13949037,0.0033557,0.0,298,297,1,0,0,gene,F48F7.1,0,13949075,2.09954,7914,13941123,38,13949410,373,335
X,+,13951183,0.00769231,9.55089e-38,130,129,1,1,0,gene,F48F7.1,0,13951211,2.09954,10060,13941123,28,13951183,0,-28
X,+,13960070,0.0,1.88079e-37,122,122,0,0,21,gene,F48F7.2,0,13960087,0.410317,3892,13956178,17,13960070,0,-17
X,+,13975580,0.0188679,5.88418e-15,53,52,1,0,0,gene,F48F7.5,1,13975580,0.340588,9941,13965639,0,13975581,1,1
X,+,13977750,0.162667,1.5162e-42,375,314,61,23,2,gene,F48F7.6,2,13977753,1.41658,610,13977140,3,13977750,0,-3
X,+,13980759,0.0,0.015625,6,6,0,0,0,gene,F48F7.8,0,13980760,0,1807,13978952,1,13980761,2,1
X,+,13996261,0.0,4.1359e-25,81,81,0,0,2,gene,C31E10.6,0,13996276,0.289098,6160,13990101,15,13996228,-33,-48
X,+,14001845,0.0171569,0.0,2040,2005,35,17,5,gene,C31E10.7,0,14001845,5.92482,2575,13999270,0,14001845,0,0
X,+,14020513,0.00197628,0.0,506,505,1,0,4,gene,C04C11.1,0,14020519,0.105738,1267,14019246,6,14020707,194,188
X,+,14033535,0.0,0.00012207,13,13,0,0,2,gene,C04C11.2,0,14033596,1.42508,11224,14022311,61,14033715,180,119
X,+,14033715,0.0,1.83671e-40,132,132,0,0,3,gene,C04C11.2,0,14033727,1.42508,11404,14022311,12,14033715,0,-12
X,+,14033722,0.0030722,0.0,651,649,2,1,28,gene,C04C11.2,0,14033727,1.42508,11411,14022311,5,14033722,0,-5
X,+,14049456,0.0,1.73472e-18,59,59,0,0,1,gene,C33G3.1,0,14049559,0.325472,12107,14037349,103,14049456,0,-103
X,+,14050736,0.0,7.27596e-12,37,37,0,0,1,gene,C33G3.1,0,14050748,0.325472,13387,14037349,12,14050736,0,-12
X,+,14054937,0.0,0.000976562,10,10,0,0,2,gene,C33G3.1,0,14055149,0.325472,2866,14052071,212,14055095,158,-54
X,+,14102273,0.0,1.13687e-13,43,43,0,0,15,gene,F16B12.6,0,14102279,0.631962,784,14101489,6,14102280,7,1
X,+,14102278,0.00326797,0.0,306,305,1,1,21,gene,F16B12.6,0,14102279,0.631962,789,14101489,1,14102280,2,1
X,+,14127800,0.0,1.4013e-45,149,149,0,0,0,gene,F28H6.4,0,14127801,0.370413,11128,14116672,1,14127802,2,1
X,+,14141860,0.0,7.45058e-09,27,27,0,0,0,gene,F28H6.2,0,14141866,0.108911,8419,14133441,6,14141867,7,1
X,+,14141867,0.0,4.76837e-07,21,21,0,0,8,gene,F28H6.2,0,14142059,0.108911,8426,14133441,192,14141867,0,-192
X,+,14147621,0.0027933,0.0,358,357,1,1,2,gene,F28H6.1,0,14147627,0.527167,2869,14144752,6,14147621,0,-6
X,+,14175968,0.0,7.27596e-12,37,37,0,0,0,gene,C37E2.2,0,14175970,0.150338,23965,14152003,2,14175971,3,1
X,+,14214894,0.00105848,0.0,3779,3775,4,3,12,gene,K06G5.1,0,14214894,8.01764,19244,14195650,0,14214894,0,0
X,+,14238629,0.0,0.0,221,221,0,0,0,gene,K04C1.2,0,14238643,0.381012,9949,14228680,14,14238629,0,-14
X,+,14247974,0.00259067,0.0,386,385,1,1,0,gene,K04C1.5,0,14248040,0.377387,6786,14241188,66,14247973,-1,-67
X,+,14256194,0.0,7.17465e-43,140,140,0,0,49,gene,E02H4.7,0,14256201,None,6425,14249769,7,14256202,8,1
X,+,14257884,0.0,1.77636e-15,49,49,0,0,0,gene,E02H4.4,0,14257889,0.106202,539,14257345,5,14257890,6,1
X,+,14313849,0.0,7.27596e-12,37,37,0,0,0,gene,C11H1.4,0,14313861,0.0891555,36843,14277006,12,14313641,-208,-220
X,+,14350045,0.0,1.45519e-11,36,36,0,0,0,gene,K04G11.4,0,14350059,0.255858,19932,14330113,14,14350060,15,1
X,+,14383150,0.0,2.32831e-10,32,32,0,0,0,gene,Y60A9.3,0,14383170,0.0274145,6751,14376399,20,14383171,21,1
X,+,14406039,0.0,4.44089e-16,51,51,0,0,0,gene,T14C1.1,0,14406055,0.0814535,22179,14383860,16,14406097,58,42
X,+,14436398,0.0,0.000244141,12,12,0,0,0,gene,F23D12.9,0,14436670,None,12613,14423785,272,14436671,273,1
X,+,14444921,0.0,0.000488281,11,11,0,0,0,gene,F23D12.4,0,14444921,0.0805691,1551,14443370,0,14444922,1,1
X,+,14448136,0.0,9.53674e-07,20,20,0,0,2,gene,F23D12.5,0,14448149,0.135926,1898,14446238,13,14448144,8,-5
X,+,14480492,0.00396825,0.0,252,251,1,1,2,gene,M163.4,0,14480493,0.378435,316,14480176,1,14480492,0,-1
X,+,14496005,0.0,2.27374e-13,42,42,0,0,1,gene,M163.2,0,14496039,0.0742458,4974,14491031,34,14496005,0,-34
X,+,14516780,0.0,0.0,365,365,0,0,1,gene,D1025.10,1,14516798,0.239124,17489,14499291,18,14516799,19,1
X,+,14520683,0.901235,8.55621e-28,162,16,146,59,4,gene,D1025.1,2,14520697,0.28066,101,14520582,14,14520683,0,-14
X,+,14537819,0.0,0.0,151,151,0,0,1,gene,T24C2.5,0,14537823,0.40667,8786,14529033,4,14537650,-169,-173
X,+,14543442,0.0,0.125,3,3,0,0,1,gene,T24C2.3,0,14543452,0.00381737,4000,14539442,10,14543477,35,25
X,+,14545765,0.0,0.0,247,247,0,0,0,gene,T24C2.2,0,14545774,0.0966155,1202,14544563,9,14545775,10,1
X,+,14550058,0.0,1.90735e-06,19,19,0,0,0,gene,T24C2.1,0,14550068,0.0375948,3323,14546735,10,14550058,0,-10
X,+,14558424,0.0,0.0,298,298,0,0,0,gene,H01A20.1,0,14558425,0.813675,2204,14556220,1,14558424,0,-1
X,+,14572639,0.0,0.000488281,11,11,0,0,0,gene,C44H4.1,0,14572647,0.0725139,11292,14561347,8,14572639,0,-8
X,+,14589546,0.0,0.0,305,305,0,0,1,gene,C44H4.5,0,14589579,0.573946,5241,14584305,33,14589558,12,-21
X,+,14595049,0.00917431,1.67941e-31,109,108,1,0,1,gene,C44H4.8,0,14595069,0.0292318,3306,14591743,20,14595070,21,1
X,+,14602988,0.0,1.43493e-42,139,139,0,0,3,gene,C44H4.7,0,14603004,0.435052,6708,14596280,16,14602988,0,-16
X,+,14611303,0.00352113,0.0,284,283,1,1,0,gene,F54E4.1,0,14611325,0.623655,2726,14608577,22,14611326,23,1
X,+,14654894,0.0,8.88178e-16,50,50,0,0,1,gene,C26G2.1,0,14654909,0.372304,30124,14624770,15,14654910,16,1
X,+,14664234,0.0,6.10352e-05,14,14,0,0,0,gene,C26G2.2,0,14664252,0.108462,1451,14662783,18,14664209,-25,-43
X,+,14674248,0.0,8.47033e-22,70,70,0,0,6,gene,F40E10.4,0,14674286,0.286553,2948,14671300,38,14674239,-9,-47
X,+,14684771,0.0,0.03125,5,5,0,0,1,gene,F40E10.3,0,14684797,4.95707,1524,14683247,26,14684797,26,0
X,+,14684797,0.000331016,0.0,3021,3020,1,1,5,gene,F40E10.3,0,14684797,4.95707,1550,14683247,0,14684797,0,0
X,+,14732203,0.0,0.0,230,230,0,0,0,gene,F33C8.4,0,14732208,0.396278,6725,14725478,5,14732209,6,1
X,+,14747228,0.0,4.54747e-13,41,41,0,0,0,gene,C05G5.2,0,14747258,0.32172,12856,14734372,30,14747239,11,-19
X,+,14753945,0.00317797,0.0,1888,1882,6,6,5,gene,C05G5.4,0,14753950,3.99598,3627,14750318,5,14753945,0,-5
X,+,14790927,0.0,0.0,325,325,0,0,0,gene,F42D1.2,0,14790977,2.5582,7449,14783478,50,14790927,0,-50
X,+,14800039,0.0,3.05176e-05,15,15,0,0,0,gene,F42D1.3,0,14800061,0.0668702,7140,14792899,22,14800039,0,-22
X,+,14807136,0.0,3.30872e-24,78,78,0,0,1,gene,F42D1.4,0,14807143,0.0671525,2860,14804276,7,14807155,19,12
X,+,14831743,0.0,1.52588e-05,16,16,0,0,1,gene,C27C12.7,0,14831753,0.375886,17444,14814299,10,14831743,0,-10
X,+,14831750,0.0588235,0.0001297,17,16,1,0,5,gene,C27C12.7,0,14831753,0.375886,17451,14814299,3,14831743,-7,-10
X,+,14845856,0.00334448,0.0,299,298,1,1,0,gene,C27C12.2,0,14845862,0.401639,7747,14838109,6,14845856,0,-6
X,+,14876067,0.0,1.0842e-19,63,63,0,0,5,gene,F31F6.8,0,14876083,0.0766911,19627,14856440,16,14876084,17,1
X,+,14881338,0.0,0.0625,4,4,0,0,0,gene,F31F6.4,0,14881456,1.5313,2567,14878771,118,14881338,0,-118
X,+,14888407,0.0,6.93889e-18,57,57,0,0,4,gene,F31F6.5,0,14888413,0.138654,6221,14882186,6,14888406,-1,-7
X,+,14895064,0.0,0.0,155,155,0,0,2,gene,F31F6.6,0,14895074,0.416644,820,14894244,10,14895064,0,-10
X,+,14918761,0.0,2.71051e-20,65,65,0,0,0,gene,Y70D2A.1,0,14918782,0.239922,18070,14900691,21,14918754,-7,-28
X,+,14920783,0.0,7.27596e-12,37,37,0,0,1,gene,Y70D2A.1,0,14920843,0.239922,20092,14900691,60,14920783,0,-60
X,+,14970669,0.00355872,0.0,281,280,1,1,0,gene,F20D1.2,1,14970677,0.52773,2827,14967842,8,14970669,0,-8
X,+,14976035,0.051001,0.0,2098,1991,107,60,1,gene,F20D1.3,2,14976035,3.07857,1338,14974697,0,14976035,0,0
X,+,14979606,0.625131,1.989e-15,955,358,597,279,25,gene,F20D1.10,3,14979607,3.97573,972,14978634,1,14979606,0,-1
X,+,14983451,0.0,3.05176e-05,15,15,0,0,7,gene,F20D1.6,0,14983478,0.61134,2866,14980585,27,14983451,0,-27
X,+,15026182,0.0,0.5,1,1,0,0,0,gene,C18B12.2,0,15026239,0.216275,38899,14987283,57,15026226,44,-13
X,+,15026226,0.0,7.45058e-09,27,27,0,0,0,gene,C18B12.2,0,15026239,0.216275,38943,14987283,13,15026226,0,-13
X,+,15063932,0.0,0.00390625,8,8,0,0,0,gene,H03G16.3,0,15063932,None,32811,15031121,0,15063933,1,1
X,+,15089315,0.0,0.5,1,1,0,0,3,gene,F09B12.6,0,15089429,0.0985173,1262,15088053,114,15089315,0,-114
X,+,15173822,0.00155763,0.0,642,641,1,1,2,gene,T10B10.2,0,15173822,2.35527,283,15173539,0,15173822,0,0
X,+,15190041,0.00508906,0.0,393,391,2,0,2,gene,T10B10.4,0,15190057,1.04737,11978,15178063,16,15190041,0,-16
X,+,15257332,0.0,0.5,1,1,0,0,0,gene,F46F2.4,0,15257334,0.00440826,4232,15253100,2,15257516,184,182
X,+,15262650,0.0666667,0.000457764,15,14,1,0,5,gene,F46F2.5,0,15262661,0.0638641,3683,15258967,11,15262646,-4,-15
X,+,15309294,0.00591716,0.0,169,168,1,1,1,gene,Y15E3A.1,0,15309297,0.464013,23082,15286212,3,15309294,0,-3
X,+,15312582,0.0,9.53674e-07,20,20,0,0,0,gene,Y15E3A.1,0,15312679,0.464013,26370,15286212,97,15312582,0,-97
X,+,15330883,0.00837521,0.0,597,592,5,3,1,gene,Y15E3A.4,0,15330913,2.04799,16068,15314815,30,15330883,0,-30
X,+,15343073,0.00358566,0.0,2510,2501,9,7,11,gene,Y15E3A.5,0,15343113,1.64055,2483,15340590,40,15343073,0,-40
X,+,15355157,0.00330033,0.0,303,302,1,0,0,gene,C33A11.1,0,15355158,1.41531,11093,15344064,1,15355157,0,-1
X,+,15365913,0.0,0.0,227,227,0,0,11,gene,C33A11.2,0,15365915,0.288171,2133,15363780,2,15365913,0,-2
X,+,15407840,0.0,3.38813e-21,68,68,0,0,1,gene,F39D8.2,0,15407849,0.220614,37922,15369918,9,15407832,-8,-17
X,+,15422427,0.0,0.5,1,1,0,0,0,gene,F39D8.3,0,15422443,0.117546,3215,15419212,16,15422413,-14,-30
X,+,15441650,0.00324675,0.0,616,614,2,0,3,gene,R03A10.4,0,15441669,0.753637,6761,15434889,19,15441650,0,-19
X,+,15441669,0.0,0.5,1,1,0,0,1417,gene,R03A10.4,0,15441669,0.753637,6780,15434889,0,15441650,-19,-19
X,+,15441720,0.0,0.0,217,217,0,0,24,gene,R03A10.4,0,15441720,0.753637,6831,15434889,0,15441720,0,0
X,+,15446645,0.016129,1.34441e-17,62,61,1,0,1,gene,R03A10.5,0,15446649,0.423053,3068,15443577,4,15446649,4,0
X,+,15466220,0.0,2.22045e-16,52,52,0,0,0,gene,R03A10.6,0,15466266,0.0694758,15940,15450280,46,15466220,0,-46
X,+,15488026,0.0,6.01853e-36,117,117,0,0,1,gene,H13N06.2,0,15488039,0.153338,2406,15485620,13,15488040,14,1
X,+,15493433,0.0,0.5,1,1,0,0,0,gene,H13N06.3,1,15493455,1.05951,1526,15491907,22,15493456,23,1
X,+,15493528,0.0,0.0,441,441,0,0,0,gene,H13N06.3,1,15493590,1.05951,1621,15491907,62,15493591,63,1
X,+,15497475,0.338983,0.00484779,59,39,20,15,1,gene,H13N06.4,2,15497475,0.454458,75,15497400,0,15497475,0,0
X,+,15516575,0.00255754,0.0,391,390,1,1,2,gene,H30A04.1,0,15516676,1.05522,11282,15505293,101,15516575,0,-101
X,+,15537582,0.0,7.27596e-12,37,37,0,0,0,gene,C02C6.2,0,15537584,0.413191,13638,15523944,2,15537582,0,-2
X,+,15542932,0.0147059,2.30393e-19,68,67,1,1,3,gene,C02C6.2,0,15542986,0.413191,18988,15523944,54,15542932,0,-54
X,+,15568810,0.0,0.0,341,341,0,0,1,gene,C02C6.1,0,15568840,1.34096,22164,15546646,30,15568841,31,1
X,+,15577168,0.0,7.70372e-34,110,110,0,0,0,gene,K09A9.6,0,15577523,0.417497,3555,15573613,355,15577390,222,-133
X,+,15591288,0.00813008,1.15669e-35,123,122,1,1,0,gene,K09A9.4,0,15591288,0.246416,4567,15586721,0,15591288,0,0
X,+,15600987,0.00263158,0.0,380,379,1,1,0,gene,K09A9.3,0,15600992,2.57528,1169,15599818,5,15600987,0,-5
X,+,15607889,0.0147059,1.05381e-37,136,134,2,0,1,gene,K09A9.1,0,15607891,0.888008,4261,15603628,2,15607889,0,-2
X,+,15620420,0.0,1.12104e-44,146,146,0,0,14,gene,K09E9.1,0,15620425,0.285793,8676,15611744,5,15620420,0,-5
X,+,15622255,0.0,5.87747e-39,127,127,0,0,20,gene,K09E9.1,0,15622255,0.285793,10511,15611744,0,15622255,0,0
X,+,15641336,0.0,0.000488281,11,11,0,0,0,gene,H08J19.1,0,15641342,0.0236079,2084,15639252,6,15641336,0,-6
X,+,15642840,0.0,0.00390625,8,8,0,0,0,gene,H08J19.1,0,15642857,0.0236079,67,15642773,17,15642840,0,-17
X,+,15666681,0.0,1.17549e-38,126,126,0,0,0,gene,F59D12.1,0,15666825,0.187597,22392,15644289,144,15666681,0,-144
X,+,15689411,0.0,6.77626e-21,67,67,0,0,89,gene,C03H12.1,0,15689434,0.382491,2019,15687392,23,15689378,-33,-56
X,+,15708139,0.00956938,0.0,209,207,2,2,1,gene,ZK662.3,0,15708265,0.616487,10149,15697990,126,15708141,2,-124
X,+,15709976,0.0153846,1.76183e-18,65,64,1,1,0,gene,ZK662.3,0,15709996,0.616487,11986,15697990,20,15709976,0,-20
X,+,15726049,0.00471698,0.0,212,211,1,0,0,gene,ZK662.4,1,15726054,0.721932,2899,15723150,5,15726049,0,-5
X,+,15731888,0.933333,6.32143e-25,120,8,112,67,2,gene,ZK678.1,2,15731894,0.404381,114,15731774,6,15731888,0,-6
X,+,15811668,0.0,0.125,3,3,0,0,0,gene,Y7A5A.11,0,15811671,0.0109703,35082,15776586,3,15811778,110,107
X,+,15820984,1.0,0.125,3,0,3,2,0,gene,Y7A5A.8,0,15820995,0.00927289,373,15820611,11,15821341,357,346
X,+,15841491,0.00084625,0.0,22452,22433,19,14,4,gene,F59F4.2,0,15841518,23.4836,8494,15832997,27,15841491,0,-27
X,+,15849814,0.0,0.0,228,228,0,0,1,gene,F59F4.4,0,15849818,0.983159,5495,15844319,4,15849819,5,1
X,+,15866515,0.0,0.00195312,9,9,0,0,1,gene,F53H4.4,0,15866524,0.0833301,8624,15857891,9,15866515,0,-9
X,+,15923663,0.0,7.27596e-12,37,37,0,0,1,gene,F31B9.3,0,15923682,0.270182,3265,15920398,19,15923656,-7,-26
X,+,15943927,0.0,0.0,358,358,0,0,0,gene,E03G2.3,0,15943929,0.484402,15522,15928405,2,15943927,0,-2
X,+,15959964,0.0,2.1684e-19,62,62,0,0,0,gene,C09G1.5,0,15959968,0.344484,5479,15954485,4,15959964,0,-4
X,+,16017424,0.0,0.5,1,1,0,0,0,gene,B0395.1,0,16017434,0.100375,29864,15987560,10,16017435,11,1
X,+,16030722,0.0,8.67362e-19,60,60,0,0,2,gene,B0395.2,0,16030737,0.319226,9058,16021664,15,16030722,0,-15
X,+,16049789,0.0,0.0,171,171,0,0,0,gene,T27A8.1,0,16049796,0.356141,15058,16034731,7,16049789,0,-7
X,+,16103538,0.0070922,5.05813e-41,141,140,1,1,0,gene,ZK1073.2,0,16103559,0.343286,6640,16096898,21,16103559,21,0
X,+,16184293,0.0,0.0,364,364,0,0,0,gene,R11.2,0,16184308,0.690729,60473,16123820,15,16184309,16,1
X,+,16189772,0.0,2.24208e-44,145,145,0,0,2,gene,R11.1,0,16189785,0.424811,4134,16185638,13,16189780,8,-5
X,+,16217298,0.00291121,0.0,687,685,2,2,1,gene,F23A7.1,0,16217323,0.916114,3806,16213492,25,16217308,10,-15
X,+,16219926,0.0,2.71051e-20,65,65,0,0,0,gene,F23A7.3,0,16219931,0.101981,2313,16217613,5,16219932,6,1
X,+,16245103,0.0,0.00390625,8,8,0,0,1,gene,W10G6.1,0,16245108,0.00757058,8169,16236934,5,16245109,6,1
X,+,16275684,0.0,6.77626e-21,67,67,0,0,0,gene,F52E10.1,0,16275687,0.323575,3944,16271740,3,16275684,0,-3
X,+,16299808,0.0,0.000488281,11,11,0,0,0,gene,T01B4.1,0,16299819,0.00685189,17444,16282364,11,16299820,12,1
X,+,16328940,0.0,0.25,2,2,0,0,1,gene,C11G6.2,0,16328997,0.00385042,14038,16314902,57,16329133,193,136
X,+,16332031,0.0,0.125,3,3,0,0,0,gene,C11G6.1,0,16332085,0.315338,2118,16329913,54,16332356,325,271
X,+,16332358,0.0,7.70372e-34,110,110,0,0,0,gene,C11G6.1,0,16332365,0.315338,2445,16329913,7,16332356,-2,-9
X,+,16354270,0.0,0.125,3,3,0,0,0,gene,C11G6.4,0,16354437,0.388682,8327,16345943,167,16354892,622,455
X,+,16354892,0.0,1.97215e-31,102,102,0,0,2,gene,C11G6.4,0,16354904,0.388682,8949,16345943,12,16354892,0,-12
X,+,16367209,0.0,2.58494e-26,85,85,0,0,0,gene,W09B12.1,0,16367278,0.180666,7740,16359469,69,16367209,0,-69
X,+,16376511,0.00442478,0.0,226,225,1,1,0,gene,F01G12.2,0,16376522,0.604665,2808,16373703,11,16376515,4,-7
X,+,16456909,0.5,0.5,2,1,1,0,1,gene,F38E9.2,0,16457004,0.119878,4434,16452475,95,16457307,398,303
X,+,16471252,0.0,9.09495e-13,40,40,0,0,2,gene,F38E9.1,0,16471286,0.205954,1,16471251,34,16471287,35,1
X,+,16486772,0.0,0.125,3,3,0,0,0,gene,K05G3.3,0,16486922,2.19847,11860,16474912,150,16487422,650,500
X,+,16487396,0.00176056,0.0,1136,1134,2,1,11,gene,K05G3.3,0,16487448,2.19847,12484,16474912,52,16487422,26,-26
X,+,16496253,0.0,0.5,1,1,0,0,0,gene,K05G3.2,0,16496269,0.00675479,6942,16489311,16,16496253,0,-16
X,+,16536752,0.0,0.0,314,314,0,0,1,gene,T27B1.2,0,16536804,1.07786,14542,16522210,52,16536752,0,-52
X,+,16558350,0.0,8.47033e-22,70,70,0,0,0,gene,K08B5.1,0,16558358,0.109849,7224,16551126,8,16558359,9,1
X,+,16579638,0.0,0.00195312,9,9,0,0,0,gene,F59C12.2,0,16579659,0.0625034,17152,16562486,21,16579660,22,1
X,+,16595153,0.0,4.65661e-10,31,31,0,0,0,gene,F59C12.1,0,16595154,0.251949,7537,16587616,1,16595151,-2,-3
X,+,16613366,0.00267953,0.0,1866,1861,5,3,5,gene,C06G1.4,0,16613407,4.17999,3921,16609445,41,16613366,0,-41
X,+,16633278,0.00675676,4.14784e-43,148,147,1,1,0,gene,C06G1.1,0,16633282,0.95118,10653,16622625,4,16633278,0,-4
X,+,16711596,0.0,1.49012e-08,26,26,0,0,0,gene,T21F2.1,0,16711712,0.0494437,8241,16703355,116,16711596,0,-116
X,+,16729474,0.00348432,0.0,287,286,1,0,0,gene,C10E2.3,1,16729477,0.705926,8955,16720519,3,16729474,0,-3
X,+,16745668,0.777778,0.0703125,9,2,7,4,2,gene,C10E2.2,2,16745744,0.0357816,989,16744679,76,16745668,0,-76
X,+,16786359,0.0113766,0.0,879,869,10,6,71,gene,T01C8.2,0,16786368,4.00782,19788,16766571,9,16786359,0,-9
X,+,16796002,0.0416667,1.43051e-06,24,23,1,0,0,gene,T01C8.1,0,16796003,1.581,8467,16787535,1,16796002,0,-1
X,+,16799622,0.00448431,0.0,446,444,2,1,0,gene,T01C8.1,0,16799664,1.581,12087,16787535,42,16799622,0,-42
X,+,16860356,0.0,3.05176e-05,15,15,0,0,1,gene,T20F7.3,0,16860370,0.0161832,12850,16847506,14,16860311,-45,-59
X,+,16872824,0.0,1.11022e-16,53,53,0,0,0,gene,T20F7.1,0,16872840,0.394339,11522,16861302,16,16872841,17,1
X,+,16872833,0.0,0.0,285,285,0,0,34,gene,T20F7.1,0,16872840,0.394339,11531,16861302,7,16872841,8,1
X,+,16891889,0.0,0.0625,4,4,0,0,2,gene,F39F10.3,0,16891905,0.152813,5935,16885954,16,16891906,17,1
X,+,16891899,0.0,5.73972e-42,137,137,0,0,8,gene,F39F10.3,0,16891905,0.152813,5945,16885954,6,16891906,7,1
X,+,16921749,0.0,5.96046e-08,24,24,0,0,0,gene,C30E1.5,0,16921767,0.0306014,5034,16916715,18,16921768,19,1
X,+,16963786,0.0,0.0,311,311,0,0,1,gene,F52G3.1,0,16963849,1.47262,28412,16935374,63,16963786,0,-63
X,+,17001645,0.00738007,0.0,271,269,2,1,22,gene,K02H8.1,0,17001645,0.876821,12037,16989608,0,17001646,1,1
X,+,17092674,0.00330033,0.0,303,302,1,0,9,gene,C08A9.1,0,17092681,0.992568,8794,17083880,7,17092632,-42,-49
X,+,17151436,0.0105263,2.39814e-27,95,94,1,1,0,gene,T23C6.1,0,17151436,0.205628,31259,17120177,0,17151436,0,0
X,+,17186294,0.00826446,4.55151e-35,121,120,1,1,0,gene,B0302.1,0,17186301,0.835348,7349,17178945,7,17186294,0,-7
X,+,17222378,0.0,2.38419e-07,22,22,0,0,0,gene,T25G12.4,0,17222392,2.11478,29118,17193260,14,17222389,11,-3
X,+,17222389,0.00099108,0.0,2018,2016,2,2,34,gene,T25G12.4,0,17222392,2.11478,29129,17193260,3,17222389,0,-3
X,+,17243272,0.0,0.0078125,7,7,0,0,0,gene,T25G12.2,0,17243275,0.0162585,8566,17234706,3,17243180,-92,-95
X,+,17302632,0.0,8.88178e-16,50,50,0,0,1,gene,C33E10.2,0,17302664,0.0467128,6485,17296147,32,17302665,33,1
X,+,17318497,0.0,8.88178e-16,50,50,0,0,3,gene,C53C11.3,0,17318517,0.277757,7371,17311126,20,17318497,0,-20
X,+,17333965,0.0,0.0,216,216,0,0,17,gene,C53C11.5,0,17333969,0.423207,7437,17326528,4,17334036,71,67
X,+,17336875,0.75,0.25,4,1,3,0,3,gene,C53C11.2,0,17337185,1.72832,370,17336505,310,17337153,278,-32
X,+,17359667,0.0,0.00390625,8,8,0,0,0,gene,F10D7.1,0,17359667,0.0468711,17534,17342133,0,17359683,16,16
X,+,17401485,0.0,7.45058e-09,27,27,0,0,0,gene,F11C7.6,0,17401504,0.296698,2214,17399271,19,17401380,-105,-124
X,+,17452305,0.00956938,0.0,209,207,2,2,2,gene,C36E6.2,0,17452309,5.15225,10741,17441564,4,17452305,0,-4
X,+,17518357,0.00138122,0.0,724,723,1,1,1,gene,R09G11.2,0,17518439,1.47893,36484,17481873,82,17518357,0,-82
X,+,17519928,0.0,6.10352e-05,14,14,0,0,40,gene,R09G11.2,0,17519928,1.47893,38055,17481873,0,17519928,0,0
X,+,17600283,0.0,0.0625,4,4,0,0,12,gene,C16H3.2,0,17600433,14.4912,48494,17551789,150,17600387,104,-46
X,+,17662369,0.00117925,0.0,848,847,1,0,0,gene,T23E7.4,0,17662373,1.3832,10863,17651506,4,17662369,0,-4
X,+,17670940,0.00350877,0.0,285,284,1,1,0,gene,T23E7.2,0,17670952,2.52683,5910,17665030,12,17670940,0,-12
X,+,17695143,0.0,2.38419e-07,22,22,0,0,0,gene,F20B4.6,0,17695279,0.107233,14443,17680700,136,17695143,0,-136
X,+,17696384,0.0,0.00012207,13,13,0,0,2,gene,F20B4.6,0,17696385,0.107233,15684,17680700,1,17696384,0,-1
X,+,17714878,0.000925926,0.0,2160,2158,2,2,0,gene,cTel55X.1,0,17714984,None,13225,17701653,106,17714878,0,-106
I,-,15052405,0.00862069,0.0,580,575,5,5,2,gene,F31C3.4,1,15052405,1.02778,1234,15053639,0,15052405,0,0
I,-,15050685,0.947368,1.28408e-25,114,6,108,74,5,gene,F31C3.3,2,15050681,0.686166,96,15050781,4,15050664,21,17
I,-,15041259,0.291705,0.0,9873,6993,2880,2089,12,gene,F31C3.1,3,15041257,22.7199,155,15041414,2,15041259,0,-2
I,-,15030696,0.0,6.01853e-36,117,117,0,0,2,gene,F33H2.7,0,15030535,0.259539,440,15031136,161,15030535,161,0
I,-,15030562,0.0,6.16298e-33,107,107,0,0,3,gene,F33H2.7,0,15030535,0.259539,574,15031136,27,15030535,27,0
I,-,15022971,0.0078125,3.76158e-37,128,127,1,0,2,gene,F33H2.1,1,15022965,0.423927,4731,15027702,6,15022965,6,0
I,-,15016993,0.0416667,1.43051e-06,24,23,1,1,2,gene,F33H2.6,2,15016899,1.01652,270,15017263,94,15016580,413,319
I,-,15016580,0.315682,5.64576e-17,491,336,155,104,8,gene,F33H2.6,2,15016564,1.01652,683,15017263,16,15016580,0,-16
I,-,15013896,0.0,7.62939e-06,17,17,0,0,2,gene,F33H2.5,0,15013859,0.624753,945,15014841,37,15013859,37,0
I,-,15013887,0.0130435,0.0,230,227,3,2,27,gene,F33H2.5,0,15013859,0.624753,954,15014841,28,15013859,28,0
I,-,14900235,0.0,0.25,2,2,0,0,34,gene,ZK270.2,0,14900198,2.57419,55387,14955622,37,14900198,37,0
I,-,14897352,0.00365631,0.0,547,545,2,2,14,gene,ZK270.2,0,14897347,2.57419,58270,14955622,5,14897352,0,-5
I,-,14834824,0.00769231,9.55089e-38,130,129,1,1,0,gene,F32A7.3,0,14834818,0.839903,15239,14850063,6,14834824,0,-6
I,-,14832117,0.0,0.0625,4,4,0,0,10,gene,F32A7.3,0,14832072,0.839903,789,14832906,45,14832117,0,-45
I,-,14820211,0.0,1.42109e-14,46,46,0,0,57,gene,Y54E5B.2,0,14820207,0.276103,9441,14829652,4,14820207,4,0
I,-,14789471,0.0,0.0,167,167,0,0,26,gene,F39B2.3,1,14789467,0.568353,26223,14815694,4,14789467,4,0
I,-,14787789,0.137931,1.1462e-12,87,75,12,8,2,gene,F39B2.4,2,14787781,0.623223,321,14788110,8,14787789,0,-8
I,-,14776648,0.914286,3.80833e-32,175,15,160,115,5,gene,F39B2.5,3,14776630,0.609905,475,14777123,18,14776648,0,-18
I,-,14774992,0.964286,1.19616e-27,112,4,108,72,0,gene,F39B2.7,4,14774981,0.153538,177,14775169,11,14774992,0,-11
I,-,14730708,0.0,4.44089e-16,51,51,0,0,3,gene,K05C4.9,0,14730704,0.181189,1617,14732325,4,14730704,4,0
I,-,14724724,0.0,1.81899e-12,39,39,0,0,5,gene,K05C4.11,0,14724724,0.168123,2178,14726902,0,14724724,0,0
I,-,14721340,0.00733753,0.0,1908,1894,14,13,2,gene,K05C4.2,1,14721324,6.91673,410,14721750,16,14721340,0,-16
I,-,14720462,0.943404,0.0,2562,145,2417,1577,4,gene,K05C4.1,2,14720447,5.81479,110,14720572,15,14720462,0,-15
I,-,14710915,0.00465116,0.0,215,214,1,0,29,gene,Y54E5A.6,1,14710914,0.33352,8234,14719149,1,14710914,1,0
I,-,14707860,0.314389,1.33601e-27,827,567,260,198,8,gene,Y54E5A.5,2,14707852,3.81588,339,14708199,8,14707860,0,-8
I,-,14706507,0.786667,3.1508e-36,450,96,354,267,0,gene,Y54E5A.4,3,14706505,1.15151,139,14706646,2,14706507,0,-2
I,-,14691719,0.00704225,2.547e-41,142,141,1,1,6,gene,Y54E5A.1,0,14691699,0.36582,9388,14701107,20,14691699,20,0
I,-,14682549,0.0,3.30872e-24,78,78,0,0,0,gene,Y105E8B.9,0,14682548,0.296028,6067,14688616,1,14682548,1,0
I,-,14679733,0.0,0.25,2,2,0,0,0,gene,Y105E8B.10,0,14679733,None,8883,14688616,0,14679695,38,38
I,-,14642553,0.0110193,0.0,363,359,4,2,19,gene,Y105E8B.2,0,14642546,0.75093,18153,14660706,7,14642553,0,-7
I,-,14629926,0.0,0.25,2,2,0,0,2,gene,Y105E8B.1,0,14629758,29.5631,4526,14634452,168,14629926,0,-168
I,-,14625420,0.002405,0.0,2079,2074,5,5,7,gene,Y105E8B.1,0,14625419,29.5631,9032,14634452,1,14625420,0,-1
I,-,14625074,0.0,0.25,2,2,0,0,2,gene,Y105E8B.1,0,14624953,29.5631,9378,14634452,121,14625074,0,-121
I,-,14624904,0.0,0.5,1,1,0,0,64,gene,Y105E8B.1,0,14624871,29.5631,9548,14634452,33,14624904,0,-33
I,-,14620621,0.0,0.03125,5,5,0,0,2,gene,Y105E8B.11,0,14620618,0.00599642,527,14621148,3,14620618,3,0
I,-,14604124,0.00890208,0.0,337,334,3,2,1,gene,Y105E8A.25,1,14603940,1.03606,16206,14620330,184,14604124,0,-184
I,-,14602791,0.0,0.5,1,1,0,0,0,gene,Y105E8A.25,1,14602778,1.03606,17539,14620330,13,14602791,0,-13
I,-,14596335,0.0,0.0078125,7,7,0,0,0,gene,Y105E8A.29,2,14596132,0.608656,23995,14620330,203,14596335,0,-203
I,-,14593556,0.0,0.25,2,2,0,0,0,gene,Y105E8A.29,2,14593486,0.608656,26774,14620330,70,14593556,0,-70
I,-,14592237,0.0,0.00390625,8,8,0,0,1,gene,Y105E8A.29,2,14592109,0.608656,28093,14620330,128,14592237,0,-128
I,-,14565829,0.888889,1.35014e-24,153,17,136,97,18,gene,Y105E8A.23,4,14565829,0.332017,463,14566292,0,14565829,0,0
I,-,14518702,0.00192493,0.0,1039,1037,2,2,0,gene,Y105E8A.22,0,14518700,1.11822,33399,14552101,2,14518700,2,0
I,-,14510537,0.354015,3.5915e-07,274,177,97,72,0,gene,Y105E8A.21,0,14510524,0.488529,877,14511414,13,14510537,0,-13
I,-,14498278,0.533333,0.196381,15,7,8,8,0,gene,Y105E8A.28,0,14498276,0.0741068,1398,14499676,2,14498276,2,0
I,-,14495237,0.0333333,1.53523e-15,60,58,2,2,0,gene,Y105E8A.20,1,14495222,0.409243,1562,14496799,15,14495237,0,-15
I,-,14486752,0.957418,0.0,728,31,697,438,3,gene,Y105E8A.19,2,14486735,1.13878,110,14486862,17,14486747,5,-12
I,-,14469088,0.00651833,0.0,29302,29111,191,158,39,gene,Y105E8A.16,1,14469002,105.971,7515,14476603,86,14469088,0,-86
I,-,14468199,0.909782,0.0,1053,95,958,726,5,gene,Y105E8A.14,2,14468191,1.0596,118,14468317,8,14468196,3,-5
I,-,14465130,0.0,2.27374e-13,42,42,0,0,5,gene,Y105E8A.13,3,14465124,0.154333,14,14465144,6,14465220,-90,-96
I,-,14451863,0.00865801,0.0,231,229,2,0,4,gene,Y105E8A.12,0,14451797,0.491189,9270,14461133,66,14451863,0,-66
I,-,14405634,0.00273973,0.0,365,364,1,1,10,gene,Y105E8A.8,0,14405634,0.329952,28552,14434186,0,14405634,0,0
I,-,14384722,0.00165289,0.0,605,604,1,0,0,gene,Y105E8A.6,0,14384722,0.980071,15944,14400666,0,14384722,0,0
I,-,14369757,0.000786782,0.0,1271,1270,1,1,3,gene,Y105E8A.4,0,14369757,1.34913,1514,14371271,0,14369757,0,0
I,-,14358310,0.0,0.0,201,201,0,0,1,gene,Y105E8A.2,0,14358292,0.871359,9282,14367592,18,14358310,0,-18
I,-,14343800,0.0,0.0,171,171,0,0,0,gene,Y105E8A.1,0,14343790,0.194653,3737,14347537,10,14343790,10,0
I,-,14287074,0.0,0.25,2,2,0,0,2,gene,F09C3.3,0,14287062,0.0340843,740,14287814,12,14287062,12,0
I,-,14274198,0.0,0.0,369,369,0,0,0,gene,F09C3.2,0,14274190,0.926573,9249,14283447,8,14274190,8,0
I,-,14244437,0.00285714,0.0,350,349,1,0,1,gene,C49A1.10,0,14244417,0.873561,27439,14271876,20,14244417,20,0
I,-,14227207,0.0,0.5,1,1,0,0,2,gene,C49A1.4,0,14227081,0.511541,5844,14233051,126,14227207,0,-126
I,-,14196306,0.0,0.000244141,12,12,0,0,0,gene,ZK849.2,0,14196297,0.169044,2294,14198600,9,14196280,26,17
I,-,14179345,0.0,2.52435e-29,95,95,0,0,1,gene,C37A5.9,0,14179341,0.51895,3250,14182595,4,14179345,0,-4
I,-,14161649,0.0,9.31323e-10,30,30,0,0,0,gene,C37A5.1,0,14161645,0.118582,11165,14172814,4,14161649,0,-4
I,-,14142192,0.00966184,0.0,414,410,4,2,1,gene,K03D10.1,0,14142189,0.572814,8522,14150714,3,14142189,3,0
I,-,14113093,0.00459921,0.0,1522,1515,7,6,19,gene,Y63D3A.6,0,14113076,2.27419,15486,14128579,17,14113093,0,-17
I,-,14101075,0.0121359,0.0,412,407,5,4,0,gene,Y63D3A.4,0,14101068,0.347155,3339,14104414,7,14101068,7,0
I,-,14082362,0.0,5.16988e-26,84,84,0,0,7,gene,F47G4.2,0,14082359,0.377793,630,14082992,3,14082362,0,-3
I,-,14068788,0.00729927,0.0,274,272,2,1,1,gene,F47G4.4,0,14068773,0.675507,9403,14078191,15,14068788,0,-15
I,-,14062120,0.0,5.96046e-08,24,24,0,0,3,gene,F47G4.5,0,14062097,0.0320868,614,14062734,23,14062122,-2,-25
I,-,14050988,0.000626566,0.0,1596,1595,1,1,20,gene,F47G4.7,1,14050819,3.73911,1205,14052193,169,14050988,0,-169
I,-,14050978,0.0,5.29396e-23,74,74,0,0,2904,gene,F47G4.7,1,14050819,3.73911,1215,14052193,159,14050988,-10,-169
I,-,14050644,0.0,0.5,1,1,0,0,6,gene,F47G4.7,1,14050545,3.73911,1549,14052193,99,14050644,0,-99
I,-,14048005,0.3125,0.0150204,32,22,10,7,0,gene,Y71A12C.2,2,14048002,0.0764704,84,14048089,3,14048002,3,0
I,-,14013299,0.0,1.35525e-20,66,66,0,0,0,gene,ZC334.9,0,14013277,1.87864,2440,14015739,22,14013299,0,-22
I,-,13973386,0.0,0.25,2,2,0,0,4,gene,Y71A12B.19,0,13973375,None,38984,14012370,11,13973397,-11,-22
I,-,13951613,0.010101,1.56194e-28,99,98,1,1,1,gene,Y71A12B.9,0,13951613,0.241287,20919,13972532,0,13951613,0,0
I,-,13839786,0.0,0.5,1,1,0,0,0,gene,W04A8.1,0,13839762,0.244673,1022,13840808,24,13839785,1,-23
I,-,13839240,0.0,0.0625,4,4,0,0,0,gene,W04A8.1,0,13839237,0.244673,1568,13840808,3,13839240,0,-3
I,-,13832139,0.341772,0.00168514,79,52,27,23,1,gene,W09G3.1,1,13832124,0.650079,3139,13835278,15,13832131,8,-7
I,-,13832131,0.271233,2.79218e-19,365,266,99,78,31,gene,W09G3.1,1,13832124,0.650079,3147,13835278,7,13832131,0,-7
I,-,13828001,0.0,0.25,2,2,0,0,1,gene,W09G3.6,2,13827973,0.643518,83,13828084,28,13827966,35,7
I,-,13827973,0.857143,0.0,441,63,378,267,8,gene,W09G3.6,2,13827973,0.643518,111,13828084,0,13827966,7,7
I,-,13827967,1.0,0.5,1,0,1,1,653,gene,W09G3.6,2,13827966,0.643518,117,13828084,1,13827966,1,0
I,-,13815443,0.0,1.73472e-18,59,59,0,0,0,gene,W09G3.6,2,13815405,0.643518,12641,13828084,38,13815448,-5,-43
I,-,13814307,0.342105,7.05781e-36,1520,1000,520,398,0,gene,W09G3.8,3,13814289,1.11858,433,13814740,18,13814307,0,-18
I,-,13812253,0.00139665,0.0,716,715,1,1,1,gene,W09G3.2,4,13812147,0.598349,2487,13814740,106,13812253,0,-106
I,-,13809293,0.0,0.015625,6,6,0,0,0,gene,W09G3.3,5,13809278,0.796455,2832,13812125,15,13809295,-2,-17
I,-,13807388,0.0,0.000488281,11,11,0,0,1,gene,W09G3.3,5,13807374,0.796455,4737,13812125,14,13807388,0,-14
I,-,13802206,0.377193,0.00238348,114,71,43,33,7,gene,W09G3.7,6,13802197,0.205278,169,13802375,9,13802206,0,-9
I,-,13796658,0.192982,6.90233e-17,171,138,33,20,2,gene,Y37H9A.5,0,13796510,None,673,13797331,148,13796506,152,4
I,-,13794147,0.214286,0.0222168,14,11,3,3,1,gene,Y37H9A.6,0,13794125,1.19511,1898,13796045,22,13794139,8,-14
I,-,13794137,0.616123,2.49487e-08,521,200,321,199,38,gene,Y37H9A.6,0,13794125,1.19511,1908,13796045,12,13794137,0,-12
I,-,13781388,0.0,0.25,2,2,0,0,2,gene,Y37H9A.2,0,13781387,0.00339579,11238,13792626,1,13781387,1,0
I,-,13756339,0.0,0.0,375,375,0,0,6,gene,Y6B3B.5,1,13756209,0.276603,23425,13779764,130,13756326,13,-117
I,-,13756127,0.0,0.03125,5,5,0,0,1,gene,Y6B3B.5,1,13756118,0.276603,23637,13779764,9,13756127,0,-9
I,-,13751118,0.954545,5.24521e-06,22,1,21,15,2,gene,Y6B3B.9,2,13751109,0.392592,98,13751216,9,13751109,9,0
I,-,13751109,0.985714,5.92923e-20,70,1,69,48,95,gene,Y6B3B.9,2,13751109,0.392592,107,13751216,0,13751109,0,0
I,-,13736865,1.0,0.5,1,0,1,1,0,gene,Y6B3B.9,2,13736856,0.392592,14351,13751216,9,13736865,0,-9
I,-,13732029,0.0107527,9.3906e-27,93,92,1,1,10,gene,Y6B3B.10,0,13732010,0.17841,2916,13734945,19,13731975,54,35
I,-,13687565,0.00333333,0.0,300,299,1,1,0,gene,W04A4.6,0,13687556,0.317309,5285,13692850,9,13687556,9,0
I,-,13662307,0.0,0.125,3,3,0,0,2,gene,W09C5.12,0,13662287,None,13551,13675858,20,13662287,20,0
I,-,13659113,0.0078165,0.0,7804,7743,61,55,12,gene,W09C5.8,0,13659111,21.4207,2394,13661507,2,13659113,0,-2
I,-,13653698,0.00283286,0.0,353,352,1,1,3,gene,W09C5.6,0,13653670,131.381,4461,13658159,28,13653691,7,-21
I,-,13653689,0.00586922,0.0,36291,36078,213,193,624,gene,W09C5.6,0,13653670,131.381,4470,13658159,19,13653689,0,-19
I,-,13653680,0.0,3.46945e-18,58,58,0,0,69351,gene,W09C5.6,0,13653670,131.381,4479,13658159,10,13653680,0,-10
I,-,13653250,0.0,0.5,1,1,0,0,11,gene,W09C5.6,0,13653189,131.381,4909,13658159,61,13653250,0,-61
I,-,13648390,0.0,0.0,159,159,0,0,3,gene,W09C5.5,0,13648382,0.381413,4528,13652918,8,13648390,0,-8
I,-,13639209,0.0,0.125,3,3,0,0,16,gene,W09C5.4,0,13639198,0.243056,1084,13640293,11,13639297,-88,-99
I,-,13628433,0.00299018,0.0,2341,2334,7,7,1,gene,W09C5.1,1,13628394,7.28878,9401,13637834,39,13628433,0,-39
I,-,13628395,0.0,0.00390625,8,8,0,0,1544,gene,W09C5.1,1,13628394,7.28878,9439,13637834,1,13628433,-38,-39
I,-,13626211,0.348921,1.26386e-07,278,181,97,75,0,gene,Y6B3A.1,2,13626210,0.630167,288,13626499,1,13626211,0,-1
I,-,13603379,0.933862,0.0,378,25,353,250,1,gene,Y87G2A.13,3,13603379,0.941508,509,13603888,0,13603379,0,0
I,-,13598505,1.0,0.125,3,0,3,2,3,gene,Y87G2A.11,4,13598490,0.34696,90,13598595,15,13598490,15,0
I,-,13598491,0.98913,0.0,184,2,182,134,1,gene,Y87G2A.11,4,13598490,0.34696,104,13598595,1,13598490,1,0
I,-,13588817,0.220414,0.0,676,527,149,108,0,gene,Y87G2A.10,5,13588810,2.07839,245,13589062,7,13588817,0,-7
I,-,13572031,0.00722892,0.0,415,412,3,2,6,gene,Y87G2A.6,0,13572022,0.614372,14135,13586166,9,13572031,0,-9
I,-,13559347,0.00505051,0.0,594,591,3,2,2,gene,Y87G2A.5,0,13559330,1.81288,6890,13566237,17,13559347,0,-17
I,-,13545174,0.00371747,0.0,269,268,1,1,1,gene,Y87G2A.4,0,13545170,0.518631,2701,13547875,4,13545174,0,-4
I,-,13542436,0.0,5.82077e-11,34,34,0,0,6,gene,Y87G2A.3,0,13542381,0.772625,621,13543057,55,13542396,40,-15
I,-,13542343,0.0,3.46945e-18,58,58,0,0,391,gene,Y87G2A.3,0,13542300,0.772625,714,13543057,43,13542396,-53,-96
I,-,13514276,0.00290698,0.0,688,686,2,2,256,gene,Y87G2A.18,0,13514273,0.924086,12970,13527246,3,13514306,-30,-33
I,-,13493303,0.00555556,0.0,540,537,3,2,30,gene,Y87G2A.17,0,13493301,0.498869,18996,13512299,2,13493284,19,17
I,-,13487390,0.012987,5.09543e-22,77,76,1,1,16,gene,Y48G10A.2,0,13487354,0.710023,627,13488017,36,13487390,0,-36
I,-,13474171,0.106256,0.0,1007,900,107,82,0,gene,Y48G10A.3,0,13474167,1.29519,2526,13476697,4,13474171,0,-4
I,-,13470384,0.0,0.5,1,1,0,0,4,gene,Y48G10A.4,0,13470337,0.339463,193,13470577,47,13470337,47,0
I,-,13470357,0.597315,0.00388566,149,60,89,68,42,gene,Y48G10A.4,0,13470337,0.339463,220,13470577,20,13470337,20,0
I,-,13428457,0.0027969,0.0,4648,4635,13,11,2,gene,Y40B1B.7,0,13428450,6.04315,26887,13455344,7,13428459,-2,-9
I,-,13413371,0.0,0.25,2,2,0,0,1,gene,W05H12.2,0,13413073,0.367712,10605,13423976,298,13412865,506,208
I,-,13410495,0.0,0.25,2,2,0,0,16,gene,C01A2.1,0,13410493,0.0363019,1159,13411654,2,13410495,0,-2
I,-,13366872,0.00394737,0.0,760,757,3,2,2,gene,Y40B1A.4,0,13366808,1.55009,43017,13409889,64,13366808,64,0
I,-,13366817,0.0,0.000976562,10,10,0,0,284,gene,Y40B1A.4,0,13366808,1.55009,43072,13409889,9,13366808,9,0
I,-,13336132,0.00208768,0.0,479,478,1,0,1,gene,W08E3.2,0,13336124,1.88599,1295,13337427,8,13336129,3,-5
I,-,13330747,0.0261438,1.92222e-39,153,149,4,4,227,gene,T04D3.5,0,13330743,1.45704,2617,13333364,4,13330759,-12,-16
I,-,13318700,0.0,4.81482e-35,114,114,0,0,8,gene,T04D3.3,0,13318690,0.274057,10460,13329160,10,13318690,10,0
I,-,13304297,0.00890208,0.0,337,334,3,3,10,gene,T04D3.1,0,13304278,0.175121,6582,13310879,19,13304290,7,-12
I,-,13300700,0.0,0.0,549,549,0,0,1,gene,M01E5.6,0,13300687,0.445383,2045,13302745,13,13300701,-1,-14
I,-,13289528,0.00326264,0.0,613,611,2,2,9,gene,M01E5.4,1,13289526,0.816841,8667,13298195,2,13289526,2,0
I,-,13286483,0.443069,0.000148361,808,450,358,276,8,gene,M01E5.3,2,13286325,2.25491,1055,13287538,158,13286483,0,-158
I,-,13280161,0.797297,9.65623e-08,74,15,59,31,10,gene,M01E5.2,3,13280142,0.217559,717,13280878,19,13280161,0,-19
I,-,13265570,0.0,6.93889e-18,57,57,0,0,11,gene,F44F1.4,0,13265556,0.138223,54,13265624,14,13265556,14,0
I,-,13262727,0.0,2.1684e-19,62,62,0,0,1,gene,F44F1.6,0,13262713,0.157375,964,13263691,14,13262713,14,0
I,-,13260208,0.0,1.77636e-15,49,49,0,0,1,gene,F44F1.5,0,13260203,0.0900798,645,13260853,5,13260203,5,0
I,-,13161507,0.5,0.5,2,1,1,0,0,gene,F22G12.4,1,13161486,0.429196,21929,13183436,21,13161486,21,0
I,-,13161494,0.959677,1.05865e-29,124,5,119,77,18,gene,F22G12.4,1,13161486,0.429196,21942,13183436,8,13161486,8,0
I,-,13138528,0.0,0.00390625,8,8,0,0,0,gene,C17H1.7,0,13138507,0.681865,16681,13155209,21,13138507,21,0
I,-,13138521,0.010989,3.67546e-26,91,90,1,1,4,gene,C17H1.7,0,13138507,0.681865,16688,13155209,14,13138507,14,0
I,-,13132450,0.0,0.125,3,3,0,0,0,gene,C17H1.6,0,13132398,0.163484,3932,13136382,52,13132450,0,-52
I,-,13130156,0.0,0.125,3,3,0,0,0,gene,C17H1.8,0,13130026,0.00905742,643,13130799,130,13130156,0,-130
I,-,13112430,0.0,7.62939e-06,17,17,0,0,6,gene,C17H1.4,0,13112416,0.0680841,5247,13117677,14,13112416,14,0
I,-,13103061,0.0,1.45519e-11,36,36,0,0,2,gene,C17H1.2,0,13103045,0.122129,4415,13107476,16,13103045,16,0
I,-,13072942,0.0,2.32831e-10,32,32,0,0,0,gene,Y26D4A.3,0,13072928,0.0260714,1002,13073944,14,13073048,-106,-120
I,-,13062108,0.00561798,0.0,178,177,1,0,0,gene,W05B5.3,0,13062087,0.356537,7392,13069500,21,13062108,0,-21
I,-,13059611,0.0,1.52588e-05,16,16,0,0,20,gene,W05B5.3,0,13059518,0.356537,9889,13069500,93,13059611,0,-93
I,-,12968266,0.00429185,0.0,3262,3248,14,10,16,gene,C47B2.4,0,12968265,4.52971,87541,13055807,1,12968268,-2,-3
I,-,12966702,0.0,2.1684e-19,62,62,0,0,64,gene,C47B2.3,1,12966598,24.3891,500,12967202,104,12966763,-61,-165
I,-,12966257,0.00527903,0.0,7956,7914,42,39,2,gene,C47B2.3,1,12966249,24.3891,945,12967202,8,12966257,0,-8
I,-,12964565,0.87907,4.28774e-32,215,26,189,147,8,gene,C47B2.2,2,12964556,1.27539,88,12964653,9,12964556,9,0
I,-,12964558,0.824945,0.0,457,80,377,272,180,gene,C47B2.2,2,12964556,1.27539,95,12964653,2,12964556,2,0
I,-,12959918,0.724221,5.82313e-21,417,115,302,236,0,gene,F08A8.7,4,12959905,0.438811,395,12960313,13,12959918,0,-13
I,-,12907754,0.0,0.000244141,12,12,0,0,2,gene,Y18D10A.18,0,12907741,0.0147288,368,12908122,13,12907741,13,0
I,-,12903453,0.00235849,0.0,424,423,1,1,0,gene,Y18D10A.16,0,12903436,1.7399,3011,12906464,17,12903453,0,-17
I,-,12869557,0.0,8.27181e-25,80,80,0,0,0,gene,Y18D10A.23,0,12869543,0.358887,33493,12903050,14,12869543,14,0
I,-,12858257,0.0116959,0.0,342,338,4,3,0,gene,Y18D10A.9,0,12858249,0.610897,3716,12861973,8,12858249,8,0
I,-,12806568,0.0,6.46235e-27,87,87,0,0,19,gene,Y18D10A.1,0,12806533,0.326088,965,12807533,35,12806568,0,-35
I,-,12764947,0.0,0.0,258,258,0,0,0,gene,B0019.1,0,12764935,0.499841,10769,12775716,12,12764947,0,-12
I,-,12732709,0.79798,3.26199e-18,198,40,158,112,35,gene,W02A11.1,2,12732684,0.583698,574,12733283,25,12732692,17,-8
I,-,12722868,0.0,0.0,319,319,0,0,0,gene,T06G6.12,0,12722859,0.340951,7141,12730009,9,12722859,9,0
I,-,12714711,0.0,3.63798e-12,38,38,0,0,6,gene,T06G6.4,0,12714688,0.0506876,7321,12722032,23,12714688,23,0
I,-,12682679,0.0,1.90735e-06,19,19,0,0,9,gene,T26E3.10,0,12682668,0.130853,25007,12707686,11,12682668,11,0
I,-,12655999,0.0,0.25,2,2,0,0,4,gene,T26E3.7,0,12655957,0.0310617,1749,12657748,42,12655957,42,0
I,-,12652074,0.00297619,0.0,336,335,1,1,0,gene,H28O16.2,0,12652061,0.616726,3135,12655209,13,12652074,0,-13
I,-,12644292,0.0,0.00390625,8,8,0,0,2,gene,H16D19.4,0,12644256,0.0237641,3069,12647361,36,12644414,-122,-158
I,-,12625223,0.00393701,0.0,508,506,2,0,4,gene,T07D10.6,0,12625211,0.823488,1441,12626664,12,12625225,-2,-14
I,-,12606238,0.142857,0.0546875,7,6,1,1,27,gene,T07D10.1,0,12606234,0.0192498,17938,12624176,4,12606235,3,-1
I,-,12603083,0.0,0.5,1,1,0,0,0,gene,T07D10.10,0,12603035,None,674,12603757,48,12602944,139,91
I,-,12592338,0.0,0.0,547,547,0,0,0,gene,F33E2.5,0,12592335,0.970422,4120,12596458,3,12592339,-1,-4
I,-,12572788,0.0,0.0,426,426,0,0,1,gene,F33E2.2,0,12572783,0.919023,5305,12578093,5,12572783,5,0
I,-,12571562,0.0,2.91038e-11,35,35,0,0,2,gene,F33E2.2,0,12571502,0.919023,6531,12578093,60,12571562,0,-60
I,-,12570871,0.0,0.000976562,10,10,0,0,0,gene,F33E2.2,0,12570851,0.919023,7222,12578093,20,12570871,0,-20
I,-,12560661,0.0,0.0625,4,4,0,0,849,gene,W02D9.6,0,12560659,1.6769,378,12561039,2,12560696,-35,-37
I,-,12538973,0.0,0.0,155,155,0,0,18,gene,W02D9.4,0,12538942,0.13122,20379,12559352,31,12538942,31,0
I,-,12532122,0.00796813,0.0,251,249,2,1,388,gene,W02D9.1,0,12532114,1.25928,5772,12537894,8,12532169,-47,-55
I,-,12499396,0.00195312,0.0,512,511,1,1,9,gene,T27F6.8,0,12499375,0.805643,28896,12528292,21,12499804,-408,-429
I,-,12426502,0.0,2.58494e-26,85,85,0,0,5,gene,E03H4.8,0,12426478,0.282188,3521,12430023,24,12426502,0,-24
I,-,12327011,0.0,1.86265e-09,29,29,0,0,3,gene,C47F8.7,0,12326998,0.0436442,1073,12328084,13,12326998,13,0
I,-,12274413,0.0,0.0625,4,4,0,0,4,gene,F41D3.9,0,12274336,0.00375437,2466,12276879,77,12274615,-202,-279
I,-,12272214,0.0,0.5,1,1,0,0,2,gene,F41D3.10,0,12272178,0,753,12272967,36,12272178,36,0
I,-,12222286,0.0,2.98023e-08,25,25,0,0,0,gene,F14B6.2,0,12222277,0.15046,32206,12254492,9,12222205,81,72
I,-,12190206,0.00526316,0.0,190,189,1,0,4,gene,R05D7.7,0,12190195,None,26149,12216355,11,12190190,16,5
I,-,12183180,0.0,1.90735e-06,19,19,0,0,130,gene,R05D7.4,0,12183156,0.653052,6397,12189577,24,12183242,-62,-86
I,-,12163521,0.00164339,0.0,1217,1215,2,2,0,gene,R05D7.1,0,12163521,2.02126,4661,12168182,0,12163523,-2,-2
I,-,12136455,0.0,0.0625,4,4,0,0,12,gene,M01G12.1,0,12136453,0.000935158,11611,12148066,2,12136453,2,0
I,-,12105975,0.0,1.19209e-07,23,23,0,0,1,gene,M01G12.12,0,12105965,0.199992,1065,12107040,10,12105965,10,0
I,-,12094577,0.0,3.05176e-05,15,15,0,0,4,gene,Y47H10A.4,0,12094476,0.123716,897,12095474,101,12094468,109,8
I,-,12084111,0.0,0.5,1,1,0,0,29,gene,Y47H10A.1,0,12084078,0.0564036,692,12084803,33,12083599,512,479
I,-,12068654,0.0625,1.15484e-07,32,30,2,1,2,gene,F58D5.2,1,12068648,0.6536,4413,12073067,6,12068648,6,0
I,-,12068134,0.0,0.25,2,2,0,0,0,gene,F58D5.2,1,12068131,0.6536,4933,12073067,3,12068134,0,-3
I,-,12066318,0.00591716,0.0,169,168,1,1,7,gene,F58D5.2,1,12066305,0.6536,6749,12073067,13,12066318,0,-13
I,-,12064885,0.00325354,0.0,4303,4289,14,11,28,gene,F58D5.1,2,12064875,4.93588,1051,12065936,10,12064885,0,-10
I,-,12059786,0.684848,4.40479e-12,330,104,226,188,2,gene,F58D5.4,3,12059770,0.403676,477,12060263,16,12059786,0,-16
I,-,12059683,0.0,0.5,1,1,0,0,28,gene,F58D5.4,3,12059579,0.403676,580,12060263,104,12059683,0,-104
I,-,12055031,0.0,7.10543e-15,47,47,0,0,23,gene,F58D5.4,3,12054960,0.403676,5232,12060263,71,12055031,0,-71
I,-,12046603,0.138889,5.48596e-06,36,31,5,3,2,gene,F58D5.9,0,12046581,0.108253,724,12047327,22,12046581,22,0
I,-,11969851,0.0,3.05176e-05,15,15,0,0,0,gene,Y53C10A.3,0,11969835,0.0101389,1315,11971166,16,11969835,16,0
I,-,11961972,0.0211416,0.0,473,463,10,10,1,gene,Y53C10A.12,0,11961950,1.04718,5538,11967510,22,11961972,0,-22
I,-,11929497,0.0013587,0.0,736,735,1,1,1,gene,R06C1.3,1,11929495,0.911778,24003,11953500,2,11929495,2,0
I,-,11923901,0.825726,0.0,482,84,398,277,3,gene,R06C1.2,2,11923896,0.615917,1132,11925033,5,11923896,5,0
I,-,11917707,0.909091,4.8026e-22,121,11,110,86,2,gene,R06C1.1,3,11917700,0.778072,103,11917810,7,11917700,7,0
I,-,11917700,0.875,2.19603e-30,208,26,182,128,256,gene,R06C1.1,3,11917700,0.778072,110,11917810,0,11917700,0,0
I,-,11912665,0.513995,0.0108731,1572,764,808,589,1,gene,R09B3.5,4,11912664,7.8057,114,11912779,1,11912665,0,-1
I,-,11909699,0.0,0.000488281,11,11,0,0,4336,gene,R09B3.1,2,11909613,0.623681,610,11910309,86,11909239,460,374
I,-,11909239,0.897243,0.0,399,41,358,294,12,gene,R09B3.1,2,11909194,0.623681,105,11909344,45,11909239,0,-45
I,-,11893715,0.0,0.0,304,304,0,0,2,gene,Y47H9C.7,0,11893708,1.08668,5742,11899457,7,11893715,0,-7
I,-,11868093,0.0016116,0.0,1241,1239,2,2,17,gene,Y47H9C.4,0,11868087,1.05267,20396,11888489,6,11868093,0,-6
I,-,11833117,0.0,0.125,3,3,0,0,10,gene,Y47H9C.1,0,11833108,0.19641,18385,11851502,9,11833154,-37,-46
I,-,11803150,0.0,0.000976562,10,10,0,0,2,gene,T02G6.2,0,11803061,0.0863629,5968,11809118,89,11802989,161,72
I,-,11792106,0.0,0.0,173,173,0,0,0,gene,ZK1151.1,0,11792067,2.68252,4913,11797019,39,11792106,0,-39
I,-,11792075,0.0,0.000976562,10,10,0,0,55,gene,ZK1151.1,0,11792067,2.68252,4944,11797019,8,11792054,21,13
I,-,11712185,0.0,0.5,1,1,0,0,4,gene,F35E2.6,0,11712185,0.0394313,3019,11715204,0,11712185,0,0
I,-,11690818,0.00503778,0.0,397,395,2,1,1,gene,T22H2.5,0,11690809,0.935301,3888,11694706,9,11690818,0,-9
I,-,11682408,0.0,4.33681e-19,61,61,0,0,2,gene,F11A6.2,0,11682352,0.451981,3674,11686082,56,11682352,56,0
I,-,11682359,0.0,0.0,180,180,0,0,22,gene,F11A6.2,0,11682352,0.451981,3723,11686082,7,11682352,7,0
I,-,11611302,0.0137931,2.34073e-40,145,143,2,1,4,gene,C17D12.7,0,11611289,0.488671,5784,11617086,13,11611289,13,0
I,-,11581975,0.0,2.38419e-07,22,22,0,0,9,gene,F15D3.8,0,11581974,0.0835802,754,11582729,1,11581974,1,0
I,-,11577476,0.00164474,0.0,1216,1214,2,1,81,gene,F15D3.6,0,11577447,1.44592,2372,11579848,29,11577476,0,-29
I,-,11557834,0.0,2.27374e-13,42,42,0,0,3,gene,F15D3.1,0,11557834,0.865243,2772,11560606,0,11557780,54,54
I,-,11529662,0.0,0.0625,4,4,0,0,9,gene,F15D3.1,0,11529656,0.865243,12234,11541896,6,11529790,-128,-134
I,-,11529648,0.0,0.125,3,3,0,0,86,gene,F15D3.1,0,11529607,0.865243,12248,11541896,41,11529790,-142,-183
I,-,11499599,0.0,0.000976562,10,10,0,0,74,gene,K08C9.6,0,11499582,0.30172,13209,11512808,17,11499643,-44,-61
I,-,11496267,0.333333,0.375,3,2,1,0,16,gene,K08C9.7,0,11496260,0.00668942,2169,11498436,7,11496233,34,27
I,-,11490562,0.0,0.015625,6,6,0,0,49,gene,K08C9.4,0,11490548,2.44843,1766,11492328,14,11490548,14,0
I,-,11416416,0.0,0.0,293,293,0,0,0,gene,Y53H1C.2,1,11416409,0.66944,7567,11423983,7,11416409,7,0
I,-,11396649,0.831325,4.2039e-45,415,70,345,284,3,gene,Y53H1C.1,2,11396647,0.598664,3900,11400549,2,11396649,0,-2
I,-,11374324,0.0769231,4.84288e-06,26,24,2,2,55,gene,F56G4.6,0,11374308,0.182234,14412,11388736,16,11374308,16,0
I,-,11341511,0.0037037,0.0,270,269,1,1,10,gene,M04D5.3,0,11341507,None,564,11342075,4,11341511,0,-4
I,-,11323100,0.00268817,0.0,372,371,1,1,6,gene,H25P06.1,0,11323082,0.838558,16669,11339769,18,11323100,0,-18
I,-,11280008,0.0,0.0,163,163,0,0,0,gene,F36D1.1,1,11280004,0.361513,2453,11282461,4,11280010,-2,-6
I,-,11276336,0.981481,2.9976e-15,54,1,53,25,1,gene,F36D1.9,2,11276320,0.373434,101,11276437,16,11276320,16,0
I,-,11276325,0.943396,2.10269e-23,106,6,100,39,194,gene,F36D1.9,2,11276320,0.373434,112,11276437,5,11276320,5,0
I,-,11221985,0.0,0.0,747,747,0,0,0,gene,Y53H1A.1,0,11221965,0.503756,12305,11234290,20,11221965,20,0
I,-,11215082,0.0,0.000976562,10,10,0,0,0,gene,Y53H1A.4,0,11215081,0.018912,1026,11216108,1,11215081,1,0
I,-,11182053,0.0075188,0.0,266,264,2,2,19,gene,F28D9.1,1,11182052,0.844477,34055,11216108,1,11182053,0,-1
I,-,11177716,0.945946,0.0,518,28,490,354,11,gene,F28D9.4,2,11177712,0.795371,122,11177838,4,11177712,4,0
I,-,11134658,0.0,2.91038e-11,35,35,0,0,31,gene,W02B9.1,0,11134637,2.35357,19126,11153784,21,11134658,0,-21
I,-,11094515,0.0,0.0,1688,1688,0,0,4,gene,W02B9.1,0,11094250,2.35357,59269,11153784,265,11094515,0,-265
I,-,11038818,0.0144928,0.0,207,204,3,3,6,gene,Y52B11A.9,0,11038810,0.666707,29606,11068424,8,11038818,0,-8
I,-,11025644,0.0,0.5,1,1,0,0,7,gene,Y52B11A.7,0,11025644,0.00300353,8402,11034046,0,11025644,0,0
I,-,11004274,0.0,0.00195312,9,9,0,0,0,gene,Y52B11A.4,0,11004274,0.406706,7058,11011332,0,11004274,0,0
I,-,10970162,0.0163934,2.64545e-17,61,60,1,1,0,gene,Y52B11A.2,0,10970157,0.464094,9428,10979590,5,10970157,5,0
I,-,10935544,0.0026455,0.0,756,754,2,2,2,gene,F49D11.9,1,10935538,1.11921,776,10936320,6,10935703,-159,-165
I,-,10933694,0.958549,2.8026e-45,193,8,185,126,8,gene,F49D11.10,2,10933694,None,107,10933801,0,10933694,0,0
I,-,10925751,0.0,0.03125,5,5,0,0,8,gene,F49D11.8,3,10925737,1.89644,1128,10926879,14,10925737,14,0
I,-,10925742,0.0164975,0.0,1576,1550,26,21,18,gene,F49D11.8,3,10925737,1.89644,1137,10926879,5,10925737,5,0
I,-,10894228,0.0,0.0,182,182,0,0,0,gene,T27C10.6,0,10894216,0.338524,12558,10906786,12,10894228,0,-12
I,-,10878367,0.142857,0.0546875,7,6,1,1,32,gene,T27C10.7,0,10878317,7.29752,1393,10879760,50,10878369,-2,-52
I,-,10784968,0.8,0.15625,5,1,4,4,0,gene,F55A3.6,0,10784968,0.0235684,140,10785108,0,10784778,190,190
I,-,10733651,0.00733753,0.0,954,947,7,6,25,gene,B0205.11,1,10733645,1.81781,7704,10741355,6,10733672,-21,-27
I,-,10732411,0.890554,0.0,1535,168,1367,893,7,gene,B0205.3,2,10732378,2.86542,118,10732529,33,10732411,0,-33
I,-,10730220,0.458904,0.0174388,292,158,134,93,50,gene,B0205.8,3,10730205,2.09263,478,10730698,15,10730224,-4,-19
I,-,10716982,0.0,7.10543e-15,47,47,0,0,11,gene,B0205.1,0,10716971,0.515073,6739,10723721,11,10716982,0,-11
I,-,10703788,0.0,9.31323e-10,30,30,0,0,20,gene,C34B2.9,0,10703787,0.210081,9650,10713438,1,10703787,1,0
I,-,10687775,0.0,0.03125,5,5,0,0,92,gene,C34B2.8,0,10687502,8.62516,11781,10699556,273,10687045,730,457
I,-,10687045,0.0097586,0.0,1947,1928,19,17,5,gene,C34B2.8,0,10687040,8.62516,12511,10699556,5,10687045,0,-5
I,-,10685574,0.0144928,0.0,483,476,7,6,136,gene,C34B2.7,1,10685570,1.01512,211,10685785,4,10685574,0,-4
I,-,10683035,0.272286,0.0,1649,1200,449,372,83,gene,C34B2.10,2,10683027,3.62644,222,10683257,8,10683137,-102,-110
I,-,10682361,0.894737,2.65926e-19,114,12,102,85,1,gene,C34B2.6,3,10682359,0.874801,97,10682458,2,10682361,0,-2
I,-,10682220,1.0,0.0625,4,0,4,4,87,gene,C34B2.6,3,10682187,0.874801,238,10682458,33,10682361,-141,-174
I,-,10682211,1.0,0.25,2,0,2,2,104,gene,C34B2.6,3,10682187,0.874801,247,10682458,24,10682361,-150,-174
I,-,10676798,0.955157,0.0,223,10,213,152,5,gene,C34B2.5,4,10676790,0.639735,110,10676908,8,10676798,0,-8
I,-,10676792,0.666667,0.375,3,1,2,2,201,gene,C34B2.5,4,10676790,0.639735,116,10676908,2,10676798,-6,-8
I,-,10666920,0.00571429,0.0,350,348,2,2,15,gene,B0511.14,0,10666864,0.545054,4527,10671447,56,10666864,56,0
I,-,10642268,0.00239904,0.0,2501,2495,6,6,1,gene,B0511.10,1,10642262,2.14929,6323,10648591,6,10642268,0,-6
I,-,10640215,0.902913,0.0,618,60,558,417,6,gene,B0511.9,2,10640214,2.21281,197,10640412,1,10640215,0,-1
I,-,10640120,1.0,0.25,2,0,2,2,129,gene,B0511.9,2,10640104,2.21281,292,10640412,16,10640215,-95,-111
I,-,10638964,0.95,1.90735e-05,20,1,19,13,14,gene,B0511.8,3,10638943,1.10866,102,10639066,21,10638964,0,-21
I,-,10638953,0.972414,0.0,1305,36,1269,907,50,gene,B0511.8,3,10638943,1.10866,113,10639066,10,10638953,0,-10
I,-,10636015,0.869565,0.00021112,23,3,20,12,5,gene,B0511.13,4,10635993,0.428334,664,10636679,22,10636004,11,-11
I,-,10633137,0.558511,0.0161044,188,83,105,84,21,gene,B0511.7,5,10633134,1.18435,129,10633266,3,10633137,0,-3
I,-,10582596,0.00174902,0.0,2287,2283,4,3,0,gene,T22A3.2,0,10582595,2.81284,7862,10590458,1,10582595,1,0
I,-,10538069,0.0,0.0,488,488,0,0,3,gene,F25H2.1,0,10538034,0.376622,15030,10553099,35,10538069,0,-35
I,-,10484958,0.0,0.0,193,193,0,0,3,gene,F37D6.1,1,10484950,0.465835,22032,10506990,8,10484958,0,-8
I,-,10478118,0.235659,2.2701e-43,645,493,152,129,11,gene,F37D6.2,2,10478084,1.06876,1172,10479290,34,10478118,0,-34
I,-,10478107,0.125,0.03125,8,7,1,1,1190,gene,F37D6.2,2,10478084,1.06876,1183,10479290,23,10478107,0,-23
I,-,10474424,0.0166667,0.0,180,177,3,3,0,gene,Y106G6H.15,1,10474423,0.744518,1092,10475516,1,10474423,1,0
I,-,10473378,0.837321,0.0,627,102,525,358,21,gene,Y106G6H.14,2,10473377,0.739874,121,10473499,1,10473378,0,-1
I,-,10471045,0.907895,5.7661e-40,228,21,207,153,3,gene,Y106G6H.12,3,10471045,0.414692,1140,10472185,0,10471045,0,0
I,-,10446122,0.00524934,0.0,381,379,2,2,11,gene,Y106G6H.6,1,10446079,0.94293,8169,10454291,43,10446122,0,-43
I,-,10443572,1.0,0.25,2,0,2,2,1,gene,Y106G6H.5,2,10443539,0.951436,85,10443657,33,10443552,20,-13
I,-,10443552,0.951613,0.0,620,30,590,387,11,gene,Y106G6H.5,2,10443539,0.951436,105,10443657,13,10443552,0,-13
I,-,10437761,0.0,1.69407e-21,69,69,0,0,3,gene,Y106G6H.4,0,10437697,0.172934,279,10438040,64,10437697,64,0
I,-,10437708,0.0,1.49012e-08,26,26,0,0,27,gene,Y106G6H.4,0,10437697,0.172934,332,10438040,11,10437697,11,0
I,-,10436290,1.0,0.5,1,0,1,0,30,gene,Y106G6H.2,0,10436253,51.9915,599,10436889,37,10435864,426,389
I,-,10435396,0.0,0.25,2,2,0,0,32,gene,Y106G6H.2,0,10435219,51.9915,1493,10436889,177,10435398,-2,-179
I,-,10435226,0.0666667,4.03304e-10,45,42,3,1,370,gene,Y106G6H.2,0,10435219,51.9915,1663,10436889,7,10435226,0,-7
I,-,10421846,0.0,2.98023e-08,25,25,0,0,0,gene,F25D7.4,0,10421846,0.594959,1038,10422884,0,10421846,0,0
I,-,10400165,0.00726744,0.0,688,683,5,5,36,gene,F25D7.1,0,10400165,2.98305,18057,10418222,0,10400165,0,0
I,-,10391376,0.0,4.23516e-22,71,71,0,0,4,gene,F45H11.4,0,10391371,0.213299,7590,10398966,5,10391304,72,67
I,-,10373857,0.0,0.0,471,471,0,0,5,gene,F45H11.2,0,10373847,6.5618,8877,10382734,10,10373850,7,-3
I,-,10373850,0.00248242,0.0,7251,7233,18,16,108,gene,F45H11.2,0,10373847,6.5618,8884,10382734,3,10373850,0,-3
I,-,10349434,0.0909091,0.00537109,11,10,1,0,3,gene,ZC434.8,0,10349433,2.78056,23922,10373356,1,10349357,77,76
I,-,10349357,0.00227402,0.0,1759,1755,4,4,20,gene,ZC434.8,0,10349307,2.78056,23999,10373356,50,10349357,0,-50
I,-,10349351,0.00379651,0.0,1317,1312,5,5,182,gene,ZC434.8,0,10349307,2.78056,24005,10373356,44,10349357,-6,-50
I,-,10335657,0.0,0.125,3,3,0,0,9,gene,ZC434.3,0,10335645,0.300854,12336,10347993,12,10335727,-70,-82
I,-,10333070,0.0,1.88079e-37,122,122,0,0,7,gene,ZC434.4,0,10333047,1.34661,390,10333460,23,10333070,0,-23
I,-,10333057,0.0,1.4013e-45,149,149,0,0,512,gene,ZC434.4,0,10333047,1.34661,403,10333460,10,10333070,-13,-23
I,-,10333050,0.0,0.00390625,8,8,0,0,794,gene,ZC434.4,0,10333047,1.34661,410,10333460,3,10333070,-20,-23
I,-,10323342,0.0,0.125,3,3,0,0,46,gene,Y106G6G.4,0,10323270,0.625926,8496,10331838,72,10323242,100,28
I,-,10279227,0.0,0.000976562,10,10,0,0,1,gene,ZC247.1,0,10279222,0.677041,12643,10291870,5,10279222,5,0
I,-,10262101,0.0,0.25,2,2,0,0,75,gene,ZC247.2,0,10262091,0.245521,2206,10264307,10,10262194,-93,-103
I,-,10231201,0.00239234,0.0,418,417,1,1,2,gene,Y106G6E.6,1,10231131,2.53113,24370,10255571,70,10231201,0,-70
I,-,10226959,0.94186,7.99074e-37,172,10,162,112,46,gene,Y106G6E.5,2,10226959,0.666498,118,10227077,0,10226959,0,0
I,-,10222765,0.97546,2.42425e-42,163,4,159,88,0,gene,Y106G6E.4,3,10222765,0.610811,102,10222867,0,10222765,0,0
I,-,10196985,0.011236,0.0,178,176,2,1,3,gene,C25A1.11,0,10196977,0.731095,1286,10198271,8,10196987,-2,-10
I,-,10196978,0.0,0.00012207,13,13,0,0,58,gene,C25A1.11,0,10196977,0.731095,1293,10198271,1,10196987,-9,-10
I,-,10192819,0.0114286,0.0,350,346,4,4,132,gene,C25A1.12,0,10192819,1.09221,1095,10193914,0,10192881,-62,-62
I,-,10190883,0.00806452,0.0,372,369,3,3,29,gene,C25A1.10,0,10190867,3.1608,402,10191285,16,10190883,0,-16
I,-,10185501,0.0,0.0078125,7,7,0,0,0,gene,C25A1.8,0,10185486,21.3171,1023,10186524,15,10185455,46,31
I,-,10185375,0.0,3.05176e-05,15,15,0,0,20145,gene,C25A1.8,0,10185121,21.3171,1149,10186524,254,10185455,-80,-334
I,-,10172604,0.0,0.00390625,8,8,0,0,17,gene,C25A1.4,0,10172554,2.03024,11858,10184462,50,10172590,14,-36
I,-,10172590,0.00222965,0.0,1794,1790,4,2,28,gene,C25A1.4,0,10172554,2.03024,11872,10184462,36,10172590,0,-36
I,-,10165113,0.05,1.90735e-05,20,19,1,1,5,gene,C25A1.2,0,10165109,0.0507096,4513,10169626,4,10165113,0,-4
I,-,10161870,0.00561798,0.0,356,354,2,2,0,gene,C25A1.3,0,10161863,0.372351,1860,10163730,7,10161870,0,-7
I,-,10122089,0.0,7.27596e-12,37,37,0,0,99,gene,Y106G6D.6,0,10122077,0.498643,28177,10150266,12,10122089,0,-12
I,-,10121294,0.0,0.5,1,1,0,0,10,gene,Y106G6D.6,0,10121229,0.498643,410,10121704,65,10121294,0,-65
I,-,10101998,0.00153374,0.0,652,651,1,1,18,gene,B0379.4,0,10101914,1.62539,5334,10107332,84,10101998,0,-84
I,-,10101931,0.0,0.00390625,8,8,0,0,114,gene,B0379.4,0,10101914,1.62539,5401,10107332,17,10101998,-67,-84
I,-,10094466,0.0,0.0,195,195,0,0,0,gene,B0379.4,0,10094409,1.62539,12866,10107332,57,10094466,0,-57
I,-,10088746,0.0,9.09495e-13,40,40,0,0,2,gene,B0379.4,0,10088738,1.62539,18586,10107332,8,10088738,8,0
I,-,10062012,0.0,4.33681e-19,61,61,0,0,13,gene,F10G8.8,0,10062003,0.648051,8859,10070871,9,10061995,17,8
I,-,10034802,0.00260902,0.0,2683,2676,7,6,5,gene,F10G8.5,0,10034765,5.59066,15837,10050639,37,10034802,0,-37
I,-,9999915,0.0,0.0,211,211,0,0,7,gene,T23D8.8,0,9999915,0.195417,21794,10021709,0,9999915,0,0
I,-,9985307,0.0,0.00195312,9,9,0,0,2,gene,T23D8.9,0,9985090,0.646346,3132,9988439,217,9984812,495,278
I,-,9984812,0.00581395,0.0,172,171,1,1,2,gene,T23D8.9,0,9984773,0.646346,3627,9988439,39,9984812,0,-39
I,-,9979649,0.00826446,0.0,605,600,5,5,0,gene,T23D8.4,1,9979647,3.14356,415,9980064,2,9979649,0,-2
I,-,9976302,0.915094,0.0,636,54,582,356,26,gene,T23D8.3,2,9976273,2.17719,112,9976414,29,9976273,29,0
I,-,9961958,0.00675676,4.14784e-43,148,147,1,1,1,gene,T24D1.4,0,9961958,0.52977,7980,9969938,0,9961958,0,0
I,-,9960082,0.00284738,0.0,1756,1751,5,4,12,gene,T24D1.3,1,9960071,1.1899,335,9960417,11,9960142,-60,-71
I,-,9958344,0.920807,0.0,644,51,593,505,1,gene,T24D1.5,2,9958332,0.448652,427,9958771,12,9958344,0,-12
I,-,9955860,0.721843,4.18042e-28,586,163,423,368,2,gene,T24D1.2,3,9955821,0.941442,277,9956137,39,9955860,0,-39
I,-,9955853,0.6,0.3125,5,2,3,3,449,gene,T24D1.2,3,9955821,0.941442,284,9956137,32,9955860,-7,-39
I,-,9938288,0.00555556,0.0,180,179,1,1,4,gene,Y106G6A.1,1,9938216,0.546001,15106,9953394,72,9938288,0,-72
I,-,9936010,0.886525,0.0,423,48,375,248,9,gene,Y106G6A.5,2,9936002,1.34208,102,9936112,8,9936002,8,0
I,-,9934278,0.00540541,0.0,370,368,2,2,5,gene,Y106G6A.2,0,9934241,1.00986,347,9934625,37,9934278,0,-37
I,-,9910533,0.0,2.24208e-44,145,145,0,0,18,gene,F52F12.6,0,9910515,1.10886,10677,9921210,18,9910533,0,-18
I,-,9900805,0.0,0.0,399,399,0,0,3,gene,F52F12.3,0,9900803,0.611576,2096,9902901,2,9900805,0,-2
I,-,9895846,1.0,0.5,1,0,1,0,22,gene,F52F12.2,0,9895771,0.0303238,7055,9902901,75,9895584,262,187
I,-,9895487,0.666667,0.375,3,1,2,1,10,gene,F52F12.2,0,9895479,0.0303238,126,9895613,8,9895584,-97,-105
I,-,9891532,0.0,1.49012e-08,26,26,0,0,1,gene,F52F12.1,0,9891499,0.0603033,2152,9893684,33,9891532,0,-33
I,-,9881490,0.0,0.0,702,702,0,0,0,gene,T23H4.2,0,9881481,0.613013,6854,9888344,9,9881489,1,-8
I,-,9852042,0.0,3.30872e-24,78,78,0,0,0,gene,K10C3.2,0,9852025,4.54053,10140,9862182,17,9851781,261,244
I,-,9851779,0.00250627,0.0,1995,1990,5,4,8,gene,K10C3.2,0,9851709,4.54053,10403,9862182,70,9851779,0,-70
I,-,9815507,0.0,0.5,1,1,0,0,2,gene,F35C12.3,0,9815420,0.629758,14242,9829749,87,9815507,0,-87
I,-,9814181,0.015748,4.70257e-35,127,125,2,2,15,gene,F35C12.3,0,9814181,0.629758,320,9814501,0,9814181,0,0
I,-,9787378,0.0117729,0.0,2888,2854,34,31,10,gene,F26E4.8,1,9787365,21.7046,25644,9813022,13,9787378,0,-13
I,-,9785732,1.0,0.5,1,0,1,1,4,gene,F26E4.10,2,9785710,0.297296,34,9785766,22,9785710,22,0
I,-,9785722,0.833333,0.09375,6,1,5,5,5,gene,F26E4.10,2,9785710,0.297296,44,9785766,12,9785710,12,0
I,-,9785710,0.927536,1.41875e-27,138,10,128,105,13,gene,F26E4.10,2,9785710,0.297296,56,9785766,0,9785710,0,0
I,-,9772553,0.00324675,0.0,308,307,1,0,150,gene,F26E4.4,0,9772548,0.796497,8764,9781317,5,9772553,0,-5
I,-,9760773,0.000389257,0.0,2569,2568,1,1,10,gene,F26E4.2,0,9760773,2.06773,1618,9762391,0,9760806,-33,-33
I,-,9747911,0.00507614,0.0,197,196,1,1,649,gene,K02A11.3,0,9747904,0.602785,369,9748280,7,9747942,-31,-38
I,-,9717656,0.0,0.015625,6,6,0,0,1,gene,C16C2.3,1,9717597,0.540311,26539,9744195,59,9717656,0,-59
I,-,9715218,0.923274,0.0,782,60,722,487,0,gene,C16C2.4,2,9715209,1.33487,92,9715310,9,9715218,0,-9
I,-,9712736,1.0,0.0625,4,0,4,3,4,gene,C04F12.10,3,9712706,1.7096,75,9712811,30,9712707,29,-1
I,-,9712707,0.923554,0.0,484,37,447,248,22,gene,C04F12.10,3,9712706,1.7096,104,9712811,1,9712707,0,-1
I,-,9710733,0.00183038,0.0,1639,1636,3,3,47,gene,C04F12.9,0,9710731,2.11665,324,9711057,2,9710755,-22,-24
I,-,9699547,0.012987,5.09543e-22,77,76,1,0,1,gene,C04F12.8,0,9699543,0.656595,10532,9710079,4,9699543,4,0
I,-,9696673,0.0,0.125,3,3,0,0,495,gene,C04F12.7,0,9696583,2.57176,577,9697250,90,9696750,-77,-167
I,-,9690545,0.0239521,1.66755e-43,167,163,4,3,0,gene,C04F12.5,0,9690545,0.717293,2101,9692646,0,9690545,0,0
I,-,9678539,0.0,0.0,589,589,0,0,0,gene,C04F12.1,0,9678486,0.985506,11547,9690086,53,9678541,-2,-55
I,-,9670714,0.0,5.96046e-08,24,24,0,0,3,gene,C03D6.1,0,9670706,0.175207,2942,9673656,8,9670703,11,3
I,-,9664903,0.0080429,0.0,373,370,3,2,0,gene,C03D6.4,0,9664901,1.07449,3715,9668618,2,9665132,-229,-231
I,-,9657920,0.0,2.32831e-10,32,32,0,0,0,gene,C03D6.6,0,9657865,0.732684,803,9658723,55,9657838,82,27
I,-,9634840,0.0,0.5,1,1,0,0,21,gene,T05F1.5,0,9634835,0.358216,4032,9638872,5,9634840,0,-5
I,-,9625905,0.0,0.125,3,3,0,0,19,gene,T05F1.3,0,9625780,98.3846,7268,9633173,125,9625785,120,-5
I,-,9625785,0.0054072,0.0,30145,29982,163,148,14,gene,T05F1.3,0,9625780,98.3846,7388,9633173,5,9625785,0,-5
I,-,9619749,0.00761085,0.0,3022,2999,23,22,6,gene,K07A1.12,1,9619746,4.18781,5262,9625011,3,9619749,0,-3
I,-,9618106,1.0,0.0625,4,0,4,3,1,gene,K07A1.11,2,9618090,1.57574,94,9618200,16,9618096,10,-6
I,-,9618096,0.956522,0.0,506,22,484,341,20,gene,K07A1.11,2,9618090,1.57574,104,9618200,6,9618096,0,-6
I,-,9616322,0.834891,4.05502e-36,321,53,268,182,448,gene,K07A1.10,3,9616306,1.32801,175,9616497,16,9616343,-21,-37
I,-,9616313,0.8125,1.78038e-07,64,12,52,42,1381,gene,K07A1.10,3,9616306,1.32801,184,9616497,7,9616343,-30,-37
I,-,9615071,0.978512,0.0,605,13,592,421,0,gene,K07A1.9,4,9615066,0.763952,105,9615176,5,9615071,0,-5
I,-,9611523,0.00837404,0.0,1433,1421,12,8,82,gene,K07A1.8,0,9611521,2.95771,279,9611802,2,9611523,0,-2
I,-,9609531,0.0377358,1.52989e-13,53,51,2,2,2,gene,K07A1.15,0,9609490,0.256054,3,9609534,41,9609531,0,-41
I,-,9584801,0.0,0.03125,5,5,0,0,2,gene,K07A1.13,0,9584774,0.292736,2334,9587135,27,9584775,26,-1
I,-,9583470,0.0,6.93889e-18,57,57,0,0,6,gene,K07A1.1,1,9583451,1.14166,388,9583858,19,9583511,-41,-60
I,-,9583459,0.0,5.16988e-26,84,84,0,0,305,gene,K07A1.1,1,9583451,1.14166,399,9583858,8,9583511,-52,-60
I,-,9582573,0.974684,0.0,553,14,539,468,11,gene,K07A1.17,2,9582569,0.996182,95,9582668,4,9582569,4,0
I,-,9581257,0.224422,1.96182e-44,606,470,136,106,0,gene,F42H11.2,3,9581257,0.68596,517,9581774,0,9581257,0,0
I,-,9568220,0.0,0.03125,5,5,0,0,0,gene,C36F7.4,0,9568208,0.211436,6530,9574750,12,9568220,0,-12
I,-,9540956,0.0,0.0,519,519,0,0,23,gene,C36F7.1,0,9540875,0.926352,24427,9565383,81,9540958,-2,-83
I,-,9536625,1.0,0.5,1,0,1,1,98,gene,C41G7.7,0,9536474,0.0291051,170,9536795,151,9536261,364,213
I,-,9532857,0.0,9.31323e-10,30,30,0,0,16,gene,C41G7.8,0,9532821,None,554,9533411,36,9532821,36,0
I,-,9518724,0.00337838,0.0,296,295,1,1,18,gene,C41G7.3,1,9518687,2.75544,7806,9526530,37,9518724,0,-37
I,-,9516753,1.0,0.25,2,0,2,2,9,gene,C41G7.9,2,9516682,None,263,9517016,71,9516766,-13,-84
I,-,9515829,0.212912,0.0,2339,1841,498,435,9,gene,C41G7.9,2,9515785,None,1187,9517016,44,9515829,0,-44
I,-,9512091,0.0,1.90735e-06,19,19,0,0,209,gene,C41G7.1,0,9512088,1.02848,2847,9514938,3,9512129,-38,-41
I,-,9512010,0.0,0.0078125,7,7,0,0,1,gene,C41G7.1,0,9512004,1.02848,2928,9514938,6,9512004,6,0
I,-,9505758,0.0022742,0.0,3078,3071,7,7,0,gene,F30A10.9,0,9505755,2.8934,5420,9511178,3,9505758,0,-3
I,-,9494545,0.328103,1.38761e-20,701,471,230,172,41,gene,F30A10.3,0,9494490,1.27675,9849,9504394,55,9494545,0,-55
I,-,9488019,0.00169924,0.0,2354,2350,4,4,24,gene,F30A10.5,0,9488016,1.11379,4584,9492603,3,9488019,0,-3
I,-,9478735,0.0348837,1.32271e-21,86,83,3,0,0,gene,F30A10.13,0,9478709,0.373138,361,9479096,26,9478735,0,-26
I,-,9444218,0.0017762,0.0,563,562,1,0,11,gene,F46A9.6,0,9444186,2.36978,28414,9472632,32,9444218,0,-32
I,-,9421983,0.00328108,0.0,2743,2734,9,8,3,gene,C17E4.5,1,9421956,3.38891,18965,9440948,27,9421983,0,-27
I,-,9420804,0.885714,4.81117e-17,105,12,93,72,0,gene,C17E4.11,2,9420796,0.317022,21,9420825,8,9420804,0,-8
I,-,9418873,0.00321888,0.0,1864,1858,6,6,40,gene,C17E4.3,0,9418864,0.892136,1091,9419964,9,9418864,9,0
I,-,9404023,0.0,2.77556e-17,55,55,0,0,0,gene,F16A11.1,1,9404010,1.00762,3718,9407741,13,9404015,8,-5
I,-,9398402,0.0,6.10352e-05,14,14,0,0,9,gene,F16A11.1,1,9398389,1.00762,9339,9407741,13,9398390,12,-1
I,-,9398390,0.00571429,0.0,350,348,2,1,63,gene,F16A11.1,1,9398389,1.00762,9351,9407741,1,9398390,0,-1
I,-,9393086,0.142857,5.93461e-19,140,120,20,10,0,gene,F16A11.2,2,9393085,0.425298,846,9393932,1,9393085,1,0
I,-,9389624,0.0634921,0.0,315,295,20,16,4,gene,F16A11.3,3,9389575,0.810539,133,9389757,49,9389624,0,-49
I,-,9357110,0.0,0.125,3,3,0,0,0,gene,M04C9.4,0,9357069,0.0510815,7045,9364155,41,9357069,41,0
I,-,9354263,0.0,1.97215e-31,102,102,0,0,0,gene,M04C9.3,0,9354254,0.350971,799,9355062,9,9354263,0,-9
I,-,9352455,0.0,0.0078125,7,7,0,0,2,gene,M04C9.1,0,9352450,0.0982025,412,9352867,5,9352455,0,-5
I,-,9342486,0.0135135,3.91753e-21,74,73,1,1,17,gene,C12C8.3,0,9342343,1.90308,2223,9344709,143,9342486,0,-143
I,-,9341903,0.0126263,0.0,396,391,5,5,9,gene,C12C8.3,0,9341887,1.90308,2806,9344709,16,9341903,0,-16
I,-,9341651,0.0,0.5,1,1,0,0,426,gene,C12C8.3,0,9341582,1.90308,3058,9344709,69,9341903,-252,-321
I,-,9314478,0.00196335,0.0,1528,1525,3,3,3,gene,F26H9.5,0,9314442,1.88533,5837,9320315,36,9314478,0,-36
I,-,9306834,0.0116822,0.0,428,423,5,2,0,gene,F26H9.4,0,9306809,0.337447,1039,9307873,25,9306809,25,0
I,-,9294025,0.00833333,0.0,240,238,2,1,0,gene,F26H9.2,0,9293870,0.913756,9833,9303858,155,9293853,172,17
I,-,9293853,0.0,0.25,2,2,0,0,0,gene,F26H9.2,0,9293851,0.913756,10005,9303858,2,9293853,0,-2
I,-,9286555,0.011236,0.0,267,264,3,3,2,gene,F14B4.3,0,9286552,0.616519,3199,9289754,3,9286552,3,0
I,-,9278679,0.0,1.86265e-09,29,29,0,0,0,gene,F14B4.2,0,9278606,2.17921,2274,9280953,73,9278679,0,-73
I,-,9273785,0.00315956,0.0,2532,2524,8,7,2,gene,F14B4.2,0,9273771,2.17921,7168,9280953,14,9273785,0,-14
I,-,9261648,0.0,2.98023e-08,25,25,0,0,0,gene,F36H2.3,0,9261639,0.224379,4294,9265942,9,9261631,17,8
I,-,9245915,0.866973,0.0,436,58,378,265,0,gene,F36H2.1,2,9245882,1.30681,100,9246015,33,9245915,0,-33
I,-,9242110,0.00877193,5.4889e-33,114,113,1,1,6,gene,F36H2.1,2,9242062,1.30681,520,9242630,48,9242110,0,-48
I,-,9233551,0.860656,1.59269e-32,244,34,210,131,1,gene,VF36H2L.1,3,9233548,0.603072,611,9234162,3,9233548,3,0
I,-,9226381,0.00862069,0.0,348,345,3,2,29,gene,C45G3.1,0,9226374,0.581388,5681,9232062,7,9226377,4,-3
I,-,9220757,0.0,0.125,3,3,0,0,0,gene,C45G3.4,0,9220719,0.0720694,1051,9221808,38,9220719,38,0
I,-,9210328,0.0,1.38778e-17,56,56,0,0,0,gene,F25H5.1,0,9210328,2.06709,8153,9218481,0,9210328,0,0
I,-,9209440,0.0,0.015625,6,6,0,0,2,gene,F25H5.1,0,9209269,2.06709,9041,9218481,171,9209440,0,-171
I,-,9185057,0.0,0.0,259,259,0,0,0,gene,F25H5.1,0,9185027,2.06709,33424,9218481,30,9185057,0,-30
I,-,9181046,0.0,1.19209e-07,23,23,0,0,4,gene,F25H5.2,0,9180994,0.146274,763,9181809,52,9180994,52,0
I,-,9181017,0.0,0.000976562,10,10,0,0,22,gene,F25H5.2,0,9180994,0.146274,792,9181809,23,9180994,23,0
I,-,9178704,0.0,0.0,260,260,0,0,36,gene,F25H5.8,0,9178688,8.49961,1232,9179936,16,9178770,-66,-82
I,-,9178694,0.00231023,0.0,3030,3023,7,0,330,gene,F25H5.8,0,9178688,8.49961,1242,9179936,6,9178770,-76,-82
I,-,9163264,0.0,5.68434e-14,44,44,0,0,1,gene,F25H5.5,1,9163252,0.523561,1528,9164792,12,9163252,12,0
I,-,9163252,0.0030581,0.0,654,652,2,2,164,gene,F25H5.5,1,9163252,0.523561,1540,9164792,0,9163252,0,0
I,-,9159513,0.881696,0.0,1344,159,1185,758,2,gene,F25H5.6,2,9159513,3.433,379,9159892,0,9159513,0,0
I,-,9144367,0.0185185,0.0,216,212,4,4,6,gene,ZK858.7,1,9144360,0.769114,9852,9154219,7,9144360,7,0
I,-,9141514,0.163522,0.0,795,665,130,101,1,gene,ZK858.6,2,9141511,2.42101,424,9141938,3,9141514,0,-3
I,-,9138350,0.737864,4.75625e-07,103,27,76,50,0,gene,ZK858.5,3,9138347,0.45472,48,9138398,3,9138347,3,0
I,-,9127092,0.003663,0.0,273,272,1,1,1,gene,ZK858.3,0,9127092,4.47605,8662,9135754,0,9127063,29,29
I,-,9110598,0.00661157,0.0,1210,1202,8,8,0,gene,W10D5.2,1,9110598,7.07084,12576,9123174,0,9110598,0,0
I,-,9107588,0.868996,3.73824e-32,229,30,199,128,58,gene,W10D5.3,2,9107530,2.06804,575,9108163,58,9107530,58,0
I,-,9107573,0.811475,7.69806e-13,122,23,99,60,684,gene,W10D5.3,2,9107530,2.06804,590,9108163,43,9107530,43,0
I,-,9107563,0.826087,0.0010556,23,4,19,8,591,gene,W10D5.3,2,9107530,2.06804,600,9108163,33,9107530,33,0
I,-,9085839,0.0,1.49012e-08,26,26,0,0,9,gene,T06D10.3,0,9085836,None,14997,9100836,3,9086217,-378,-381
I,-,9080015,0.00378072,0.0,529,527,2,2,46,gene,T06D10.2,0,9080002,0.877157,5322,9085337,13,9080015,0,-13
I,-,9075068,0.00369004,0.0,271,270,1,0,1,gene,T06D10.1,0,9074615,1.15534,2488,9077556,453,9075068,0,-453
I,-,9074967,0.0,0.125,3,3,0,0,53,gene,T06D10.1,0,9074615,1.15534,2589,9077556,352,9075068,-101,-453
I,-,9064556,0.0,5.96046e-08,24,24,0,0,3,gene,W06D4.5,1,9064526,1.28531,5682,9070238,30,9064389,167,137
I,-,9064405,0.0769231,0.00158691,13,12,1,1,0,gene,W06D4.5,1,9064389,1.28531,5833,9070238,16,9064389,16,0
I,-,9064394,0.00532623,0.0,751,747,4,4,22,gene,W06D4.5,1,9064389,1.28531,5844,9070238,5,9064389,5,0
I,-,9063151,0.967742,1.52944e-38,155,5,150,103,4,gene,W06D4.4,2,9063138,0.494244,64,9063215,13,9063151,0,-13
I,-,9049338,0.893617,2.1951e-23,141,15,126,32,20,gene,C31H5.5,2,9049323,0.424198,110,9049448,15,9049323,15,0
I,-,9046566,0.0018315,0.0,546,545,1,1,4,gene,C31H5.6,0,9046562,0.517941,1621,9048187,4,9046566,0,-4
I,-,9045355,0.0,0.0625,4,4,0,0,1,gene,C31H5.6,0,9045349,0.517941,606,9045961,6,9045355,0,-6
I,-,9042588,0.00105798,0.0,4726,4721,5,4,1,gene,C31H5.4,0,9042569,6.08963,722,9043310,19,9042776,-188,-207
I,-,9036686,0.03125,7.45058e-09,32,31,1,0,1,gene,C31H5.3,0,9036677,0.0685869,5574,9042260,9,9036686,0,-9
I,-,9034021,0.0,0.125,3,3,0,0,0,gene,C31H5.3,0,9034003,0.0685869,8239,9042260,18,9034003,18,0
I,-,9013876,0.00862069,0.0,348,345,3,3,1,gene,F36F2.3,1,9013849,1.37519,1433,9015309,27,9013876,0,-27
I,-,9008699,0.90301,0.0,299,29,270,202,1,gene,F36F2.6,2,9008699,0.668691,291,9008990,0,9008699,0,0
I,-,9003954,0.681633,1.65932e-16,490,156,334,225,46,gene,F36F2.4,3,9003930,1.83816,550,9004504,24,9003954,0,-24
I,-,9003947,1.0,0.5,1,0,1,1,359,gene,F36F2.4,3,9003930,1.83816,557,9004504,17,9003954,-7,-24
I,-,8999567,0.0,3.9443e-31,101,101,0,0,8,gene,F32H2.6,0,8999555,0.139508,519,9000086,12,8999555,12,0
I,-,8986523,0.00458716,0.0,436,434,2,2,1,gene,F32H2.5,0,8986513,3.27149,8965,8995488,10,8986513,10,0
I,-,8970072,0.0,0.0,195,195,0,0,145,gene,F32H2.3,0,8970062,1.36089,3054,8973126,10,8970072,0,-10
I,-,8942276,0.0,7.45058e-09,27,27,0,0,1,gene,F53B6.2,0,8942222,0.403071,3248,8945524,54,8942249,27,-27
I,-,8916796,0.0128205,0.0,234,231,3,3,6,gene,T08G11.1,1,8916795,1.12415,2524,8919320,1,8916796,0,-1
I,-,8905457,0.871429,4.87673e-30,210,27,183,107,47,gene,T08G11.4,2,8905438,0.779643,178,8905635,19,8905457,0,-19
I,-,8904970,0.0666667,4.22956e-13,60,56,4,3,1,gene,T08G11.4,2,8904897,0.779643,665,8905635,73,8904970,0,-73
I,-,8901426,0.0,3.8147e-06,18,18,0,0,2,gene,T08G11.5,0,8901419,0.202966,1308,8902734,7,8901419,7,0
I,-,8894128,0.00127421,0.0,3924,3919,5,4,9,gene,F55H12.4,0,8894127,6.22945,3475,8897603,1,8894128,0,-1
I,-,8861263,0.0,4.33681e-19,61,61,0,0,0,gene,F55H12.6,0,8861263,0.179493,2745,8864008,0,8861265,-2,-2
I,-,8855438,0.0434783,1.47082e-11,46,44,2,1,0,gene,F55H12.6,0,8855436,0.179493,3276,8858714,2,8855436,2,0
I,-,8851107,0.027972,1.49786e-36,143,139,4,3,4,gene,F29D10.4,0,8851086,0.682303,2569,8853676,21,8851086,21,0
I,-,8838710,0.0,0.0,808,808,0,0,3,gene,F36A2.13,0,8838584,1.24455,3831,8842541,126,8838710,0,-126
I,-,8816185,0.00623435,0.0,40742,40488,254,209,19,gene,F36A2.6,0,8816177,105.828,3305,8819490,8,8816185,0,-8
I,-,8811639,0.0,0.00390625,8,8,0,0,2,gene,F36A2.4,1,8811624,0.0810357,3867,8815506,15,8811639,0,-15
I,-,8808040,0.0,2.98023e-08,25,25,0,0,180,gene,F36A2.1,2,8808003,1.45504,910,8808950,37,8808040,0,-37
I,-,8804689,0.932271,0.0,251,17,234,133,28,gene,F36A2.2,3,8804688,0.590003,102,8804791,1,8804688,1,0
I,-,8785407,0.0,0.0,481,481,0,0,11,gene,DY3.6,0,8785378,0.562307,16217,8801624,29,8785407,0,-29
I,-,8777504,0.0,1.77636e-15,49,49,0,0,33,gene,DY3.5,0,8777503,0.338482,2221,8779725,1,8777503,1,0
I,-,8759780,0.00490691,0.0,6929,6895,34,26,12,gene,DY3.1,1,8759771,8.49651,7072,8766852,9,8759782,-2,-11
I,-,8759026,0.25,0.25,4,3,1,1,2,gene,DY3.8,2,8758987,1.7143,98,8759124,39,8758988,38,-1
I,-,8758988,0.389744,2.9167e-06,390,238,152,120,8,gene,DY3.8,2,8758987,1.7143,136,8759124,1,8758988,0,-1
I,-,8757595,0.015873,0.0,1260,1240,20,17,1,gene,C36B1.11,0,8757398,0.992141,529,8758124,197,8757562,33,-164
I,-,8757494,0.25,0.25,4,3,1,1,1,gene,C36B1.11,0,8757398,0.992141,630,8758124,96,8757494,0,-96
I,-,8746975,0.0,0.0,250,250,0,0,5,gene,C36B1.9,0,8746917,0.50586,2632,8749607,58,8746917,58,0
I,-,8735709,0.00816994,0.0,612,607,5,4,2,gene,C36B1.5,0,8735699,0.544289,6828,8742537,10,8735709,0,-10
I,-,8728479,0.0146684,0.0,1568,1545,23,15,11,gene,C36B1.4,0,8728479,3.87147,2443,8730922,0,8728479,0,0
I,-,8724336,0.142857,0.0546875,7,6,1,0,5,gene,C36B1.1,0,8724322,0.652702,2831,8727167,14,8724271,65,51
I,-,8710947,0.0,7.70372e-34,110,110,0,0,0,gene,C36B1.1,0,8710947,0.652702,16220,8727167,0,8710947,0,0
I,-,8701963,0.00260417,0.0,384,383,1,1,5,gene,F39H11.2,0,8701949,1.16294,3698,8705661,14,8701949,14,0
I,-,8696291,0.0163675,0.0,1894,1863,31,24,91,gene,F39H11.5,0,8696284,5.60888,1197,8697488,7,8696284,7,0
I,-,8695071,0.0,0.5,1,1,0,0,0,gene,K07A12.5,0,8695017,0.103135,44,8695115,54,8694976,95,41
I,-,8692483,0.00649351,0.0,308,306,2,2,8,gene,K07A12.7,1,8692483,0.885695,1002,8693485,0,8692483,0,0
I,-,8690921,0.863636,1.26123e-18,132,18,114,76,68,gene,K07A12.4,2,8690921,0.49387,109,8691030,0,8690921,0,0
I,-,8681324,0.00531915,0.0,752,748,4,4,0,gene,K07A12.2,0,8681229,1.33517,1873,8683197,95,8681311,13,-82
I,-,8681317,0.00328228,0.0,914,911,3,3,102,gene,K07A12.2,0,8681229,1.33517,1880,8683197,88,8681311,6,-82
I,-,8671030,0.0,3.55271e-15,48,48,0,0,3,gene,K07A12.8,0,8670987,None,5625,8676655,43,8670950,80,37
I,-,8664112,0.00704225,2.547e-41,142,141,1,1,75,gene,F39H2.4,0,8664106,0.522715,2453,8666565,6,8664149,-37,-43
I,-,8640228,0.0190217,0.0,368,361,7,5,0,gene,F43G9.10,0,8640227,1.35018,22811,8663039,1,8640228,0,-1
I,-,8637118,0.00524384,0.0,1907,1897,10,9,184,gene,F43G9.9,0,8637115,4.28391,1383,8638501,3,8637118,0,-3
I,-,8614824,0.00381679,0.0,524,522,2,1,6,gene,F43G9.3,1,8614754,0.984182,1575,8616399,70,8614824,0,-70
I,-,8612592,0.897849,4.27429e-31,186,19,167,122,0,gene,F43G9.4,2,8612577,0.585793,118,8612710,15,8612577,15,0
I,-,8608623,0.00480307,0.0,1041,1036,5,3,5,gene,F43G9.1,0,8608615,6.03663,2343,8610966,8,8608623,0,-8
I,-,8608616,0.0,0.00195312,9,9,0,0,372,gene,F43G9.1,0,8608615,6.03663,2350,8610966,1,8608623,-7,-8
I,-,8587497,0.0,1.38778e-17,56,56,0,0,1,gene,R05D11.1,0,8587481,0.23482,18891,8606388,16,8587499,-2,-18
I,-,8580099,0.00626424,0.0,1756,1745,11,11,59,gene,T01H8.1,1,8580093,1.15498,3216,8583315,6,8580099,0,-6
I,-,8578012,0.0,0.5,1,1,0,0,50,gene,T01H8.1,1,8577973,1.15498,5303,8583315,39,8578022,-10,-49
I,-,8573741,0.235294,7.05007e-05,51,39,12,4,8,gene,T01H8.2,2,8573739,0.347572,107,8573848,2,8573755,-14,-16
I,-,8570990,0.0,0.000244141,12,12,0,0,1,gene,T01H8.5,0,8570977,0.485713,557,8571547,13,8570949,41,28
I,-,8544405,0.0526316,3.62396e-05,19,18,1,0,0,gene,M04C7.4,0,8544358,0.0147025,1650,8546055,47,8544269,136,89
I,-,8534517,0.0,0.00012207,13,13,0,0,0,gene,M04C7.1,0,8534510,0.074977,5888,8540405,7,8534510,7,0
I,-,8534510,0.0,0.015625,6,6,0,0,6,gene,M04C7.1,0,8534510,0.074977,5895,8540405,0,8534510,0,0
I,-,8531328,0.0136986,7.72918e-21,73,72,1,1,0,gene,K02B12.8,1,8531312,0.372132,385,8531713,16,8531312,16,0
I,-,8529263,0.623693,6.79734e-06,287,108,179,137,25,gene,K02B12.7,2,8529263,1.1339,109,8529372,0,8529263,0,0
I,-,8526613,0.92233,2.34451e-20,103,8,95,80,0,gene,K02B12.5,3,8526613,0.249357,137,8526750,0,8526613,0,0
I,-,8511307,0.00401606,0.0,498,496,2,1,24,gene,K02B12.3,0,8511307,0.999161,276,8511583,0,8511307,0,0
I,-,8502597,0.0588235,0.0001297,17,16,1,1,2,gene,K02B12.1,0,8502561,0.231516,6480,8509077,36,8502404,193,157
I,-,8487048,0.00471698,0.0,212,211,1,1,0,gene,D1081.9,0,8487035,0.367241,11061,8498109,13,8487035,13,0
I,-,8485731,0.333333,0.375,3,2,1,1,13,gene,D1081.6,0,8485686,0.191193,71,8485802,45,8485686,45,0
I,-,8476274,0.0294118,1.97906e-09,34,33,1,0,2,gene,D1081.4,0,8476274,0.166564,6469,8482743,0,8476274,0,0
I,-,8451013,0.00239808,0.0,417,416,1,0,2,gene,F10D11.6,0,8450986,2.35755,12302,8463315,27,8450986,27,0
I,-,8438589,0.0,2.38419e-07,22,22,0,0,96,gene,F10D11.2,1,8438578,0.721017,1374,8439963,11,8438630,-41,-52
I,-,8435856,1.0,9.31323e-10,30,0,30,20,5,gene,F02E9.9,2,8435843,1.24138,93,8435949,13,8435856,0,-13
I,-,8432972,0.0102916,0.0,583,577,6,6,2,gene,F02E9.9,2,8432923,1.24138,2977,8435949,49,8432972,0,-49
I,-,8429824,0.988372,1.11152e-24,86,1,85,65,4,gene,F02E9.10,3,8429805,1.09291,78,8429902,19,8429824,0,-19
I,-,8429813,0.873016,1.92952e-27,189,24,165,145,221,gene,F02E9.10,3,8429805,1.09291,89,8429902,8,8429813,0,-8
I,-,8426400,0.0,0.000488281,11,11,0,0,10,gene,F02E9.5,4,8426394,1.00563,679,8427079,6,8426076,324,318
I,-,8426083,0.0577933,0.0,571,538,33,31,3,gene,F02E9.5,4,8426067,1.00563,996,8427079,16,8426067,16,0
I,-,8425778,0.0,0.00012207,13,13,0,0,15,gene,F02E9.5,4,8425772,1.00563,1301,8427079,6,8425778,0,-6
I,-,8410796,0.0118694,0.0,337,333,4,4,0,gene,F02E9.2,0,8410795,1.42403,14162,8424958,1,8410796,0,-1
I,-,8405969,1.0,0.5,1,0,1,1,8,gene,F02E9.3,0,8405947,0.252111,1651,8407620,22,8405947,22,0
I,-,8390019,0.00684932,1.63672e-42,146,145,1,1,3,gene,T19A6.1,0,8390010,1.64169,13920,8403939,9,8390019,0,-9
I,-,8363850,0.957447,8.54792e-44,188,8,180,125,2,gene,F16D3.2,2,8363833,1.24681,96,8363946,17,8363850,0,-17
I,-,8363847,0.893805,4.75867e-19,113,12,101,72,2,gene,F16D3.2,2,8363833,1.24681,99,8363946,14,8363847,0,-14
I,-,8346014,0.0,6.31089e-30,97,97,0,0,0,gene,C34B7.3,0,8346013,0.220023,12231,8358245,1,8346014,0,-1
I,-,8329665,0.0,0.0625,4,4,0,0,8,gene,F52B5.6,0,8329636,79.734,12010,8341675,29,8329638,27,-2
I,-,8329638,0.00278384,0.0,59989,59822,167,152,127,gene,F52B5.6,0,8329636,79.734,12037,8341675,2,8329638,0,-2
I,-,8323978,0.0,0.0,363,363,0,0,20,gene,F52B5.3,1,8323974,0.478416,5060,8329038,4,8323974,4,0
I,-,8318241,0.930607,0.0,807,56,751,583,2,gene,F52B5.2,2,8318241,0.686697,96,8318337,0,8318241,0,0
I,-,8307557,0.00842359,0.0,831,824,7,6,2,gene,F52B5.1,0,8307540,1.87506,5662,8313219,17,8307557,0,-17
I,-,8293910,0.0,0.5,1,1,0,0,2,gene,T01G9.4,1,8293780,1.20918,3008,8296918,130,8293631,279,149
I,-,8293631,0.0205761,0.0,243,238,5,5,26,gene,T01G9.4,1,8293631,1.20918,3287,8296918,0,8293631,0,0
I,-,8290996,0.840072,0.0,1113,178,935,673,16,gene,T01G9.6,2,8290805,7.01463,291,8291287,191,8290996,0,-191
I,-,8288115,0.0381125,0.0,551,530,21,16,11,gene,T01G9.2,3,8288099,1.5298,828,8288943,16,8288115,0,-16
I,-,8254918,0.00450113,0.0,1333,1327,6,5,95,gene,ZK265.9,0,8254912,1.20747,1376,8256294,6,8254918,0,-6
I,-,8240629,0.0,6.10352e-05,14,14,0,0,0,gene,ZK265.1,0,8240624,0.0574481,3054,8243683,5,8240629,0,-5
I,-,8223001,0.0163934,1.38821e-33,122,120,2,2,31,gene,T02E1.2,0,8222993,0.590786,1532,8224533,8,8223001,0,-8
I,-,8218640,0.0,0.000488281,11,11,0,0,3,gene,T02E1.5,0,8218619,2.196,1379,8220019,21,8218316,324,303
I,-,8218316,0.00660502,0.0,757,752,5,4,6,gene,T02E1.5,0,8218316,2.196,1703,8220019,0,8218316,0,0
I,-,8213267,0.0,0.25,2,2,0,0,6,gene,T02E1.5,0,8213251,2.196,4674,8217941,16,8213267,0,-16
I,-,8142530,0.0,0.25,2,2,0,0,3,gene,T28B8.5,0,8142530,0.0231725,38797,8181327,0,8142530,0,0
I,-,8119307,0.00113122,0.0,884,883,1,1,2,gene,C09H6.2,0,8119306,0.870354,20148,8139455,1,8119307,0,-1
I,-,8118510,0.0,4.76837e-07,21,21,0,0,0,gene,C09H6.2,0,8118508,0.870354,20945,8139455,2,8118510,0,-2
I,-,8081670,0.0,3.05176e-05,15,15,0,0,1,gene,F18C12.1,0,8081664,0.0429025,28066,8109736,6,8081664,6,0
I,-,8057022,0.000805802,0.0,1241,1240,1,1,5,gene,K04G2.9,0,8057020,1.01026,3762,8060784,2,8057020,2,0
I,-,8048241,0.0,0.5,1,1,0,0,9,gene,K04G2.7,0,8048234,0.127355,7212,8055453,7,8048230,11,4
I,-,8040519,0.0,2.64698e-23,75,75,0,0,11,gene,K04G2.11,1,8040494,0.339017,6833,8047352,25,8040519,0,-25
I,-,8040513,0.0,0.0,150,150,0,0,21,gene,K04G2.11,1,8040494,0.339017,6839,8047352,19,8040519,-6,-25
I,-,8039174,0.475728,0.0315458,309,162,147,128,6,gene,K04G2.5,2,8039014,3.43217,160,8039334,160,8038903,271,111
I,-,8038903,0.771852,0.0,675,154,521,405,31,gene,K04G2.5,2,8038832,3.43217,158,8039061,71,8038903,0,-71
I,-,8035689,0.823529,5.4886e-22,204,36,168,98,0,gene,K04G2.3,3,8035689,0.357173,1247,8036936,0,8035689,0,0
I,-,8027785,0.00443951,0.0,3604,3588,16,11,3,gene,K04G2.1,1,8027755,4.96825,5071,8032856,30,8027785,0,-30
I,-,8026518,0.920792,7.97126e-20,101,8,93,72,4,gene,C54G4.9,2,8026512,0.28962,78,8026596,6,8026518,0,-6
I,-,8024415,0.105944,0.0,2086,1865,221,192,65,gene,C54G4.8,0,8024396,8.4149,456,8024871,19,8024415,0,-19
I,-,7968680,0.0357143,2.13718e-14,56,54,2,2,12,gene,T22C1.11,0,7968674,0.423912,3786,7972466,6,7968680,0,-6
I,-,7951586,0.0246479,0.0,284,277,7,5,1,gene,T22C1.7,0,7951544,0.931255,4383,7955969,42,7951586,0,-42
I,-,7934742,0.0,3.05176e-05,15,15,0,0,2,gene,F20G4.3,1,7934687,1.76198,2689,7937431,55,7934570,172,117
I,-,7934570,0.00121065,0.0,826,825,1,1,9,gene,F20G4.3,1,7934536,1.76198,2861,7937431,34,7934570,0,-34
I,-,7926331,0.445205,0.0275495,146,81,65,44,28,gene,F20G4.1,2,7926330,0.523141,299,7926630,1,7926330,1,0
I,-,7918345,1.0,0.000976562,10,0,10,10,2,gene,F20G4.2,3,7918343,0.118215,91,7918436,2,7918334,11,9
I,-,7918334,0.964286,1.04308e-07,28,1,27,21,14,gene,F20G4.2,3,7918332,0.118215,102,7918436,2,7918334,0,-2
I,-,7875547,0.0,0.0,260,260,0,0,2,gene,R11A5.7,0,7875532,2.35675,18662,7894209,15,7875547,0,-15
I,-,7863635,0.0,0.00390625,8,8,0,0,3,gene,R11A5.3,0,7863516,1.00245,3935,7867570,119,7863546,89,-30
I,-,7859410,0.0190275,0.0,473,464,9,6,10,gene,R11A5.2,0,7859396,1.73234,3371,7862781,14,7859410,0,-14
I,-,7849005,0.0,1.19209e-07,23,23,0,0,4,gene,F30F8.5,0,7848921,0.543706,8746,7857751,84,7848853,152,68
I,-,7815035,0.00632911,0.0,158,157,1,1,3,gene,D2005.3,0,7814992,2.83244,11400,7826435,43,7815035,0,-43
I,-,7801815,0.000896861,0.0,1115,1114,1,1,1,gene,D2005.2,0,7801801,1.68432,11930,7813745,14,7801815,0,-14
I,-,7793605,0.0,5.96046e-08,24,24,0,0,9,gene,D2005.6,0,7793565,0.405525,6846,7800451,40,7793532,73,33
I,-,7770232,0.00165563,0.0,604,603,1,1,1,gene,H15N14.2,0,7770149,1.11782,10887,7781119,83,7770232,0,-83
I,-,7770220,0.0,3.72529e-09,28,28,0,0,1043,gene,H15N14.2,0,7770149,1.11782,10899,7781119,71,7770232,-12,-83
I,-,7724650,0.00407332,0.0,491,489,2,2,15,gene,F27D4.7,0,7724648,1.00086,41875,7766525,2,7724648,2,0
I,-,7707043,0.0023753,0.0,842,840,2,2,8,gene,F27D4.2,0,7706788,2.66829,16668,7723711,255,7707043,0,-255
I,-,7689397,0.00238095,0.0,420,419,1,1,6,gene,T23G11.6,0,7689340,0.809491,11960,7701357,57,7689397,0,-57
I,-,7689351,0.0,0.015625,6,6,0,0,50,gene,T23G11.6,0,7689340,0.809491,12006,7701357,11,7689397,-46,-57
I,-,7676365,0.0,0.000976562,10,10,0,0,0,gene,F26A3.7,0,7676298,0.499619,8511,7684876,67,7676114,251,184
I,-,7676324,0.0,0.00195312,9,9,0,0,2,gene,F26A3.7,0,7676298,0.499619,8552,7684876,26,7676114,210,184
I,-,7676121,0.00235294,0.0,425,424,1,1,1,gene,F26A3.7,0,7676114,0.499619,8755,7684876,7,7676114,7,0
I,-,7676116,0.0,1.38778e-17,56,56,0,0,78,gene,F26A3.7,0,7676114,0.499619,8760,7684876,2,7676114,2,0
I,-,7658285,0.00122549,0.0,1632,1630,2,1,9,gene,F26A3.4,0,7658273,3.04545,11869,7670154,12,7658285,0,-12
I,-,7656330,0.010989,0.0,273,270,3,3,0,gene,F26A3.3,1,7656266,0.316476,648,7656978,64,7656330,0,-64
I,-,7649771,0.505882,0.0857884,85,42,43,36,0,gene,F26A3.8,2,7649761,0.405593,645,7650416,10,7649771,0,-10
I,-,7643322,0.960557,0.0,431,17,414,321,2,gene,F26A3.2,3,7643235,1.73667,102,7643424,87,7643262,60,-27
I,-,7643182,0.0,0.00390625,8,8,0,0,131,gene,F26A3.2,3,7643035,1.73667,242,7643424,147,7643262,-80,-227
I,-,7641761,0.980723,0.0,415,8,407,160,18,gene,F26A3.1,4,7641761,1.1048,114,7641875,0,7641761,0,0
I,-,7639772,0.319672,4.88031e-09,244,166,78,56,6,gene,F29D11.2,5,7639757,1.00191,562,7640334,15,7639774,-2,-17
I,-,7588361,0.0,0.5,1,1,0,0,0,gene,D2030.6,0,7588355,2.10286,45853,7634214,6,7588355,6,0
I,-,7581622,0.00852655,0.0,6685,6628,57,48,5,gene,D2030.4,1,7581617,13.8205,3697,7585319,5,7581622,0,-5
I,-,7580827,0.924855,1.05057e-33,173,13,160,117,2,gene,D2030.3,2,7580825,0.610975,101,7580928,2,7580827,0,-2
I,-,7570547,0.00436681,0.0,916,912,4,3,1,gene,D2030.1,0,7570468,1.05521,7955,7578502,79,7570547,0,-79
I,-,7542151,0.00530973,0.0,565,562,3,3,5,gene,C26C6.5,0,7542106,2.09498,25664,7567815,45,7542151,0,-45
I,-,7494207,0.0,0.015625,6,6,0,0,9,gene,T28F4.6,0,7494204,8.24698,8713,7502920,3,7494207,0,-3
I,-,7490168,0.0285714,1.01863e-09,35,34,1,1,3,gene,T28F4.4,0,7490162,0.251242,2771,7492939,6,7490169,-1,-7
I,-,7476941,0.03125,7.45058e-09,32,31,1,0,2,gene,T28F4.1,0,7476932,2.1958,7109,7484050,9,7476941,0,-9
I,-,7474196,0.005,0.0,200,199,1,1,4,gene,T28F4.1,0,7474188,2.1958,1553,7475749,8,7474196,0,-8
I,-,7466422,0.0181818,4.61838e-30,110,108,2,2,32,gene,ZK524.4,1,7466416,0.676243,6199,7472621,6,7466416,6,0
I,-,7466417,0.00497512,0.0,201,200,1,1,40,gene,ZK524.4,1,7466416,0.676243,6204,7472621,1,7466416,1,0
I,-,7460751,0.902913,2.32628e-18,103,10,93,68,3,gene,ZK524.3,2,7460748,0.304783,101,7460852,3,7460751,0,-3
I,-,7404490,0.0,0.125,3,3,0,0,0,gene,C15A11.6,0,7404410,0.0170751,52652,7457142,80,7404348,142,62
I,-,7395914,0.0,1.49012e-08,26,26,0,0,13,gene,C15A11.3,0,7395907,0.102393,2795,7398709,7,7395914,0,-7
I,-,7381826,0.0,0.5,1,1,0,0,1,gene,F07A5.7,0,7381740,14.3231,4077,7385903,86,7381826,0,-86
I,-,7380282,0.0,0.25,2,2,0,0,16,gene,F07A5.7,0,7380118,14.3231,5621,7385903,164,7380282,0,-164
I,-,7379755,1.0,0.00390625,8,0,8,0,7,gene,F07A5.7,0,7379661,14.3231,408,7380163,94,7379755,0,-94
I,-,7371906,0.0,0.25,2,2,0,0,2,gene,F07A5.5,0,7371817,0.328725,4705,7376611,89,7371530,376,287
I,-,7371530,0.0,0.0,206,206,0,0,0,gene,F07A5.5,0,7371455,0.328725,5081,7376611,75,7371530,0,-75
I,-,7359097,0.0,5.96046e-08,24,24,0,0,4,gene,F07A5.4,0,7359080,0.0947127,1128,7360225,17,7359097,0,-17
I,-,7352083,0.00331126,0.0,302,301,1,1,6,gene,F07A5.1,0,7352070,0.69665,5030,7357113,13,7352070,13,0
I,-,7346720,0.00479781,0.0,1459,1452,7,7,102,gene,F52A8.5,0,7346718,4.45864,1009,7347729,2,7346720,0,-2
I,-,7321082,0.00735294,0.0,272,270,2,2,12,gene,F52A8.2,0,7321077,1.80728,1185,7322267,5,7321082,0,-5
I,-,7314274,0.00466073,0.0,7295,7261,34,31,26,gene,F13G3.10,1,7314271,8.06625,3997,7318271,3,7314271,3,0
I,-,7314016,0.0,0.125,3,3,0,0,395,gene,F13G3.10,1,7314004,8.06625,4255,7318271,12,7314049,-33,-45
I,-,7313896,0.0,3.30872e-24,78,78,0,0,4,gene,F13G3.10,1,7313871,8.06625,4375,7318271,25,7313896,0,-25
I,-,7313544,1.0,0.125,3,0,3,2,16,gene,F13G3.9,2,7313521,1.39833,82,7313626,23,7313521,23,0
I,-,7313522,0.911051,0.0,371,33,338,223,10,gene,F13G3.9,2,7313521,1.39833,104,7313626,1,7313521,1,0
I,-,7311902,0.0,0.5,1,1,0,0,12,gene,F13G3.8,0,7311731,0.0422696,890,7312792,171,7311913,-11,-182
I,-,7304687,0.0,0.0,159,159,0,0,2,gene,F13G3.6,1,7304684,0.47843,3907,7308594,3,7304684,3,0
I,-,7303181,1.0,0.5,1,0,1,0,2,gene,F13G3.5,2,7303178,2.8484,116,7303297,3,7303224,-43,-46
I,-,7302972,0.735537,1.67785e-32,605,160,445,376,4,gene,F13G3.5,2,7302966,2.8484,325,7303297,6,7302966,6,0
I,-,7302966,0.936073,0.0,657,42,615,395,1001,gene,F13G3.5,2,7302966,2.8484,331,7303297,0,7302966,0,0
I,-,7300911,0.938301,0.0,2107,130,1977,1363,1,gene,F13G3.4,3,7300892,2.95461,94,7301005,19,7300913,-2,-21
I,-,7299810,0.0,0.5,1,1,0,0,1,gene,F13G3.3,4,7299784,0.0618878,247,7300057,26,7299810,0,-26
I,-,7282869,0.958466,0.0,313,13,300,226,9,gene,F21C3.4,2,7282869,0.478001,88,7282957,0,7282869,0,0
I,-,7280432,0.918033,2.58003e-12,61,5,56,35,0,gene,F21C3.3,3,7280431,3.3913,92,7280524,1,7280499,-67,-68
I,-,7280325,0.897854,0.0,1165,119,1046,737,2,gene,F21C3.3,3,7280309,3.3913,199,7280524,16,7280499,-174,-190
I,-,7272176,0.0,2.98023e-08,25,25,0,0,27,gene,F21C3.1,0,7272171,0.210249,2050,7274226,5,7272171,5,0
I,-,7251165,0.0,1.90735e-06,19,19,0,0,48,gene,R06C7.7,1,7251147,0.696486,7748,7258913,18,7251280,-115,-133
I,-,7250814,0.0263158,1.15779e-29,114,111,3,1,14,gene,R06C7.7,1,7250814,0.696486,8099,7258913,0,7250814,0,0
I,-,7248685,0.835616,3.68845e-33,292,48,244,160,7,gene,R06C7.5,2,7248674,1.46746,141,7248826,11,7248685,0,-11
I,-,7246809,1.0,0.000976562,10,0,10,9,0,gene,R06C7.6,3,7246805,0.0890423,83,7246892,4,7246805,4,0
I,-,7243761,0.0178571,7.77156e-16,56,55,1,1,33,gene,R06C7.3,0,7243751,0.580427,2317,7246078,10,7243761,0,-10
I,-,7234692,0.0142857,5.92923e-20,70,69,1,1,3,gene,R06C7.2,1,7234673,0.12651,4299,7238991,19,7234780,-88,-107
I,-,7234684,0.0,3.05176e-05,15,15,0,0,70,gene,R06C7.2,1,7234673,0.12651,4307,7238991,11,7234780,-96,-107
I,-,7233119,0.1125,1.86938e-25,160,142,18,16,7,gene,C01H6.9,2,7233118,0.299922,273,7233392,1,7233118,1,0
I,-,7193912,0.00254777,0.0,785,783,2,1,9,gene,M05B5.5,0,7193905,1.53466,8292,7202204,7,7193905,7,0
I,-,7174122,0.00322581,0.0,620,618,2,2,19,gene,M05B5.2,0,7174114,1.30422,1388,7175510,8,7174122,0,-8
I,-,7156784,0.00565771,0.0,707,703,4,3,14,gene,K07G5.1,1,7156775,1.23826,10144,7166928,9,7156784,0,-9
I,-,7151840,0.569032,1.75049e-05,775,334,441,345,518,gene,K07G5.6,2,7151839,1.57397,618,7152458,1,7151840,0,-1
I,-,7147575,0.0938967,4.595e-37,213,193,20,16,16,gene,H37N21.1,0,7147410,0.887669,2360,7149935,165,7147229,346,181
I,-,7147289,0.0,3.05176e-05,15,15,0,0,1,gene,H37N21.1,0,7147229,0.887669,2646,7149935,60,7147229,60,0
I,-,7128422,0.0,2.71051e-20,65,65,0,0,0,gene,K10D3.2,0,7128136,1.74557,6310,7134732,286,7128422,0,-286
I,-,7116524,0.0,0.0625,4,4,0,0,146,gene,K10D3.6,0,7116523,0.854592,5096,7121620,1,7116705,-181,-182
I,-,7099496,0.170213,2.23435e-06,47,39,8,7,0,gene,F22D6.8,0,7099468,0.243076,203,7099699,28,7099496,0,-28
I,-,7094715,0.0,7.45058e-09,27,27,0,0,15,gene,F22D6.5,0,7094711,1.292,4268,7098983,4,7094747,-32,-36
I,-,7094536,0.0,0.0,191,191,0,0,10,gene,F22D6.5,0,7094510,1.292,4447,7098983,26,7094747,-211,-237
I,-,7090100,0.0,0.125,3,3,0,0,3,gene,F22D6.3,0,7090056,2.52463,1208,7091308,44,7090061,39,-5
I,-,7090061,0.00453608,0.0,2425,2414,11,11,9,gene,F22D6.3,0,7090056,2.52463,1247,7091308,5,7090061,0,-5
I,-,7081519,0.00216333,0.0,9245,9225,20,17,12,gene,F22D6.2,1,7081499,10.6314,6495,7088014,20,7081519,0,-20
I,-,7074865,0.0,0.125,3,3,0,0,1,gene,W01A8.6,0,7074708,0.427317,1052,7075917,157,7074732,133,-24
I,-,7069185,0.00387472,0.0,6194,6170,24,21,4,gene,W01A8.4,0,7069174,7.45289,1463,7070648,11,7069187,-2,-13
I,-,7056357,0.0,0.0,210,210,0,0,51,gene,W01A8.2,0,7056319,0.466574,1820,7058177,38,7056319,38,0
I,-,7051791,0.0,0.015625,6,6,0,0,0,gene,W01A8.7,0,7051755,0.0155713,1905,7053696,36,7051854,-63,-99
I,-,7020802,0.0,9.31323e-10,30,30,0,0,2,gene,H06O01.1,0,7020786,18.6935,29174,7049976,16,7020789,13,-3
I,-,7020796,0.0,0.0,282,282,0,0,2,gene,H06O01.1,0,7020786,18.6935,29180,7049976,10,7020789,7,-3
I,-,7020789,0.00543933,0.0,7170,7131,39,30,248,gene,H06O01.1,0,7020786,18.6935,29187,7049976,3,7020789,0,-3
I,-,7015209,0.0126582,1.30695e-22,79,78,1,1,5,gene,H06O01.2,0,7015207,0.485953,696,7015905,2,7015207,2,0
I,-,6973789,0.0,0.125,3,3,0,0,2,gene,C30F12.4,0,6973778,0.773183,18283,6992072,11,6973788,1,-10
I,-,6971883,0.0,0.00195312,9,9,0,0,5,gene,C30F12.3,0,6971868,0.42666,271,6972154,15,6971797,86,71
I,-,6970144,0.0019802,0.0,505,504,1,1,675,gene,C30F12.2,0,6970139,0.468427,218,6970362,5,6970144,0,-5
I,-,6961138,0.0102041,0.0,196,194,2,1,0,gene,C30F12.1,0,6961138,0.477267,6528,6967666,0,6961138,0,0
I,-,6950498,0.00961538,5.1276e-30,104,103,1,1,11,gene,T10B11.7,1,6950457,0.459327,1400,6951898,41,6950457,41,0
I,-,6950147,0.0,0.5,1,1,0,0,9,gene,T10B11.7,1,6950120,0.459327,1751,6951898,27,6950120,27,0
I,-,6945357,0.352227,9.31772e-07,247,160,87,64,14,gene,T10B11.6,2,6945357,0.678626,234,6945591,0,6945357,0,0
I,-,6941969,0.0555556,1.68697e-31,144,136,8,8,0,gene,T10B11.5,3,6941949,0.251372,1206,6943175,20,6941989,-20,-40
I,-,6925460,0.0,0.0,253,253,0,0,1,gene,C48B6.9,0,6925458,0.264534,12041,6937501,2,6925458,2,0
I,-,6923685,0.0118603,0.0,7504,7415,89,78,1,gene,C48B6.10,0,6923669,18.4656,594,6924279,16,6923689,-4,-20
I,-,6923678,0.0,1.49012e-08,26,26,0,0,2358,gene,C48B6.10,0,6923669,18.4656,601,6924279,9,6923689,-11,-20
I,-,6913578,0.0,0.0,215,215,0,0,2,gene,C48B6.6,0,6913575,0.606165,4120,6917698,3,6913578,0,-3
I,-,6883111,0.0,0.0,739,739,0,0,4,gene,T21G5.5,0,6882967,1.55083,14641,6897752,144,6883111,0,-144
I,-,6873786,1.0,0.5,1,0,1,1,0,gene,T21G5.4,0,6873683,0.543453,3279,6877065,103,6873739,47,-56
I,-,6823092,0.0204082,8.70415e-14,49,48,1,1,0,gene,K02F2.6,0,6823057,0.218595,22085,6845177,35,6823092,0,-35
I,-,6810415,0.0,0.015625,6,6,0,0,0,gene,K02F2.5,0,6810308,1.49093,10107,6820522,107,6810401,14,-93
I,-,6789739,0.00555556,0.0,55800,55490,310,265,8,gene,C37A2.7,1,6789737,121.226,8497,6798236,2,6789739,0,-2
I,-,6789003,0.944444,9.16771e-09,36,2,34,19,0,gene,C37A2.6,2,6788987,0.0672946,34,6789037,16,6788987,16,0
I,-,6779911,0.00571429,0.0,175,174,1,1,1,gene,C37A2.5,0,6779907,0.693156,8171,6788082,4,6779907,4,0
I,-,6767798,0.00169127,0.0,6504,6493,11,8,3,gene,F08B6.4,0,6767791,13.7231,2285,6770083,7,6767798,0,-7
I,-,6765612,0.0,1.03398e-25,83,83,0,0,21,gene,F08B6.4,0,6765611,13.7231,4471,6770083,1,6765612,0,-1
I,-,6760180,0.0,4.81482e-35,114,114,0,0,3,gene,F08B6.3,0,6760168,0.469566,1050,6761230,12,6760168,12,0
I,-,6756349,0.00771208,0.0,389,386,3,3,1,gene,W02D3.11,1,6756347,1.56423,1832,6758181,2,6756349,0,-2
I,-,6753032,0.946237,5.24776e-21,93,5,88,68,2,gene,W02D3.10,2,6753032,0.322593,187,6753219,0,6753032,0,0
I,-,6745824,1.0,0.03125,5,0,5,3,3,gene,W02D3.9,3,6745705,2.18956,165,6745989,119,6745331,493,374
I,-,6745330,0.290221,1.55864e-14,317,225,92,72,1,gene,W02D3.9,3,6745325,2.18956,52,6745382,5,6745330,0,-5
I,-,6736162,0.0,0.0,167,167,0,0,1,gene,W02D3.8,0,6736153,0.232536,6137,6742299,9,6736162,0,-9
I,-,6732271,0.00814111,0.0,737,731,6,5,4,gene,W02D3.7,0,6732270,2.625,1761,6734032,1,6732281,-10,-11
I,-,6730969,0.0,5.96046e-08,24,24,0,0,4,gene,W02D3.6,0,6730960,0.0223535,299,6731268,9,6731111,-142,-151
I,-,6729377,0.00134508,0.0,14869,14849,20,16,2,gene,W02D3.5,0,6729367,13.7233,618,6729995,10,6729377,0,-10
I,-,6721055,0.0,3.30872e-24,78,78,0,0,3,gene,W02D3.4,0,6721047,1.10463,7233,6728288,8,6721047,8,0
I,-,6670406,0.0,0.0625,4,4,0,0,0,gene,ZC581.9,0,6670404,0.159757,16957,6687363,2,6670404,2,0
I,-,6662533,0.0,0.125,3,3,0,0,0,gene,ZC581.7,0,6662506,0.14246,2545,6665078,27,6662292,241,214
I,-,6637415,0.0,1.42109e-14,46,46,0,0,0,gene,D2092.1,0,6637348,0.194891,3241,6640656,67,6637430,-15,-82
I,-,6626789,0.00807537,0.0,743,737,6,5,9,gene,D2092.2,0,6626781,1.02097,261,6627050,8,6626789,0,-8
I,-,6607521,0.00606061,0.0,330,328,2,1,72,gene,D2092.5,0,6607518,1.07946,4627,6612148,3,6607518,3,0
I,-,6565851,0.00695652,0.0,575,571,4,3,5,gene,F57B10.12,1,6565851,1.65871,33135,6598986,0,6565869,-18,-18
I,-,6564452,0.539626,0.000699489,1123,517,606,492,5,gene,F57B10.11,2,6564450,1.29148,291,6564743,2,6564454,-2,-4
I,-,6554291,0.00343053,0.0,4081,4067,14,13,6,gene,F57B10.10,1,6554290,8.64267,7063,6561354,1,6554293,-2,-3
I,-,6553465,0.0714286,2.61025e-09,42,39,3,2,4,gene,F57B10.14,2,6553423,33.0115,17,6553482,42,6553382,83,41
I,-,6553380,0.923523,0.0,19640,1502,18138,11577,20,gene,F57B10.14,2,6553372,33.0115,102,6553482,8,6553380,0,-8
I,-,6552615,0.0681818,7.52834e-10,44,41,3,2,140,gene,F57B10.9,1,6552613,0.363536,212,6552827,2,6552647,-32,-34
I,-,6550437,0.956044,4.16746e-42,182,8,174,127,5,gene,F57B10.8,2,6550351,0.509293,100,6550537,86,6550351,86,0
I,-,6550398,1.0,3.05176e-05,15,0,15,14,154,gene,F57B10.8,2,6550351,0.509293,139,6550537,47,6550351,47,0
I,-,6548591,1.0,0.00390625,8,0,8,2,78,gene,T10E9.9,3,6548544,0.176011,54,6548645,47,6548591,0,-47
I,-,6548576,0.666667,0.375,3,1,2,0,81,gene,T10E9.9,3,6548544,0.176011,69,6548645,32,6548591,-15,-47
I,-,6541063,0.0137615,0.0,218,215,3,1,3,gene,T10E9.8,0,6541056,0.235424,5463,6546526,7,6541152,-89,-96
I,-,6532978,0.0,3.46945e-18,58,58,0,0,49,gene,T10E9.7,0,6532968,4.5074,6152,6539130,10,6533032,-54,-64
I,-,6531964,0.004662,0.0,2574,2562,12,10,0,gene,T10E9.7,0,6531961,4.5074,22,6531986,3,6531964,0,-3
I,-,6523128,0.0,0.25,2,2,0,0,1,gene,T10E9.5,0,6523046,0.0330507,6030,6529158,82,6523463,-335,-417
I,-,6513651,0.00471698,0.0,212,211,1,1,0,gene,C55B7.11,0,6513649,0.38011,3923,6517574,2,6513651,0,-2
I,-,6494322,0.0,0.5,1,1,0,0,56,gene,C55B7.9,1,6494257,0.771997,7979,6502301,65,6494248,74,9
I,-,6493849,0.0,0.0,174,174,0,0,242,gene,C55B7.9,1,6493833,0.771997,8452,6502301,16,6493849,0,-16
I,-,6492729,0.931624,0.0,234,16,218,141,1,gene,C55B7.8,2,6492728,0.446299,94,6492823,1,6492729,0,-1
I,-,6488948,0.0,0.03125,5,5,0,0,28,gene,K06A5.8,0,6488928,0.173203,1770,6490718,20,6488948,0,-20
I,-,6471924,0.0041841,0.0,239,238,1,0,52,gene,K06A5.7,0,6471904,1.17841,2259,6474183,20,6471924,0,-20
I,-,6467319,0.0,0.0078125,7,7,0,0,2,gene,K06A5.6,0,6467304,3.17713,2068,6469387,15,6466943,376,361
I,-,6465719,0.0,0.0625,4,4,0,0,0,gene,K06A5.6,0,6465709,3.17713,3668,6469387,10,6465711,8,-2
I,-,6465711,0.0100358,0.0,1395,1381,14,12,4,gene,K06A5.6,0,6465709,3.17713,3676,6469387,2,6465711,0,-2
I,-,6458481,0.00613497,0.0,815,810,5,4,0,gene,T23H2.5,0,6458474,3.62557,5716,6464197,7,6458481,0,-7
I,-,6446467,0.0082713,0.0,1209,1199,10,10,10,gene,T23H2.3,0,6446466,0.803655,7517,6453984,1,6446466,1,0
I,-,6411630,0.0,4.70198e-38,124,124,0,0,2,gene,ZC328.3,0,6411561,0.583002,4676,6416306,69,6411561,69,0
I,-,6392526,0.0,4.03897e-28,91,91,0,0,5,gene,ZC328.2,0,6392477,0.342392,13338,6405864,49,6392526,0,-49
I,-,6358405,0.00591716,0.0,338,336,2,2,0,gene,K04F10.6,0,6358397,0.521516,27744,6386149,8,6358397,8,0
I,-,6324019,0.0,7.27596e-12,37,37,0,0,0,gene,F26B1.7,0,6323985,0.116704,32604,6356623,34,6323993,26,-8
I,-,6220766,0.00360064,0.0,115535,115119,416,364,6,gene,T08B2.10,0,6220752,153.8,479,6221245,14,6220766,0,-14
I,-,6214588,0.0,0.0,244,244,0,0,0,gene,T08B2.9,1,6214577,2.08596,5331,6219919,11,6214588,0,-11
I,-,6214425,0.0,2.38419e-07,22,22,0,0,2,gene,T08B2.9,1,6214217,2.08596,5494,6219919,208,6214425,0,-208
I,-,6214218,0.00618238,0.0,647,643,4,4,3,gene,T08B2.9,1,6214217,2.08596,5701,6219919,1,6214218,0,-1
I,-,6211887,0.919109,0.0,853,69,784,518,6,gene,T08B2.8,2,6211886,1.70899,100,6211987,1,6211887,0,-1
I,-,6209941,0.452223,0.000196301,1057,579,478,396,0,gene,T08B2.7,3,6209877,3.8044,1331,6211272,64,6209941,0,-64
I,-,6209748,0.0,0.5,1,1,0,0,1,gene,T08B2.7,3,6209745,3.8044,1524,6211272,3,6209748,0,-3
I,-,6194899,0.0,0.0,177,177,0,0,2,gene,T05E7.4,0,6194898,0.331527,5901,6200800,1,6194898,1,0
I,-,6183880,0.0,0.015625,6,6,0,0,12,gene,T09B4.10,1,6183848,1.08601,7569,6191449,32,6183882,-2,-34
I,-,6183858,0.0023753,0.0,421,420,1,1,107,gene,T09B4.10,1,6183848,1.08601,7591,6191449,10,6183858,0,-10
I,-,6183849,0.0,1.77636e-15,49,49,0,0,730,gene,T09B4.10,1,6183848,1.08601,7600,6191449,1,6183858,-9,-10
I,-,6180842,0.625207,1.6854e-10,603,226,377,259,0,gene,T09B4.9,2,6180842,0.945655,474,6181316,0,6180842,0,0
I,-,6166541,0.0106383,0.0,470,465,5,3,15,gene,T09B4.8,0,6166533,2.26044,11427,6177968,8,6166541,0,-8
I,-,6109657,0.0138122,0.0,362,357,5,5,10,gene,T27A3.7,1,6109649,0.469056,27065,6136722,8,6109657,0,-8
I,-,6107717,0.40625,0.000158254,320,190,130,93,8,gene,T27A3.6,2,6107717,0.549046,100,6107817,0,6107717,0,0
I,-,6078890,0.00294118,0.0,340,339,1,0,0,gene,ZK484.4,1,6078879,1.05754,8542,6087432,11,6078849,41,30
I,-,6070124,0.903005,0.0,732,71,661,385,5,gene,ZK484.3,2,6070124,3.11357,114,6070238,0,6070124,0,0
I,-,6068042,0.837209,3.66346e-06,43,7,36,22,0,gene,C27A12.9,3,6068034,0.28134,491,6068533,8,6068034,8,0
I,-,6060955,0.254545,0.0,990,738,252,202,7,gene,C27A12.8,4,6060954,0.94888,487,6061442,1,6060955,0,-1
I,-,6058426,1.0,0.03125,5,0,5,4,0,gene,C27A12.7,5,6058319,1.02857,122,6058548,107,6058426,0,-107
I,-,6058408,1.0,0.5,1,0,1,0,22,gene,C27A12.7,5,6058319,1.02857,140,6058548,89,6058426,-18,-107
I,-,6058259,0.933333,0.000457764,15,1,14,12,12,gene,C27A12.7,5,6058231,1.02857,289,6058548,28,6058259,0,-28
I,-,6058232,0.724215,2.74741e-22,446,123,323,223,17,gene,C27A12.7,5,6058231,1.02857,316,6058548,1,6058232,0,-1
I,-,6056071,1.0,0.5,1,0,1,0,2,gene,C27A12.6,6,6055951,0.536165,47,6056118,120,6055823,248,128
I,-,6055823,0.802469,1.54711e-36,405,80,325,245,4,gene,C27A12.6,6,6055822,0.536165,295,6056118,1,6055823,0,-1
I,-,6055812,0.5,0.5,2,1,1,1,874,gene,C27A12.6,6,6055798,0.536165,306,6056118,14,6055823,-11,-25
I,-,6011539,0.0,0.00012207,13,13,0,0,14,gene,C06A5.9,0,6011472,0.468032,12607,6024146,67,6011525,14,-53
I,-,6011499,0.0,0.00390625,8,8,0,0,222,gene,C06A5.9,0,6011472,0.468032,12647,6024146,27,6011525,-26,-53
I,-,6009535,0.0,2.38419e-07,22,22,0,0,39,gene,C06A5.8,0,6009520,0.268578,248,6009783,15,6009608,-73,-88
I,-,6009526,0.0,0.0,295,295,0,0,55,gene,C06A5.8,0,6009520,0.268578,257,6009783,6,6009608,-82,-88
I,-,6004925,0.0,0.125,3,3,0,0,1,gene,C06A5.12,0,6004925,0.242059,3157,6008082,0,6004925,0,0
I,-,6000888,0.00722022,0.0,277,275,2,2,64,gene,C06A5.7,0,6000776,1.5745,3785,6004673,112,6001101,-213,-325
I,-,5985871,0.00219298,0.0,456,455,1,1,3,gene,C06A5.6,0,5985861,0.554605,6798,5992669,10,5985871,0,-10
I,-,5973322,0.0,2.32831e-10,32,32,0,0,0,gene,B0207.12,0,5973322,0.260917,6949,5980271,0,5973322,0,0
I,-,5959528,0.0145985,5.34712e-38,137,135,2,0,11,gene,B0207.10,0,5959522,0.581927,3433,5962961,6,5959528,0,-6
I,-,5936959,0.0113122,0.0,442,437,5,5,3,gene,B0207.6,0,5936946,0.499725,8652,5945611,13,5936946,13,0
I,-,5904698,0.0,2.27374e-13,42,42,0,0,2,gene,C34G6.7,0,5904642,2.39622,30841,5935539,56,5904692,6,-50
I,-,5904692,0.0526316,2.5575e-09,38,36,2,2,28,gene,C34G6.7,0,5904642,2.39622,30847,5935539,50,5904692,0,-50
I,-,5904330,0.0126316,0.0,475,469,6,3,13,gene,C34G6.7,0,5904312,2.39622,31209,5935539,18,5904330,0,-18
I,-,5878957,0.00216216,0.0,925,923,2,2,5,gene,C34G6.6,0,5878892,4.98008,23143,5902100,65,5878957,0,-65
I,-,5869957,0.0107582,0.0,1952,1931,21,18,0,gene,F33D11.11,1,5869950,3.06625,4468,5874425,7,5869957,0,-7
I,-,5868142,0.923345,0.0,574,44,530,345,1,gene,F33D11.10,2,5868132,2.62488,124,5868266,10,5868142,0,-10
I,-,5866434,0.889796,0.0,490,54,436,318,1,gene,F33D11.12,3,5866350,0.868674,130,5866564,84,5866434,0,-84
I,-,5865045,0.0261438,1.92222e-39,153,149,4,3,12,gene,F33D11.12,3,5865013,0.868674,1519,5866564,32,5865045,0,-32
I,-,5862569,1.0,0.25,2,0,2,2,19,gene,F33D11.9,4,5862560,1.56423,77,5862646,9,5862560,9,0
I,-,5862514,0.840237,1.94385e-20,169,27,142,110,8,gene,F33D11.9,4,5862512,1.56423,132,5862646,2,5862560,-46,-48
I,-,5860036,0.0,0.5,1,1,0,0,15,gene,F33D11.9,4,5859964,1.56423,2610,5862646,72,5860036,0,-72
I,-,5859623,0.00598802,0.0,1503,1494,9,8,34,gene,F33D11.9,4,5859583,1.56423,3023,5862646,40,5859623,0,-40
I,-,5855041,0.00487805,0.0,205,204,1,0,34,gene,F33D11.8,0,5855024,0.338802,2510,5857551,17,5855050,-9,-26
I,-,5826151,0.00811359,0.0,493,489,4,2,33,gene,C32F10.8,0,5826047,3.32439,8496,5834647,104,5826151,0,-104
I,-,5825077,0.00359712,0.0,834,831,3,1,34,gene,C32F10.8,0,5825076,3.32439,9570,5834647,1,5825077,0,-1
I,-,5821118,0.00519481,0.0,385,383,2,2,5,gene,C32F10.6,0,5821111,0.41143,1754,5822872,7,5821111,7,0
I,-,5821111,0.0,3.9443e-31,101,101,0,0,71,gene,C32F10.6,0,5821111,0.41143,1761,5822872,0,5821111,0,0
I,-,5818129,0.5,0.273438,8,4,4,4,266,gene,C32F10.5,0,5818128,0.921377,353,5818482,1,5818128,1,0
I,-,5810005,0.0,0.0,1222,1222,0,0,10,gene,C32F10.4,0,5809998,2.793,5671,5815676,7,5810005,0,-7
I,-,5807257,0.027027,2.6921e-10,37,36,1,1,272,gene,B0414.8,0,5807251,0.560674,1166,5808423,6,5807244,13,7
I,-,5801302,0.666667,0.234375,6,2,4,4,0,gene,B0414.7,0,5801289,0.616995,2660,5803962,13,5801289,13,0
I,-,5795117,0.0188679,0.0,265,260,5,5,0,gene,B0414.6,0,5795044,0.339271,290,5795407,73,5795117,0,-73
I,-,5791755,0.021322,0.0,469,459,10,8,1,gene,B0414.5,0,5791726,0.787381,574,5792329,29,5791755,0,-29
I,-,5760803,0.907216,9.01917e-18,97,9,88,63,1,gene,F56H1.5,2,5760791,0.861967,96,5760899,12,5760796,7,-5
I,-,5760800,0.872428,1.04784e-34,243,31,212,151,1,gene,F56H1.5,2,5760791,0.861967,99,5760899,9,5760796,4,-5
I,-,5743574,0.003465,0.0,1443,1438,5,5,6,gene,F56H1.4,0,5743557,3.75092,10741,5754315,17,5743574,0,-17
I,-,5691506,0.00411523,0.0,243,242,1,1,0,gene,T19B4.7,0,5691485,1.25972,34875,5726381,21,5691506,0,-21
I,-,5673355,0.00165017,0.0,606,605,1,0,11,gene,F55F8.9,0,5673347,0.64204,5908,5679263,8,5673355,0,-8
I,-,5668841,0.0,6.10352e-05,14,14,0,0,6,gene,F55F8.8,0,5668840,0.0640811,1112,5669953,1,5668840,1,0
I,-,5658715,0.00353982,0.0,565,563,2,1,0,gene,F55F8.6,1,5658712,0.815897,734,5659449,3,5658715,0,-3
I,-,5657920,0.0357143,0.0,308,297,11,9,8,gene,F55F8.5,2,5657912,1.00965,1,5657921,8,5657920,0,-8
I,-,5655860,0.962656,0.0,241,9,232,150,7,gene,F55F8.4,3,5655823,1.31022,91,5655951,37,5655860,0,-37
I,-,5655850,0.952381,1.95769e-10,42,2,40,31,682,gene,F55F8.4,3,5655823,1.31022,101,5655951,27,5655850,0,-27
I,-,5653633,0.25,0.25,4,3,1,1,5,gene,F55F8.3,4,5653579,0.564516,198,5653831,54,5653642,-9,-63
I,-,5653608,0.515152,0.0764681,99,48,51,41,79,gene,F55F8.3,4,5653579,0.564516,223,5653831,29,5653642,-34,-63
I,-,5653593,0.5,0.5,2,1,1,1,672,gene,F55F8.3,4,5653579,0.564516,238,5653831,14,5653642,-49,-63
I,-,5649659,0.928205,1.62821e-38,195,14,181,123,10,gene,F55F8.2,5,5649652,0.76356,103,5649762,7,5649659,0,-7
I,-,5624478,0.820513,2.79778e-05,39,7,32,26,0,gene,F46F11.10,2,5624478,0.166679,126,5624604,0,5624478,0,0
I,-,5618684,0.025641,7.09406e-11,39,38,1,1,6,gene,F46F11.6,1,5618556,1.26753,4342,5623026,128,5618554,130,2
I,-,5618554,0.00263158,0.0,380,379,1,1,2,gene,F46F11.6,1,5618416,1.26753,4472,5623026,138,5618554,0,-138
I,-,5616405,0.811966,2.05782e-12,117,22,95,59,3,gene,F46F11.9,2,5616383,0.471005,188,5616593,22,5616405,0,-22
I,-,5616398,0.714286,0.0610962,14,4,10,6,147,gene,F46F11.9,2,5616383,0.471005,195,5616593,15,5616405,-7,-22
I,-,5610273,0.175123,0.0,9519,7852,1667,1057,8,gene,F46F11.5,3,5610257,18.2201,104,5610377,16,5610273,0,-16
I,-,5608844,0.0168269,0.0,1248,1227,21,16,0,gene,F46F11.4,4,5608839,5.15783,495,5609339,5,5608843,1,-4
I,-,5607530,0.0,4.54747e-13,41,41,0,0,1,gene,F46F11.11,0,5607520,0.0938808,287,5607817,10,5607520,10,0
I,-,5597363,0.0,3.58732e-43,141,141,0,0,2,gene,M01E11.7,0,5597253,1.00713,7491,5604854,110,5597253,110,0
I,-,5589316,0.0,3.46945e-18,58,58,0,0,91,gene,M01E11.7,0,5589307,1.00713,1040,5590356,9,5589316,0,-9
I,-,5589310,0.0,1.86265e-09,29,29,0,0,105,gene,M01E11.7,0,5589307,1.00713,1046,5590356,3,5589316,-6,-9
I,-,5579258,0.0,0.015625,6,6,0,0,6,gene,M01E11.6,0,5579231,0.932184,4159,5583417,27,5579302,-44,-71
I,-,5572952,0.00387883,0.0,5414,5393,21,21,166,gene,M01E11.5,1,5572920,4.50832,4120,5577072,32,5572976,-24,-56
I,-,5570082,0.493942,0.0192148,1403,710,693,607,0,gene,M01E11.4,2,5570080,4.35983,1705,5571787,2,5570080,2,0
I,-,5550298,0.00281162,0.0,2134,2128,6,6,38,gene,M01A10.3,0,5550293,6.68237,16048,5566346,5,5550298,0,-5
I,-,5533715,0.047619,1.95769e-10,42,40,2,1,2,gene,F59A3.9,0,5533713,0.131065,15425,5549140,2,5533713,2,0
I,-,5511692,0.0238095,9.54969e-12,42,41,1,1,2,gene,F59A3.6,0,5511672,0.438164,5667,5517359,20,5511692,0,-20
I,-,5509173,0.0271967,0.0,478,465,13,12,0,gene,F59A3.4,1,5509172,1.22522,297,5509470,1,5509172,1,0
I,-,5507026,0.878652,0.0,445,54,391,269,1,gene,F59A3.3,2,5507026,1.02874,93,5507119,0,5507026,0,0
I,-,5485745,0.00227772,0.0,121174,120898,276,242,16,gene,C09D4.5,1,5485715,104.809,743,5486488,30,5485745,0,-30
I,-,5484661,0.964286,0.0,560,20,540,423,1,gene,C09D4.4,2,5484646,0.609554,116,5484777,15,5484646,15,0
I,-,5479441,0.982699,0.0,289,5,284,209,59,gene,T05E8.3,3,5479441,0.710481,104,5479545,0,5479441,0,0
I,-,5469639,0.0,0.25,2,2,0,0,3,gene,T05E8.2,0,5469633,0.0268819,2743,5472382,6,5469630,9,3
I,-,5446870,0.0,0.125,3,3,0,0,7,gene,F27C1.13,0,5446858,0.0148933,5914,5452784,12,5446858,12,0
I,-,5433057,0.00293542,0.0,4088,4076,12,8,3,gene,F27C1.8,0,5433054,13.4658,852,5433909,3,5433057,0,-3
I,-,5429625,0.0,0.0625,4,4,0,0,2,gene,F27C1.7,1,5429623,19.2721,1112,5430737,2,5429625,0,-2
I,-,5428460,0.942149,2.37507e-26,121,7,114,76,1,gene,F27C1.6,2,5428443,0.690763,71,5428531,17,5428460,0,-17
I,-,5428451,0.941441,0.0,222,13,209,140,509,gene,F27C1.6,2,5428443,0.690763,80,5428531,8,5428451,0,-8
I,-,5420734,1.0,0.00195312,9,0,9,6,4,gene,C30H7.2,3,5420695,1.71803,562,5421296,39,5420734,0,-39
I,-,5420104,0.394872,6.98241e-06,390,236,154,104,1,gene,C30H7.2,3,5420102,1.71803,1192,5421296,2,5420104,0,-2
I,-,5415632,0.291262,5.5692e-10,206,146,60,32,4,gene,C24A11.9,4,5415617,0.813168,1020,5416652,15,5415632,0,-15
I,-,5408347,0.004,0.0,750,747,3,3,3,gene,C24A11.8,0,5408341,1.7571,4497,5412844,6,5408347,0,-6
I,-,5384511,0.00315457,0.0,317,316,1,1,0,gene,F55A12.9,0,5384472,2.72489,18632,5403143,39,5384511,0,-39
I,-,5376344,0.0103093,6.12156e-28,97,96,1,1,9,gene,F55A12.9,0,5376320,2.72489,26799,5403143,24,5376344,0,-24
I,-,5367832,0.0144928,0.0,345,340,5,5,2,gene,F55A12.10,0,5367819,0.175475,5025,5372857,13,5367832,0,-13
I,-,5354015,0.0,0.0,154,154,0,0,0,gene,F55A12.8,0,5353968,0.842378,12932,5366947,47,5353770,245,198
I,-,5353770,0.00431034,0.0,464,462,2,2,5,gene,F55A12.8,0,5353770,0.842378,13177,5366947,0,5353770,0,0
I,-,5344727,0.00246305,0.0,406,405,1,1,10,gene,F55A12.7,0,5344707,1.30418,4921,5349648,20,5344727,0,-20
I,-,5319276,0.011236,0.0,356,352,4,3,39,gene,F48C1.6,1,5319274,1.04393,11305,5330581,2,5319299,-23,-25
I,-,5318127,0.943061,0.0,281,16,265,191,0,gene,F48C1.5,2,5318113,1.11118,102,5318229,14,5318113,14,0
I,-,5313927,0.0,0.0,172,172,0,0,4,gene,F48C1.4,3,5313824,0.872062,3567,5317494,103,5313726,201,98
I,-,5300334,0.00833333,0.0,360,357,3,3,8,gene,C01G8.6,0,5300309,0.647985,619,5300953,25,5300334,0,-25
I,-,5291607,0.169385,0.0,1594,1324,270,232,0,gene,C01G8.5,1,5291511,5.59589,7150,5298757,96,5291607,0,-96
I,-,5290697,0.002457,0.0,814,812,2,2,4,gene,C01G8.5,1,5290638,5.59589,8060,5298757,59,5290697,0,-59
I,-,5283947,0.927536,1.41875e-27,138,10,128,92,3,gene,C01G8.4,2,5283929,0.272863,115,5284062,18,5283944,3,-15
I,-,5281527,0.252841,3.10135e-41,704,526,178,116,0,gene,C01G8.3,3,5281519,0.848224,561,5282088,8,5281519,8,0
I,-,5278711,0.96,3.0933e-24,100,4,96,64,12,gene,C01G8.2,4,5278701,0.297467,93,5278804,10,5278711,0,-10
I,-,5278702,0.666667,0.234375,6,2,4,4,323,gene,C01G8.2,4,5278701,0.297467,102,5278804,1,5278711,-9,-10
I,-,5272038,0.0056338,0.0,355,353,2,2,4,gene,B0261.8,0,5272034,0.849898,811,5272849,4,5272040,-2,-6
I,-,5270942,0.017284,0.0,810,796,14,14,3,gene,B0261.7,0,5270937,1.32532,336,5271278,5,5270937,5,0
I,-,5241917,0.0,1.77636e-15,49,49,0,0,1,gene,C32E12.4,0,5241878,0.211125,7851,5249768,39,5241917,0,-39
I,-,5208131,0.00540541,0.0,185,184,1,1,4,gene,C32E12.5,0,5208124,1.21506,22425,5230556,7,5208131,0,-7
I,-,5175539,0.010084,0.0,595,589,6,6,3,gene,F56A3.4,0,5175524,1.47763,10100,5185639,15,5175525,14,-1
I,-,5164887,0.0108932,0.0,459,454,5,2,8,gene,Y110A7A.19,0,5164884,0.772152,6416,5171303,3,5164887,0,-3
I,-,5162232,0.0119403,0.0,335,331,4,4,1,gene,Y110A7A.18,0,5162207,0.883332,370,5162602,25,5162207,25,0
I,-,5127202,0.00522193,0.0,766,762,4,4,62,gene,Y110A7A.17,0,5127190,1.67273,12254,5139456,12,5127202,0,-12
I,-,5118855,0.00490196,0.0,204,203,1,1,15,gene,Y110A7A.16,0,5118850,0.39413,5063,5123918,5,5118855,0,-5
I,-,5113755,0.0157895,0.0,190,187,3,2,15,gene,Y110A7A.15,0,5113741,0.476168,367,5114122,14,5113755,0,-14
I,-,5106051,0.0110935,0.0,1262,1248,14,12,7,gene,Y110A7A.14,1,5106048,6.8841,3435,5109486,3,5106051,0,-3
I,-,5104914,0.938838,0.0,327,20,307,240,34,gene,Y110A7A.13,2,5104914,1.08802,199,5105113,0,5104919,-5,-5
I,-,5103476,1.0,0.000488281,11,0,11,11,3,gene,Y110A7A.12,3,5103457,0.205685,107,5103583,19,5103404,72,53
I,-,5103397,0.636364,0.161133,11,4,7,7,89,gene,Y110A7A.12,3,5103355,0.205685,186,5103583,42,5103404,-7,-49
I,-,5082282,0.00869565,0.0,230,228,2,2,3,gene,C30F8.2,0,5082260,11.0188,19474,5101756,22,5082282,0,-22
I,-,5082276,0.0135747,0.0,442,436,6,5,14,gene,C30F8.2,0,5082260,11.0188,19480,5101756,16,5082276,0,-16
I,-,5082268,0.0,6.10352e-05,14,14,0,0,2857,gene,C30F8.2,0,5082260,11.0188,19488,5101756,8,5082268,0,-8
I,-,5068832,0.0181818,1.54143e-44,165,162,3,2,0,gene,C46H11.11,0,5068831,0.700726,11075,5079907,1,5068832,0,-1
I,-,5054997,0.027027,2.6921e-10,37,36,1,1,3,gene,C46H11.10,0,5054886,0.356338,3255,5058252,111,5054886,111,0
I,-,5054341,1.0,0.03125,5,0,5,5,6,gene,C46H11.10,0,5054341,0.356338,3911,5058252,0,5054341,0,0
I,-,5016312,0.0,6.10352e-05,14,14,0,0,1,gene,F54C1.6,0,5016260,0.0237463,2458,5018770,52,5016260,52,0
I,-,4993507,0.0,0.03125,5,5,0,0,9,gene,F54C1.5,0,4993453,0.10803,11453,5004960,54,4993507,0,-54
I,-,4967090,0.0104167,0.0,576,570,6,6,12,gene,W03G9.4,0,4967071,2.26901,903,4967993,19,4967090,0,-19
I,-,4958195,0.0040724,0.0,2210,2201,9,9,23,gene,W03G9.8,1,4958155,1.72281,6470,4964665,40,4958567,-372,-412
I,-,4957668,0.949416,0.0,257,13,244,177,1,gene,F28B3.7,2,4957661,1.35884,105,4957773,7,4957668,0,-7
I,-,4951482,0.974468,0.0,705,18,687,441,6,gene,F28B3.6,3,4951470,1.35555,89,4951571,12,4951482,0,-12
I,-,4950477,1.0,0.125,3,0,3,1,7,gene,F28B3.10,4,4950406,2.418,105,4950582,71,4950411,66,-5
I,-,4950435,1.0,0.25,2,0,2,1,1,gene,F28B3.10,4,4950406,2.418,147,4950582,29,4950411,24,-5
I,-,4950411,0.896416,0.0,2037,211,1826,1111,3,gene,F28B3.10,4,4950406,2.418,171,4950582,5,4950411,0,-5
I,-,4950375,1.0,0.00390625,8,0,8,4,1000,gene,F28B3.10,4,4950352,2.418,207,4950582,23,4950411,-36,-59
I,-,4950343,0.666667,0.164062,9,3,6,2,723,gene,F28B3.10,4,4950295,2.418,239,4950582,48,4950411,-68,-116
I,-,4926234,0.000832639,0.0,1201,1200,1,1,0,gene,F28B3.8,0,4926196,1.59342,23096,4949330,38,4926234,0,-38
I,-,4914048,0.0069808,0.0,1719,1707,12,10,3,gene,F21F3.6,0,4914045,8.99702,6639,4920687,3,4914048,0,-3
I,-,4887959,0.0,7.27596e-12,37,37,0,0,48,gene,F25F8.2,0,4887950,0.243468,9665,4897624,9,4887966,-7,-16
I,-,4867826,0.0,8.88178e-16,50,50,0,0,2,gene,C01F4.2,0,4867823,0.153965,17220,4885046,3,4867826,0,-3
I,-,4826634,0.0267857,4.38958e-29,112,109,3,3,1,gene,F57C9.7,0,4826634,0.185324,24027,4850661,0,4826634,0,0
I,-,4777718,0.0,2.64698e-23,75,75,0,0,0,gene,M04F3.5,1,4777717,0.914183,12927,4790645,1,4777718,0,-1
I,-,4773042,0.25,0.25,4,3,1,1,92,gene,M04F3.4,2,4773025,2.13027,776,4773818,17,4773048,-6,-23
I,-,4773025,0.0883352,0.0,883,805,78,63,1012,gene,M04F3.4,2,4773025,2.13027,793,4773818,0,4773048,-23,-23
I,-,4765191,0.25,0.25,4,3,1,1,6,gene,M04F3.3,0,4765141,0.143736,3132,4768323,50,4765141,50,0
I,-,4765169,0.0,1.35525e-20,66,66,0,0,54,gene,M04F3.3,0,4765141,0.143736,3154,4768323,28,4765141,28,0
I,-,4762374,0.0,1.73472e-18,59,59,0,0,0,gene,M04F3.6,0,4762360,None,825,4763199,14,4762360,14,0
I,-,4744322,0.0029383,0.0,1021,1018,3,3,0,gene,C10H11.9,1,4744262,1.48469,15499,4759821,60,4744322,0,-60
I,-,4738123,1.0,0.000976562,10,0,10,8,59,gene,C10H11.8,2,4738076,0.418855,58,4738181,47,4737848,275,228
I,-,4738115,0.9,0.00976562,10,1,9,9,52,gene,C10H11.8,2,4738076,0.418855,66,4738181,39,4737848,267,228
I,-,4738099,0.951542,0.0,681,33,648,417,215,gene,C10H11.8,2,4738076,0.418855,82,4738181,23,4737848,251,228
I,-,4737686,1.0,0.5,1,0,1,1,10,gene,C10H11.8,2,4737634,0.418855,370,4738056,52,4737848,-162,-214
I,-,4715209,0.0070922,5.05813e-41,141,140,1,1,16,gene,W09C3.7,0,4715162,0.831728,1765,4716974,47,4715486,-277,-324
I,-,4698576,0.0,1.0842e-19,63,63,0,0,6,gene,T04D1.4,0,4698576,1.75071,10691,4709267,0,4698576,0,0
I,-,4671739,0.00286944,0.0,697,695,2,2,3,gene,B0041.7,0,4671715,1.06998,11529,4683268,24,4671739,0,-24
I,-,4652899,0.00497512,0.0,201,200,1,1,3,gene,B0041.6,0,4652898,0.686687,7942,4660841,1,4652906,-7,-8
I,-,4650771,0.00293255,0.0,341,340,1,1,3,gene,B0041.5,0,4650703,1.05535,1377,4652148,68,4650771,0,-68
I,-,4646964,0.00237041,0.0,38390,38299,91,77,16,gene,B0041.4,0,4646958,86.4255,1306,4648270,6,4646964,0,-6
I,-,4644070,0.652968,1.6955e-06,219,76,143,123,18,gene,Y119C1A.1,1,4644056,1.14218,1566,4645636,14,4644278,-208,-222
I,-,4640883,0.911932,0.0,352,31,321,264,4,gene,C44E4.3,2,4640873,0.839867,115,4640998,10,4640883,0,-10
I,-,4640856,0.79021,5.84073e-13,143,30,113,98,629,gene,C44E4.3,2,4640849,0.839867,142,4640998,7,4640883,-27,-34
I,-,4637308,1.0,0.5,1,0,1,0,3,gene,C44E4.6,3,4637168,18.1651,127,4637435,140,4637329,-21,-161
I,-,4636380,0.338858,0.0,13094,8657,4437,3016,87,gene,C44E4.6,3,4636342,18.1651,1055,4637435,38,4636380,0,-38
I,-,4633378,0.00675676,0.0,296,294,2,2,0,gene,C44E4.2,0,4633348,0.355933,1150,4634528,30,4633348,30,0
I,-,4602667,0.0056391,0.0,532,529,3,2,0,gene,D1007.7,0,4602640,0.994748,7477,4610144,27,4602667,0,-27
I,-,4589915,0.0267857,0.0,224,218,6,5,4,gene,D1007.19,0,4589900,0.211086,8002,4597917,15,4589900,15,0
I,-,4584506,0.00394896,0.0,40517,40357,160,139,54,gene,D1007.6,1,4584492,110.967,5095,4589601,14,4584506,0,-14
I,-,4583811,0.944954,0.0,218,12,206,155,7,gene,D1007.5,2,4583805,0.680566,47,4583858,6,4583811,0,-6
I,-,4580602,0.905085,0.0,295,28,267,191,0,gene,D1007.4,3,4580588,0.540132,98,4580700,14,4580585,17,3
I,-,4579704,0.0,0.00195312,9,9,0,0,36,gene,D1007.18,0,4579687,0.442658,260,4579964,17,4579704,0,-17
I,-,4577205,0.0,4.65661e-10,31,31,0,0,0,gene,D1007.3,0,4577201,0.0670222,1491,4578696,4,4577201,4,0
I,-,4570028,0.0,9.31323e-10,30,30,0,0,0,gene,D1007.1,0,4570025,0.0652467,1185,4571213,3,4570028,0,-3
I,-,4556832,0.0,0.0078125,7,7,0,0,9,gene,Y119C1B.10,0,4556812,0.473279,11965,4568797,20,4556812,20,0
I,-,4556816,0.0,0.0,183,183,0,0,20,gene,Y119C1B.10,0,4556812,0.473279,11981,4568797,4,4556812,4,0
I,-,4539724,0.00431965,0.0,463,461,2,0,2,gene,Y119C1B.9,0,4539708,0.64992,15628,4555352,16,4539708,16,0
I,-,4534799,0.00397088,0.0,1511,1505,6,5,4,gene,Y119C1B.8,0,4534799,1.3724,2654,4537453,0,4534799,0,0
I,-,4518492,0.00411523,0.0,486,484,2,2,0,gene,Y119C1B.6,0,4518466,0.601239,7475,4525967,26,4518466,26,0
I,-,4516084,0.00578035,0.0,173,172,1,1,6,gene,Y119C1B.5,1,4516057,0.36984,1084,4517168,27,4516084,0,-27
I,-,4511127,0.170557,0.0,557,462,95,68,3,gene,Y119C1B.4,2,4511125,0.893016,314,4511441,2,4511127,0,-2
I,-,4450928,0.204301,1.35802e-24,279,222,57,45,1,gene,C41D11.5,2,4450924,1.25982,270,4451198,4,4450926,2,-2
I,-,4449775,0.903797,0.0,395,38,357,260,28,gene,C41D11.9,3,4449775,0.447023,84,4449859,0,4449775,0,0
I,-,4448462,0.958961,0.0,1194,49,1145,684,3,gene,C41D11.8,4,4448455,1.61178,119,4448581,7,4448462,0,-7
I,-,4444343,0.0,3.23117e-27,88,88,0,0,2,gene,C41D11.4,0,4444343,0.739618,2251,4446594,0,4444106,237,237
I,-,4444157,0.0,0.5,1,1,0,0,2,gene,C41D11.4,0,4444115,0.739618,2437,4446594,42,4444106,51,9
I,-,4431925,0.0,1.05879e-22,73,73,0,0,10,gene,C41D11.3,0,4431917,0.877514,9745,4441670,8,4431917,8,0
I,-,4381941,0.0,9.31323e-10,30,30,0,0,9,gene,ZK973.11,0,4381908,0.939426,30288,4412229,33,4381899,42,9
I,-,4373019,0.00796081,0.0,1633,1620,13,13,11,gene,ZK973.10,1,4373019,5.33885,6306,4379325,0,4373019,0,0
I,-,4372139,0.889728,0.0,662,73,589,425,2,gene,ZK973.9,2,4372139,1.51783,111,4372250,0,4372137,2,2
I,-,4270288,0.00724638,0.0,552,548,4,4,1,gene,C43E11.10,1,4270288,0.761179,3473,4273761,0,4270288,0,0
I,-,4267968,0.891679,0.0,1394,151,1243,836,7,gene,C43E11.9,2,4267968,2.57561,102,4268070,0,4267968,0,0
I,-,4242728,0.970149,0.0,201,6,195,124,1,gene,C43E11.7,2,4242727,0.611278,92,4242820,1,4242728,0,-1
I,-,4210343,0.003367,0.0,297,296,1,1,3,gene,C18E3.8,0,4210342,0.31339,3952,4214295,1,4210342,1,0
I,-,4178448,0.00381679,0.0,2358,2349,9,9,17,gene,R12E2.13,0,4178436,3.79717,30146,4208594,12,4178448,0,-12
I,-,4174775,0.00174216,0.0,574,573,1,1,11,gene,R12E2.12,1,4174740,1.47868,2529,4177304,35,4174775,0,-35
I,-,4173625,0.410831,9.07095e-10,1071,631,440,300,17,gene,R12E2.11,2,4173624,2.52981,122,4173747,1,4173625,0,-1
I,-,4161114,0.00466418,0.0,1072,1067,5,5,68,gene,R12E2.9,0,4161111,1.45869,7872,4168986,3,4161114,0,-3
I,-,4144584,0.0,1.19209e-07,23,23,0,0,1,gene,E01A2.7,0,4144568,0.147174,731,4145315,16,4144584,0,-16
I,-,4138953,0.00174672,0.0,1145,1143,2,2,1,gene,E01A2.6,1,4138946,3.67534,3303,4142256,7,4138953,0,-7
I,-,4137073,0.929204,1.26117e-44,226,16,210,147,4,gene,E01A2.5,2,4137069,0.332465,89,4137162,4,4137069,4,0
I,-,4073127,0.0,1.19209e-07,23,23,0,0,3,gene,C09D1.2,0,4073102,0.0298394,56436,4129563,25,4072849,278,253
I,-,4031740,0.0,2.58494e-26,85,85,0,0,1,gene,F55C7.7,0,4031686,1.67255,39975,4071715,54,4031628,112,58
I,-,4017475,0.0,6.77626e-21,67,67,0,0,96,gene,F55C7.7,0,4017474,1.67255,54240,4071715,1,4017475,0,-1
I,-,4011586,0.0,3.15544e-30,98,98,0,0,0,gene,F55C7.7,0,4011582,1.67255,3588,4015174,4,4011586,0,-4
I,-,4011209,0.0,0.5,1,1,0,0,1,gene,F55C7.7,0,4011179,1.67255,3965,4015174,30,4011586,-377,-407
I,-,3977425,0.0,6.10352e-05,14,14,0,0,0,gene,F28H1.4,0,3977220,1.16544,1336,3978761,205,3977220,205,0
I,-,3975743,0.00578035,0.0,173,172,1,1,2,gene,F28H1.4,0,3975701,1.16544,3018,3978761,42,3975743,0,-42
I,-,3953993,0.0,0.0,402,402,0,0,0,gene,T21E3.3,0,3953967,0.706307,9122,3963115,26,3953944,49,23
I,-,3927887,0.0172786,0.0,463,455,8,8,4,gene,T20F5.7,1,3927883,0.861812,7384,3935271,4,3927889,-2,-6
I,-,3925172,0.793103,1.24326e-08,87,18,69,55,0,gene,T20F5.6,2,3925125,1.00143,263,3925435,47,3925173,-1,-48
I,-,3925164,0.903226,7.48774e-22,124,12,112,84,313,gene,T20F5.6,2,3925125,1.00143,271,3925435,39,3925165,-1,-40
I,-,3915310,0.00327869,0.0,305,304,1,1,0,gene,T20F5.4,0,3915200,1.4888,2490,3917800,110,3915460,-150,-260
I,-,3910544,0.00495049,0.0,202,201,1,1,23,gene,T20F5.3,0,3910539,0.491592,172,3910716,5,3910544,0,-5
I,-,3905210,0.021978,1.65396e-24,91,89,2,1,6,gene,C50F2.8,0,3905202,0.370567,4426,3909636,8,3905202,8,0
I,-,3899347,0.00250941,0.0,797,795,2,2,5,gene,C50F2.6,0,3899346,2.98383,984,3900331,1,3899347,0,-1
I,-,3887093,0.0,0.5,1,1,0,0,27,gene,C50F2.9,1,3887082,0.357329,1213,3888306,11,3887082,11,0
I,-,3876706,0.00507614,0.0,394,392,2,2,7,gene,T03F1.12,0,3876705,0.603512,8927,3885633,1,3876706,0,-1
I,-,3865940,0.00386698,0.0,1293,1288,5,5,8,gene,T03F1.9,1,3865939,1.09081,4748,3870688,1,3865940,0,-1
I,-,3862729,0.955357,2.58371e-26,112,5,107,75,11,gene,T03F1.8,2,3862705,1.61054,48,3862777,24,3862731,-2,-26
I,-,3862059,0.5,0.5,2,1,1,1,17,gene,T03F1.8,2,3861983,1.61054,718,3862777,76,3862070,-11,-87
I,-,3859294,0.929412,1.13053e-17,85,6,79,65,1,gene,T03F1.7,3,3859294,0.480024,87,3859381,0,3859294,0,0
I,-,3841552,0.00632911,0.0,158,157,1,1,10,gene,T03F1.6,1,3841532,0.388029,12631,3854183,20,3841532,20,0
I,-,3839836,0.0,0.5,1,1,0,0,2,gene,T03F1.5,2,3839696,0.852355,14347,3854183,140,3839675,161,21
I,-,3839675,1.0,0.5,1,0,1,1,8,gene,T03F1.5,2,3839602,0.852355,140,3839815,73,3839675,0,-73
I,-,3816811,0.00473934,0.0,633,630,3,3,31,gene,C32E8.11,0,3816803,0.878241,17304,3834115,8,3816798,13,5
I,-,3805739,0.00298211,0.0,1006,1003,3,2,3,gene,C32E8.10,1,3805706,1.3989,1721,3807460,33,3805706,33,0
I,-,3805499,0.0,0.25,2,2,0,0,0,gene,C32E8.10,1,3805448,1.3989,1961,3807460,51,3805499,0,-51
I,-,3798069,0.418994,0.00570062,179,104,75,53,2,gene,C32E8.9,2,3798051,0.460436,324,3798393,18,3798055,14,-4
I,-,3792799,0.00962861,0.0,727,720,7,7,0,gene,C32E8.8,0,3792797,1.08443,1756,3794555,2,3792799,0,-2
I,-,3759041,0.005005,0.0,999,994,5,3,430,gene,ZK770.3,1,3758993,3.59687,14871,3773912,48,3759041,0,-48
I,-,3753960,0.400529,1.69984e-15,1513,907,606,309,5,gene,Y8G1A.2,2,3753907,2.99895,1492,3755452,53,3753960,0,-53
I,-,3737480,0.00374813,0.0,1334,1329,5,5,7,gene,T12F5.5,0,3737452,2.74755,11042,3748522,28,3737480,0,-28
I,-,3721159,0.00372439,0.0,537,535,2,2,3,gene,T12F5.4,0,3721094,1.20464,11713,3732872,65,3721159,0,-65
I,-,3709437,0.0,7.45058e-09,27,27,0,0,2,gene,F21A9.2,0,3709222,0.117704,3688,3713125,215,3708742,695,480
I,-,3697734,0.0,0.015625,6,6,0,0,0,gene,H26D21.2,0,3697732,0.765188,8302,3706036,2,3697551,183,181
I,-,3697551,0.0220126,0.0,318,311,7,7,5,gene,H26D21.2,0,3697537,0.765188,8485,3706036,14,3697551,0,-14
I,-,3684088,0.00520291,0.0,961,956,5,3,79,gene,D1037.4,0,3684061,2.12215,6059,3690147,27,3684120,-32,-59
I,-,3680929,0.00442152,0.0,1357,1351,6,5,128,gene,D1037.3,0,3680901,15.5452,1887,3682816,28,3680946,-17,-45
I,-,3671702,0.0045045,0.0,222,221,1,1,5,gene,D1037.2,0,3671682,0.469535,8471,3680173,20,3671702,0,-20
I,-,3647077,0.00568182,0.0,352,350,2,1,0,gene,T28F2.5,0,3646883,0.713957,4155,3651232,194,3647011,66,-128
I,-,3636501,0.0,0.5,1,1,0,0,0,gene,T28F2.4,0,3636477,0.464165,5153,3641654,24,3636485,16,-8
I,-,3636485,0.0,0.0,419,419,0,0,15,gene,T28F2.4,0,3636477,0.464165,5169,3641654,8,3636485,0,-8
I,-,3608310,0.0,0.000244141,12,12,0,0,45,gene,Y47G6A.25,1,3608281,0.24882,10581,3618891,29,3608347,-37,-66
I,-,3605705,0.502809,0.042022,356,177,179,141,30,gene,Y47G6A.24,2,3605696,1.52841,708,3606413,9,3605746,-41,-50
I,-,3600731,0.0,1.81899e-12,39,39,0,0,0,gene,Y47G6A.29,0,3600728,0.317946,3789,3604520,3,3600679,52,49
I,-,3562853,0.20736,0.0,1413,1120,293,215,33,gene,Y47G6A.22,2,3562846,1.33008,2158,3565011,7,3562853,0,-7
I,-,3559825,1.0,0.125,3,0,3,2,0,gene,Y47G6A.21,3,3559798,0.774728,7,3559832,27,3559809,16,-11
I,-,3559809,0.466258,0.0118604,489,261,228,159,3,gene,Y47G6A.21,3,3559798,0.774728,23,3559832,11,3559809,0,-11
I,-,3546906,0.00630252,0.0,476,473,3,2,0,gene,Y47G6A.20,0,3546896,1.35818,5044,3551950,10,3546906,0,-10
I,-,3529958,0.00753296,0.0,531,527,4,0,2,gene,Y47G6A.19,0,3529958,1.31457,9353,3539311,0,3529958,0,0
I,-,3512735,0.00662252,0.0,755,750,5,2,5,gene,Y47G6A.18,0,3512661,1.37201,10580,3523315,74,3512735,0,-74
I,-,3466303,0.027972,1.49786e-36,143,139,4,4,0,gene,Y47G6A.14,0,3466289,0.293104,6244,3472547,14,3466303,0,-14
I,-,3438544,0.0,0.0,519,519,0,0,1,gene,Y47G6A.12,0,3438534,0.745418,827,3439371,10,3438544,0,-10
I,-,3402865,0.0,1.54074e-33,109,109,0,0,22,gene,W05F2.4,0,3402812,1.01195,6723,3409588,53,3402865,0,-53
I,-,3384008,0.0,0.0078125,7,7,0,0,0,gene,W05F2.4,0,3383855,1.01195,25580,3409588,153,3384008,0,-153
I,-,3383216,0.0,0.125,3,3,0,0,1,gene,W05F2.4,0,3383214,1.01195,26372,3409588,2,3383216,0,-2
I,-,3368551,0.00395738,0.0,3285,3272,13,12,110,gene,W05F2.3,0,3368551,6.34191,6225,3374776,0,3368553,-2,-2
I,-,3349917,0.0,0.5,1,1,0,0,1,gene,Y44E3A.6,0,3349892,1.297,13902,3363819,25,3349901,16,-9
I,-,3349901,0.0,0.0,195,195,0,0,71,gene,Y44E3A.6,0,3349892,1.297,13918,3363819,9,3349901,0,-9
I,-,3330674,0.0100334,0.0,299,296,3,2,0,gene,Y44E3A.4,1,3330612,0.837756,9540,3340214,62,3330674,0,-62
I,-,3318585,0.910605,0.0,2282,204,2078,1324,0,gene,Y44E3A.3,2,3318576,4.76746,246,3318831,9,3318584,1,-8
I,-,3307586,0.0,0.0,163,163,0,0,0,gene,Y44E3A.2,0,3307557,0.288544,10390,3317976,29,3307466,120,91
I,-,3294357,0.00326619,0.0,1837,1831,6,6,3,gene,W01B11.6,0,3294348,2.4204,7006,3301363,9,3294357,0,-9
I,-,3280508,0.0,0.25,2,2,0,0,3,gene,W01B11.5,0,3280477,0.34263,12630,3293138,31,3280884,-376,-407
I,-,3277656,0.02,4.44089e-14,50,49,1,1,0,gene,W01B11.5,0,3277656,0.34263,15482,3293138,0,3277656,0,0
I,-,3265856,0.00909091,0.0,220,218,2,1,1,gene,Y44E3B.1,0,3265855,0.774663,3551,3269407,1,3265855,1,0
I,-,3265288,0.0204082,0.0,196,192,4,4,3,gene,Y44E3B.1,0,3265225,0.774663,4119,3269407,63,3265288,0,-63
I,-,3246074,0.0,0.0,756,756,0,0,1,gene,Y54E10A.16,0,3246062,1.11463,18162,3264236,12,3246074,0,-12
I,-,3222954,0.458015,0.0100827,393,213,180,153,1,gene,Y54E10A.14,2,3222951,0.517936,207,3223161,3,3222951,3,0
I,-,3198839,0.0,1.83671e-40,132,132,0,0,0,gene,Y54E10A.12,0,3198832,0.27542,392,3199231,7,3198832,7,0
I,-,3192858,0.902439,7.37048e-15,82,8,74,63,8,gene,Y54E10A.11,1,3192697,0.433863,671,3193529,161,3192731,127,-34
I,-,3192741,0.863636,0.000367165,22,3,19,15,34,gene,Y54E10A.11,1,3192697,0.433863,788,3193529,44,3192731,10,-34
I,-,3176320,0.705548,8.69358e-29,703,207,496,399,8,gene,Y54E10A.10,2,3176311,1.50083,99,3176419,9,3176320,0,-9
I,-,3176312,0.444444,0.246094,9,5,4,4,1386,gene,Y54E10A.10,2,3176311,1.50083,107,3176419,1,3176320,-8,-9
I,-,3162386,0.00496278,0.0,2418,2406,12,11,0,gene,Y54E10A.9,0,3162284,4.26689,10879,3173265,102,3162377,9,-93
I,-,3151997,0.0425532,7.68097e-12,47,45,2,1,1,gene,K09H9.7,0,3151980,0.398755,6496,3158493,17,3151980,17,0
I,-,3147794,0.0262172,0.0,267,260,7,7,9,gene,K09H9.6,0,3147785,1.15233,2548,3150342,9,3147794,0,-9
I,-,3117627,0.0106383,4.74579e-27,94,93,1,0,6,gene,C45E1.4,0,3117626,0.367295,15342,3132969,1,3117627,0,-1
I,-,3096219,0.026455,0.0,189,184,5,4,4,gene,M01B12.5,1,3096207,1.24089,13445,3109664,12,3096219,0,-12
I,-,3084875,0.873457,0.0,324,41,283,185,1,gene,M01B12.4,2,3084838,1.36499,127,3085002,37,3084875,0,-37
I,-,3070151,0.0193798,0.0,516,506,10,9,6,gene,M01B12.3,0,3070141,1.07428,823,3070974,10,3070141,10,0
I,-,3070147,0.0,0.0625,4,4,0,0,1028,gene,M01B12.3,0,3070141,1.07428,827,3070974,6,3070141,6,0
I,-,3047842,0.0,0.000976562,10,10,0,0,0,gene,Y54E10BR.7,0,3047795,0.0609679,4207,3052049,47,3047795,47,0
I,-,3031093,0.939606,0.0,1573,95,1478,978,1,gene,Y54E10BR.5,2,3031093,4.90912,124,3031217,0,3031093,0,0
I,-,3013449,0.00581395,0.0,688,684,4,3,5,gene,Y54E10BL.6,1,3013446,0.662484,14854,3028303,3,3013449,0,-3
I,-,3002848,0.805584,0.0,2901,564,2337,1402,0,gene,Y54E10BL.5,2,3002838,8.86668,2563,3005411,10,3002850,-2,-12
I,-,2995915,0.389937,0.00133207,159,97,62,48,7,gene,Y71F9AR.3,0,2995914,0.294638,5417,3001332,1,2995914,1,0
I,-,2983077,0.915,0.0,400,34,366,267,0,gene,Y71F9AR.4,2,2983073,0.933179,132,2983209,4,2983073,4,0
I,-,2957911,0.0,1.79366e-43,142,142,0,0,0,gene,Y71F9AR.1,0,2957868,0.570051,23747,2981658,43,2957877,34,-9
I,-,2924714,0.036036,2.30688e-27,111,107,4,4,1,gene,Y71F9AL.18,0,2924695,0.560605,14762,2939476,19,2924716,-2,-21
I,-,2900861,0.00852878,0.0,469,465,4,4,2,gene,Y71F9AL.17,1,2900802,2.93667,6865,2907726,59,2900861,0,-59
I,-,2893719,0.14162,0.0,1617,1388,229,147,5,gene,Y71F9AL.16,2,2893714,1.75032,1608,2895327,5,2893719,0,-5
I,-,2883455,0.666667,0.375,3,1,2,2,2,gene,Y71F9AL.14,3,2883441,1.03738,60,2883515,14,2883441,14,0
I,-,2883441,0.987013,0.0,462,6,456,300,24,gene,Y71F9AL.14,3,2883441,1.03738,74,2883515,0,2883441,0,0
I,-,2876309,0.00652458,0.0,41382,41112,270,239,2,gene,Y71F9AL.13,1,2876303,83.8978,4561,2880870,6,2876309,0,-6
I,-,2875290,0.940828,0.0,338,20,318,229,2,gene,Y71F9AL.12,2,2875290,0.71059,103,2875393,0,2875290,0,0
I,-,2855733,0.00284293,0.0,1407,1403,4,4,29,gene,W10C8.5,0,2855671,1.47649,2792,2858525,62,2855733,0,-62
I,-,2855716,0.0,4.44089e-16,51,51,0,0,7985,gene,W10C8.5,0,2855671,1.47649,2809,2858525,45,2855716,0,-45
I,-,2830312,0.00206612,0.0,484,483,1,0,0,gene,W10C8.2,0,2830294,1.91334,21646,2851958,18,2830294,18,0
I,-,2822118,0.0,0.000244141,12,12,0,0,14,gene,W03D8.3,0,2822086,0.398495,123,2822241,32,2822086,32,0
I,-,2785854,0.0,0.5,1,1,0,0,0,gene,W03D8.9,1,2785797,0.9898,2915,2788769,57,2785854,0,-57
I,-,2778718,0.00286533,0.0,349,348,1,0,19,gene,Y71F9B.13,0,2778718,0.73987,2131,2780849,0,2778697,21,21
I,-,2777450,0.0,0.0078125,7,7,0,0,9,gene,Y71F9B.13,0,2777308,0.73987,3399,2780849,142,2777450,0,-142
I,-,2776098,0.0198676,1.97049e-40,151,148,3,1,0,gene,Y71F9B.10,0,2776083,0.954548,273,2776371,15,2776098,0,-15
I,-,2758205,0.00829876,0.0,241,239,2,1,1,gene,Y71F9B.7,2,2758205,0.785961,824,2759029,0,2758205,0,0
I,-,2742509,0.0,0.0,172,172,0,0,2,gene,Y71F9B.8,0,2742497,0.969233,13072,2755581,12,2742509,0,-12
I,-,2726590,0.0,0.015625,6,6,0,0,44,gene,Y71F9B.6,1,2726585,0.282384,8759,2735349,5,2726659,-69,-74
I,-,2721476,0.865306,0.0,735,99,636,455,8,gene,Y71F9B.16,2,2721470,1.02015,931,2722407,6,2721470,6,0
I,-,2682798,0.0,0.0,284,284,0,0,0,gene,F32B5.7,0,2682729,0.575966,3842,2686640,69,2682798,0,-69
I,-,2648058,0.0,0.0625,4,4,0,0,4,gene,F40E3.5,0,2648039,0.137156,24881,2672939,19,2648058,0,-19
I,-,2628256,0.0,1.90735e-06,19,19,0,0,118,gene,Y23H5A.7,0,2628113,1.758,11084,2639340,143,2628578,-322,-465
I,-,2595281,0.00502513,0.0,199,198,1,0,2,gene,K07A3.2,0,2595248,0.537699,27821,2623102,33,2595281,0,-33
I,-,2586534,0.0,0.25,2,2,0,0,1,gene,K07A3.1,0,2586434,5.26838,998,2587532,100,2586127,407,307
I,-,2586125,0.00441014,0.0,4535,4515,20,16,2,gene,K07A3.1,0,2586123,5.26838,1407,2587532,2,2586125,0,-2
I,-,2576021,0.00623053,0.0,321,319,2,2,1,gene,C55C2.5,0,2576007,0.377907,4888,2580909,14,2576021,0,-14
I,-,2485392,0.00371058,0.0,539,537,2,1,41,gene,Y74C10AR.3,1,2485383,0.43174,20882,2506274,9,2485383,9,0
I,-,2471936,0.923636,0.0,550,42,508,293,1,gene,Y74C10AL.2,2,2471928,1.7234,105,2472041,8,2471936,0,-8
I,-,2463462,0.0344828,5.40167e-08,29,28,1,1,0,gene,T16H5.1,0,2463407,0.0587333,5304,2468766,55,2463462,0,-55
I,-,2456464,0.0,0.0078125,7,7,0,0,4,gene,T16H5.1,0,2456445,0.0587333,12302,2468766,19,2456464,0,-19
I,-,2433614,0.00439078,0.0,911,907,4,3,8,gene,F23C8.9,0,2433610,0.61802,2862,2436476,4,2433614,0,-4
I,-,2425097,0.0,0.015625,6,6,0,0,8,gene,F23C8.7,0,2425074,0.0741383,4585,2429682,23,2425074,23,0
I,-,2421734,0.00264317,0.0,1135,1132,3,3,108,gene,F23C8.6,1,2421698,2.9796,633,2422367,36,2421743,-9,-45
I,-,2420366,0.179191,1.39163e-18,173,142,31,23,49,gene,F23C8.5,2,2420347,6.76217,200,2420566,19,2420354,12,-7
I,-,2420354,0.314204,0.0,7702,5282,2420,1732,374,gene,F23C8.5,2,2420347,6.76217,212,2420566,7,2420354,0,-7
I,-,2401493,0.0,0.0,175,175,0,0,0,gene,Y39G10AR.18,1,2401489,1.73692,16944,2418437,4,2401489,4,0
I,-,2401490,0.0,3.05176e-05,15,15,0,0,5,gene,Y39G10AR.18,1,2401489,1.73692,16947,2418437,1,2401489,1,0
I,-,2381854,0.747126,1.56095e-11,174,44,130,80,1,gene,Y39G10AR.17,2,2381852,0.167628,1101,2382955,2,2381852,2,0
I,-,2321818,0.00236742,0.0,2112,2107,5,5,12,gene,Y39G10AR.14,0,2321811,2.31482,210,2322028,7,2321818,0,-7
I,-,2306791,0.00721154,0.0,832,826,6,4,1,gene,Y39G10AR.13,1,2306787,1.63075,11501,2318292,4,2306791,0,-4
I,-,2304394,0.884125,0.0,863,100,763,625,1,gene,Y39G10AR.12,2,2304393,2.75478,112,2304506,1,2304394,0,-1
I,-,2304369,0.8,0.15625,5,1,4,4,2456,gene,Y39G10AR.12,2,2304362,2.75478,137,2304506,7,2304394,-25,-32
I,-,2304346,0.8,0.15625,5,1,4,3,556,gene,Y39G10AR.12,2,2304190,2.75478,160,2304506,156,2304394,-48,-204
I,-,2289754,0.834568,5.60519e-45,405,67,338,257,0,gene,Y39G10AL.3,0,2289748,0.964403,7529,2297283,6,2289754,0,-6
I,-,2272821,0.0,2.77556e-17,55,55,0,0,1,gene,F12B6.1,0,2272800,0.17529,8683,2281504,21,2272867,-46,-67
I,-,2118532,0.0,5.04871e-29,94,94,0,0,4,gene,Y37E3.16,0,2118520,0.330026,31294,2149826,12,2118532,0,-12
I,-,2093850,0.0116279,1.11152e-24,86,85,1,1,0,gene,Y37E3.13,0,2093838,0.203935,13557,2107407,12,2093824,26,14
I,-,2070609,0.00432387,0.0,80946,80596,350,315,9,gene,Y37E3.8,1,2070606,120.605,15028,2085637,3,2070609,0,-3
I,-,2070209,0.0,0.5,1,1,0,0,2,gene,Y37E3.8,1,2070203,120.605,15428,2085637,6,2070209,0,-6
I,-,2069589,0.979592,8.70415e-14,49,1,48,17,14,gene,Y37E3.7,2,2069515,107.555,88,2069677,74,2069589,0,-74
I,-,2069577,0.952089,0.0,71674,3434,68240,43737,90,gene,Y37E3.7,2,2069515,107.555,0,2069577,62,2069577,0,-62
I,-,2063982,0.0,2.77556e-17,55,55,0,0,152,gene,Y37E3.1,0,2063944,0.472926,5102,2069084,38,2064018,-36,-74
I,-,2063963,0.0,0.5,1,1,0,0,682,gene,Y37E3.1,0,2063944,0.472926,5121,2069084,19,2064018,-55,-74
I,-,2043807,0.175926,2.03269e-12,108,89,19,13,5,gene,Y20F4.4,0,2043782,0.527701,5335,2049142,25,2043813,-6,-31
I,-,2010497,0.00675676,4.14784e-43,148,147,1,1,14,gene,Y20F4.3,0,2010491,0.270658,23829,2034326,6,2010481,16,10
I,-,1958503,0.0,0.000976562,10,10,0,0,24,gene,Y51F10.10,0,1958455,0.685232,29646,1988149,48,1958513,-10,-58
I,-,1894909,0.0,0.00012207,13,13,0,0,0,gene,Y71G12A.4,0,1894879,0.116183,16769,1911678,30,1894864,45,15
I,-,1872307,0.00145349,0.0,1376,1374,2,0,1,gene,M01D7.2,0,1872280,1.69359,1619,1873926,27,1872307,0,-27
I,-,1832422,0.00499896,0.0,4801,4777,24,20,5,gene,C53H9.3,0,1832422,5.72219,19262,1851684,0,1832422,0,0
I,-,1798789,0.0,0.5,1,1,0,0,2,gene,Y71G12B.27,0,1798646,0.552264,10643,1809432,143,1798646,143,0
I,-,1775934,0.0010929,0.0,915,914,1,1,3,gene,Y71G12B.25,0,1775917,1.94399,3833,1779767,17,1775934,0,-17
I,-,1751056,0.0167598,0.0,179,176,3,3,1,gene,Y71G12B.24,0,1751056,0.698577,20310,1771366,0,1751056,0,0
I,-,1676435,0.0,5.96046e-08,24,24,0,0,1,gene,Y71G12B.35,1,1676431,None,9677,1686112,4,1676431,4,0
I,-,1672741,0.989583,1.21169e-27,96,1,95,51,0,gene,Y71G12B.23,2,1672717,0.219491,115,1672856,24,1672719,22,-2
I,-,1651883,0.0,0.125,3,3,0,0,0,gene,Y71G12B.20,0,1651784,1.24695,3734,1655617,99,1651381,502,403
I,-,1651616,0.0,0.5,1,1,0,0,1,gene,Y71G12B.20,0,1651514,1.24695,4001,1655617,102,1651381,235,133
I,-,1626630,0.0,0.000976562,10,10,0,0,0,gene,Y73E7A.7,0,1626613,0.485799,17961,1644591,17,1626606,24,7
I,-,1610042,0.00257732,0.0,388,387,1,1,0,gene,Y73E7A.6,0,1610037,1.10114,11110,1621152,5,1610037,5,0
I,-,1596205,0.00134409,0.0,744,743,1,1,0,gene,Y73E7A.4,0,1596176,0.502024,4418,1600623,29,1596176,29,0
I,-,1514412,0.00546448,0.0,183,182,1,1,1,gene,Y92H12A.5,0,1514410,0.558645,80242,1594654,2,1514410,2,0
I,-,1443943,0.00665557,0.0,1202,1194,8,6,1,gene,F37F2.2,0,1443943,2.25184,7178,1451121,0,1443943,0,0
I,-,1434226,1.0,0.5,1,0,1,1,1,gene,Y92H12BR.4,0,1434167,0.0427006,8225,1442451,59,1433852,374,315
I,-,1433718,0.0,1.90735e-06,19,19,0,0,7,gene,Y92H12BR.4,0,1433696,0.0427006,8733,1442451,22,1433852,-134,-156
I,-,1415808,0.00555899,0.0,1619,1610,9,9,12,gene,Y92H12BR.2,0,1415794,1.52919,15816,1431624,14,1415809,-1,-15
I,-,1392785,0.0,0.0,278,278,0,0,2,gene,Y92H12BM.1,1,1392770,0.18609,21131,1413916,15,1392760,25,10
I,-,1385088,0.903226,2.09315e-06,31,3,28,18,0,gene,Y92H12BL.4,2,1385058,0.30285,4153,1389241,30,1385058,30,0
I,-,1385070,0.926471,0.0,340,25,315,230,71,gene,Y92H12BL.4,2,1385058,0.30285,4171,1389241,12,1385058,12,0
I,-,1344693,0.199223,0.0,1029,824,205,137,3,gene,K12C11.1,0,1344693,1.50005,32087,1376780,0,1344693,0,0
I,-,1268156,0.0,0.0,191,191,0,0,0,gene,Y48G8AR.1,0,1268155,0.677014,72496,1340652,1,1268156,0,-1
I,-,1226813,0.0,0.0,3991,3991,0,0,2,gene,Y48G8AL.13,0,1226799,3.25493,32613,1259426,14,1226813,0,-14
I,-,1156022,0.00403877,0.0,1238,1233,5,5,2,gene,Y48G8AL.14,1,1156022,1.98276,6857,1162879,0,1156022,0,0
I,-,1154388,0.79661,1.942e-06,59,12,47,34,0,gene,Y48G8AL.10,2,1154385,0.331046,792,1155180,3,1154388,0,-3
I,-,1141033,0.0,0.5,1,1,0,0,1,gene,Y48G8AL.9,0,1141023,0.43753,1054,1142087,10,1141023,10,0
I,-,1095798,0.0,2.71051e-20,65,65,0,0,0,gene,R06A10.4,0,1095795,0.486636,40579,1136377,3,1095798,0,-3
I,-,1066979,0.0,0.25,2,2,0,0,0,gene,Y34D9A.10,0,1066871,1.55983,11445,1078424,108,1066901,78,-30
I,-,1066901,0.00567108,0.0,529,526,3,1,2,gene,Y34D9A.10,0,1066871,1.55983,11523,1078424,30,1066901,0,-30
I,-,1033438,0.00251889,0.0,397,396,1,1,3,gene,Y34D9A.4,0,1033437,1.03823,17488,1050926,1,1033438,0,-1
I,-,1029912,0.0132275,0.0,378,373,5,4,0,gene,Y34D9A.1,0,1029910,0.938177,722,1030634,2,1029912,0,-2
I,-,957350,0.0,0.125,3,3,0,0,53,gene,Y34D9B.1,0,957321,0.638404,6352,963702,29,957321,29,0
I,-,926924,0.0,0.25,2,2,0,0,2,gene,Y95B8A.12,0,926879,0.195133,21645,948569,45,926879,45,0
I,-,926916,0.0,1.77636e-15,49,49,0,0,3,gene,Y95B8A.12,0,926879,0.195133,21653,948569,37,926879,37,0
I,-,919149,0.0,0.000976562,10,10,0,0,0,gene,Y95B8A.12,0,919139,0.195133,29420,948569,10,919139,10,0
I,-,846765,0.0,0.0,159,159,0,0,0,gene,ZC123.4,0,846747,0.444646,26001,872766,18,846765,0,-18
I,-,762224,0.0,0.5,1,1,0,0,0,gene,T06A4.2,0,762201,0.267117,79482,841706,23,761844,380,357
I,-,745359,0.0,0.125,3,3,0,0,17,gene,Y18H1A.13,0,745311,0.109799,2851,748210,48,745456,-97,-145
I,-,743526,0.0,0.0625,4,4,0,0,0,gene,Y18H1A.13,0,743511,0.109799,4684,748210,15,743517,9,-6
I,-,715877,0.0,0.0,404,404,0,0,2,gene,Y18H1A.3,1,715853,0.855089,2019,717896,24,715853,24,0
I,-,698325,0.738676,8.55704e-17,287,75,212,133,0,gene,Y18H1A.2,2,698325,0.604874,1953,700278,0,698330,-5,-5
I,-,694881,1.0,0.0625,4,0,4,0,9,gene,Y18H1A.4,3,694808,0.846048,104,694985,73,694951,-70,-143
I,-,694665,0.857143,0.0546875,7,1,6,4,10,gene,Y18H1A.4,3,694633,0.846048,320,694985,32,694653,12,-20
I,-,694653,0.949686,0.0,318,16,302,187,12,gene,Y18H1A.4,3,694633,0.846048,332,694985,20,694653,0,-20
I,-,636353,0.0025974,0.0,1155,1152,3,2,0,gene,Y65B4A.6,1,636337,2.65189,9275,645628,16,636353,0,-16
I,-,629938,1.0,0.5,1,0,1,0,25,gene,F56A6.4,2,629697,0.422666,912,630850,241,629447,491,250
I,-,629447,0.630522,9.79784e-06,249,92,157,127,2,gene,F56A6.4,2,629447,0.422666,1403,630850,0,629447,0,0
I,-,607604,0.0245902,5.55285e-32,122,119,3,3,0,gene,F56A6.2,0,607590,0.165852,7047,614651,14,607574,30,16
I,-,566589,0.0,0.03125,5,5,0,0,0,gene,Y65B4BR.9,0,566394,0.0348803,5588,572177,195,566394,195,0
I,-,516459,0.00440529,0.0,227,226,1,1,2,gene,Y65B4BL.5,0,516397,3.61392,3651,520110,62,516459,0,-62
I,-,510938,0.0,0.5,1,1,0,0,2,gene,Y65B4BL.7,0,510887,0.890703,60,510998,51,510840,98,47
I,-,506222,0.00746269,6.15298e-39,134,133,1,1,33,gene,Y65B4BL.4,1,506215,0.499961,2733,508955,7,506253,-31,-38
I,-,502045,0.817204,1.74166e-10,93,17,76,61,0,gene,Y65B4BL.3,2,502033,0.244249,848,502893,12,502046,-1,-13
I,-,467138,0.0,1.16415e-10,33,33,0,0,0,gene,W04C9.5,0,467134,0.0434482,14687,481825,4,467134,4,0
I,-,418669,0.0,9.31323e-10,30,30,0,0,0,gene,Y50C1A.2,0,418663,0.0447952,43991,462660,6,418663,6,0
I,-,394416,0.0,5.60519e-45,147,147,0,0,4,gene,R119.5,0,394414,0.321184,18438,412854,2,394414,2,0
I,-,381905,0.00386225,0.0,3107,3095,12,9,1,gene,R119.4,1,381904,13.0751,6604,388509,1,381905,0,-1
I,-,379076,0.977416,0.0,1107,25,1082,786,1,gene,R119.3,2,379072,1.05646,39,379115,4,379076,0,-4
I,-,363910,0.0,1.35525e-20,66,66,0,0,0,gene,R119.1,0,363904,0.0652469,4358,368268,6,363904,6,0
I,-,347022,0.0,0.125,3,3,0,0,66,gene,Y48G1A.6,0,346913,0.241073,10152,357174,109,347144,-122,-231
I,-,323353,0.0153846,0.0,715,704,11,9,8,gene,Y48G1A.5,0,323353,1.73737,3580,326933,0,323353,0,0
I,-,315566,0.0,0.0625,4,4,0,0,4,gene,C53D5.6,0,315471,5.22552,1397,316963,95,314990,576,481
I,-,314990,0.0104131,0.0,2881,2851,30,23,3,gene,C53D5.6,0,314979,5.22552,1973,316963,11,314990,0,-11
I,-,311131,0.0,0.015625,6,6,0,0,263,gene,C53D5.5,0,310820,0.374571,50,311181,311,310803,328,17
I,-,310836,0.0,0.125,3,3,0,0,150,gene,C53D5.5,0,310820,0.374571,145,310981,16,310803,33,17
I,-,310803,0.0,0.015625,6,6,0,0,81,gene,C53D5.5,0,310788,0.374571,178,310981,15,310803,0,-15
I,-,289042,0.0,0.00390625,8,8,0,0,18,gene,C53D5.4,0,289036,0.365586,16767,305809,6,289122,-80,-86
I,-,259157,0.0,0.0,298,298,0,0,0,gene,Y48G1BR.1,0,259155,0.637023,26934,286091,2,259157,0,-2
I,-,217551,0.0,1.26218e-29,96,96,0,0,7,gene,Y48G1BL.4,0,217465,0.222526,2182,219733,86,217431,120,34
I,-,182772,0.018018,2.35156e-30,111,109,2,2,0,gene,F56C11.3,0,182771,0.621419,29133,211905,1,182771,1,0
I,-,166819,0.0111111,7.27014e-26,90,89,1,0,3,gene,F56C11.2,0,166816,0.66312,15260,182079,3,166819,0,-3
I,-,154848,0.0,1.0842e-19,63,63,0,0,0,gene,F56C11.1,0,154819,0.261003,5321,160169,29,154819,29,0
I,-,110057,0.00180029,0.0,8332,8317,15,11,88,gene,F53G12.1,1,110044,14.3822,749,110806,13,110057,0,-13
I,-,108165,0.0600255,0.0,783,736,47,42,1,gene,Y48G1C.8,2,108161,1.02556,509,108674,4,108161,4,0
I,-,95365,0.0,0.000244141,12,12,0,0,0,gene,Y48G1C.13,0,95312,None,1110,96475,53,95312,53,0
I,-,86293,0.0,0.0,159,159,0,0,1,gene,Y48G1C.6,0,86284,0.211829,8522,94815,9,86284,9,0
I,-,32542,0.0047619,0.0,210,209,1,1,1,gene,Y74C9A.5,0,32482,0.659673,22760,55302,60,32482,60,0
I,-,26781,0.0027894,0.0,717,715,2,2,1,gene,Y74C9A.4,0,26778,0.668089,810,27591,3,26778,3,0
I,-,10230,0.00462963,0.0,432,430,2,2,0,gene,Y74C9A.3,0,10148,0.747957,7257,17487,82,10230,0,-82
II,-,15185278,0.0125392,0.0,319,315,4,3,0,gene,Y1H11.2,0,15185272,0.210901,59160,15244438,6,15185280,-2,-8
II,-,15178481,0.0,1.90735e-06,19,19,0,0,1,gene,Y53F4B.37,0,15178480,0.00371642,1383,15179864,1,15178480,1,0
II,-,15174852,0.0,0.03125,5,5,0,0,2,gene,Y53F4B.35,0,15174842,0.0420139,2413,15177265,10,15174842,10,0
II,-,15171805,0.00117647,0.0,850,849,1,0,3,gene,Y53F4B.33,0,15171805,0.364628,2351,15174156,0,15171805,0,0
II,-,15169753,0.030303,2.90702e-17,66,64,2,1,1,gene,Y53F4B.32,0,15169744,0.0548915,1309,15171062,9,15169744,9,0
II,-,15167301,0.00314465,0.0,636,634,2,2,4,gene,Y53F4B.31,0,15167287,0.733088,1144,15168445,14,15167301,0,-14
II,-,15165609,0.0,5.73972e-42,137,137,0,0,108,gene,Y53F4B.30,1,15165564,2.29824,479,15166088,45,15165621,-12,-57
II,-,15164448,0.787081,7.01071e-34,418,89,329,210,77,gene,Y53F4B.29,2,15164438,1.30675,337,15164785,10,15164448,0,-10
II,-,15118853,0.0,0.0625,4,4,0,0,0,gene,Y53F4B.38,0,15118821,None,7614,15126467,32,15118846,7,-25
II,-,15071566,0.00381679,0.0,262,261,1,0,0,gene,Y53F4B.18,0,15071561,0.665447,10378,15081944,5,15071561,5,0
II,-,15010311,0.00203252,0.0,492,491,1,1,1,gene,Y53F4B.9,0,15010306,0.56398,2987,15013298,5,15010311,0,-5
II,-,15003432,0.0,0.00390625,8,8,0,0,1,gene,Y53F4B.10,0,15003405,0.00508253,1331,15004763,27,15003405,27,0
II,-,14983921,0.0,0.000488281,11,11,0,0,0,gene,Y53F4B.5,0,14983904,0.00984795,17871,15001792,17,14983904,17,0
II,-,14969249,0.0137615,0.0,218,215,3,2,1,gene,Y53F4B.3,0,14969240,0.862147,11574,14980823,9,14969249,0,-9
II,-,14964003,0.00166113,0.0,602,601,1,0,1,gene,Y53F4B.2,0,14963996,0.396093,4524,14968527,7,14963996,7,0
II,-,14958088,0.0,0.125,3,3,0,0,18,gene,Y53F4B.1,0,14958084,0.0615774,1319,14959407,4,14958084,4,0
II,-,14910300,0.0,1.32349e-23,76,76,0,0,0,gene,R03C1.1,0,14910296,0.433536,43814,14954114,4,14910296,4,0
II,-,14818436,0.00257732,0.0,388,387,1,1,0,gene,W01D2.2,0,14818418,0.449203,1667,14820103,18,14818436,0,-18
II,-,14818408,0.0,0.25,2,2,0,0,241,gene,W01D2.2,0,14818161,0.449203,1695,14820103,247,14818436,-28,-275
II,-,14753770,0.0015163,0.0,1319,1317,2,2,71,gene,Y54E2A.3,1,14753770,1.90507,2089,14755859,0,14753789,-19,-19
II,-,14752470,0.875,0.03125,8,1,7,5,4,gene,Y54E2A.2,2,14752462,0.278447,270,14752740,8,14752384,86,78
II,-,14752384,0.802632,8.76911e-15,152,30,122,99,0,gene,Y54E2A.2,2,14752384,0.278447,356,14752740,0,14752384,0,0
II,-,14739138,0.0,5.82077e-11,34,34,0,0,0,gene,Y54E2A.1,0,14739132,0.0683538,7647,14746785,6,14739138,0,-6
II,-,14727945,0.00568182,0.0,176,175,1,0,3,gene,C09F9.3,0,14727912,0.278501,6359,14734304,33,14727945,0,-33
II,-,14695193,0.00241935,0.0,1240,1237,3,2,5,gene,K02B7.3,0,14695181,1.61922,18371,14713564,12,14695195,-2,-14
II,-,14666839,0.0,0.0,554,554,0,0,0,gene,ZC101.2,0,14666748,2.77962,8318,14675157,91,14666839,0,-91
II,-,14643979,0.00719424,0.0,278,276,2,1,0,gene,C38C6.2,0,14643970,0.817173,3242,14647221,9,14643981,-2,-11
II,-,14605569,0.0,7.62939e-06,17,17,0,0,10,gene,F19H8.2,0,14605514,0.417983,24827,14630396,55,14605535,34,-21
II,-,14591838,0.0,0.03125,5,5,0,0,1,gene,C01G12.7,0,14591783,0.112118,12207,14604045,55,14591789,49,-6
II,-,14582206,0.0,4.23516e-22,71,71,0,0,5,gene,C01G12.3,0,14582178,0.4246,4215,14586421,28,14582256,-50,-78
II,-,14563730,0.0,0.25,2,2,0,0,0,gene,C01G12.12,0,14563701,None,16420,14580150,29,14564027,-297,-326
II,-,14561495,0.00811359,0.0,493,489,4,3,0,gene,C04H5.6,0,14561492,0.55923,690,14562185,3,14561492,3,0
II,-,14540421,0.0,0.0625,4,4,0,0,0,gene,C04H5.9,0,14540378,None,304,14540725,43,14540378,43,0
II,-,14537473,0.0,1.77636e-15,49,49,0,0,0,gene,C04H5.2,0,14537455,0.2714,2554,14540027,18,14537458,15,-3
II,-,14528135,0.0243056,0.0,288,281,7,5,19,gene,F57C2.5,0,14528116,1.54892,7687,14535822,19,14528192,-57,-76
II,-,14523418,0.0153846,1.76183e-18,65,64,1,1,3,gene,F57C2.1,1,14523402,0.178566,2691,14526109,16,14523402,16,0
II,-,14522033,0.88,3.32449e-12,75,9,66,60,0,gene,F57C2.2,2,14522025,0.30109,248,14522281,8,14522017,16,8
II,-,14494347,0.00510856,0.0,783,779,4,2,0,gene,K10H10.2,0,14494315,2.8989,6004,14500351,32,14494347,0,-32
II,-,14488584,0.0136157,0.0,1322,1304,18,16,3,gene,C13B4.2,0,14488578,2.26816,4189,14492773,6,14488584,0,-6
II,-,14479523,0.00819672,2.29456e-35,122,121,1,0,1,gene,C13B4.1,0,14479522,0.46416,5627,14485150,1,14479522,1,0
II,-,14437867,0.00356506,0.0,561,559,2,1,1,gene,K04B12.2,0,14437859,0.82375,32427,14470294,8,14437867,0,-8
II,-,14424786,0.025641,7.09406e-11,39,38,1,0,0,gene,K04B12.1,0,14424784,0.373917,9560,14434346,2,14424786,0,-2
II,-,14413370,0.00105152,0.0,951,950,1,1,310,gene,F26H11.5,0,14413360,1.07921,4410,14417780,10,14413360,10,0
II,-,14389973,0.00366838,0.0,1363,1358,5,5,11,gene,F26H11.1,0,14389960,2.21238,12301,14402274,13,14389973,0,-13
II,-,14377785,0.0,0.03125,5,5,0,0,1,gene,R06A4.10,0,14377772,0.0519396,11344,14389129,13,14377785,0,-13
II,-,14357463,0.0181818,4.61838e-30,110,108,2,2,1,gene,R06A4.8,1,14357425,0.53914,16262,14373725,38,14357425,38,0
II,-,14349301,0.0179372,0.0,446,438,8,5,1,gene,Y54G11A.17,2,14349301,None,1319,14350620,0,14349301,0,0
II,-,14348687,0.960396,0.0,202,8,194,123,4,gene,Y54G11A.10,3,14348687,0.990973,94,14348781,0,14348689,-2,-2
II,-,14345645,0.777778,0.0703125,9,2,7,5,13,gene,Y54G11A.9,4,14345620,0.767913,1368,14347013,25,14346052,-407,-432
II,-,14345632,0.811456,4.54696e-40,419,79,340,243,30,gene,Y54G11A.9,4,14345620,0.767913,1381,14347013,12,14346052,-420,-432
II,-,14344339,0.8125,0.00854492,16,3,13,7,0,gene,Y54G11A.8,5,14344339,0.503136,101,14344440,0,14344339,0,0
II,-,14310674,0.0,0.0,756,756,0,0,2,gene,Y54G11A.13,0,14310638,1.11936,29224,14339898,36,14310674,0,-36
II,-,14306155,0.0,0.00012207,13,13,0,0,1,gene,Y54G11A.6,0,14306148,0,1475,14307630,7,14306188,-33,-40
II,-,14301922,0.00649702,0.0,1847,1835,12,7,0,gene,Y54G11A.5,0,14301915,3.69854,1533,14303455,7,14301922,0,-7
II,-,14269085,0.0,0.0,422,422,0,0,6,gene,Y54G11A.1,0,14269048,0.288648,16722,14285807,37,14269048,37,0
II,-,14243499,0.0,0.0,804,804,0,0,25,gene,Y48B6A.11,0,14243486,0.679282,14209,14257708,13,14243486,13,0
II,-,14234068,0.0,0.0625,4,4,0,0,1,gene,Y48B6A.12,1,14233850,2.17929,804,14234872,218,14234016,52,-166
II,-,14233751,0.00960384,0.0,833,825,8,4,53,gene,Y48B6A.12,1,14233699,2.17929,1121,14234872,52,14233751,0,-52
II,-,14226182,0.0,0.5,1,1,0,0,4,gene,Y48B6A.13,2,14226155,0.294892,88,14226270,27,14226155,27,0
II,-,14226171,0.89404,5.36899e-25,151,16,135,98,8,gene,Y48B6A.13,2,14226155,0.294892,99,14226270,16,14226155,16,0
II,-,14218013,0.0,3.8147e-06,18,18,0,0,0,gene,Y48B6A.16,0,14217960,None,2837,14220850,53,14217960,53,0
II,-,14217972,0.0,0.0625,4,4,0,0,10,gene,Y48B6A.16,0,14217960,None,2878,14220850,12,14217960,12,0
II,-,14217889,0.0,0.5,1,1,0,0,0,gene,Y48B6A.16,0,14217848,None,2961,14220850,41,14217960,-71,-112
II,-,14154269,0.0136986,0.0,511,504,7,7,1,gene,Y48B6A.1,0,14154269,1.56543,12507,14166776,0,14154269,0,0
II,-,14142164,1.0,0.5,1,0,1,1,5,gene,W03H9.4,3,14142022,0.813328,382,14142546,142,14142093,71,-71
II,-,14142114,0.5625,0.174561,16,7,9,8,5,gene,W03H9.4,3,14142022,0.813328,432,14142546,92,14142093,21,-71
II,-,14142093,0.5,0.375,4,2,2,0,53,gene,W03H9.4,3,14142022,0.813328,453,14142546,71,14142093,0,-71
II,-,14132729,0.95941,0.0,271,11,260,173,0,gene,K09E4.2,4,14132719,0.636806,564,14133293,10,14132729,0,-10
II,-,14126837,0.764706,3.41217e-17,238,56,182,137,1,gene,K09E4.3,5,14126836,0.582562,743,14127580,1,14126837,0,-1
II,-,14118006,0.0,6.93889e-18,57,57,0,0,0,gene,K09E4.4,0,14118001,0.181222,5833,14123839,5,14118006,0,-5
II,-,14109124,0.0,0.0,3142,3142,0,0,26,gene,K09E4.6,0,14109113,5.50652,5000,14114124,11,14109113,11,0
II,-,14037618,0.0,0.0,592,592,0,0,1,gene,W01G7.1,0,14037611,1.26805,52238,14089856,7,14037618,0,-7
II,-,14020855,0.0,0.0,164,164,0,0,0,gene,F01D5.10,0,14020842,0.183785,12258,14033113,13,14020842,13,0
II,-,14016861,0.0,0.125,3,3,0,0,0,gene,F01D5.9,0,14016856,0.381192,875,14017736,5,14016861,0,-5
II,-,14000938,0.0,0.5,1,1,0,0,0,gene,F01D5.4,0,14000932,None,644,14001582,6,14000932,6,0
II,-,13999828,0.0,0.00390625,8,8,0,0,29,gene,F01D5.3,0,13999800,0.736203,725,14000553,28,13999962,-134,-162
II,-,13998698,0.0,0.0625,4,4,0,0,19,gene,F01D5.2,0,13998611,0.263372,261,13998959,87,13998851,-153,-240
II,-,13997475,0.0,0.000976562,10,10,0,0,249,gene,F01D5.1,0,13997468,2.96821,893,13998368,7,13997493,-18,-25
II,-,13994666,0.0,0.015625,6,6,0,0,12,gene,Y39G8B.7,0,13994655,0.273402,2186,13996852,11,13994942,-276,-287
II,-,13991736,0.0,0.000488281,11,11,0,0,1,gene,Y39G8B.5,0,13991735,0.0107074,2571,13994307,1,13991735,1,0
II,-,13976118,0.0138889,1.52466e-20,72,71,1,1,0,gene,Y39G8B.2,1,13976105,0.320381,941,13977059,13,13976118,0,-13
II,-,13976113,0.0,3.72529e-09,28,28,0,0,19,gene,Y39G8B.2,1,13976105,0.320381,946,13977059,8,13976118,-5,-13
II,-,13972841,0.0674098,0.0,1884,1757,127,86,1,gene,Y39G8B.1,2,13972840,2.24638,728,13973569,1,13972840,1,0
II,-,13962314,0.0,7.62939e-06,17,17,0,0,1,gene,W07G1.5,0,13962277,0.0776595,2441,13964755,37,13962314,0,-37
II,-,13957352,0.0,5.82077e-11,34,34,0,0,11,gene,W07G1.3,0,13957317,1.10033,1674,13959026,35,13957420,-68,-103
II,-,13955887,0.0,2.29589e-41,135,135,0,0,0,gene,W07G1.3,0,13955861,1.10033,3139,13959026,26,13955887,0,-26
II,-,13931935,0.0,7.70372e-34,110,110,0,0,1,gene,W02B8.5,0,13931915,0.27807,5955,13937890,20,13931894,41,21
II,-,13902012,0.00735294,1.5612e-39,136,135,1,0,0,gene,W02B8.1,0,13901949,0.420694,28410,13930422,63,13901999,13,-50
II,-,13872212,0.00197628,0.0,506,505,1,1,5,gene,Y51H1A.2,0,13872174,0.661708,26052,13898264,38,13872193,19,-19
II,-,13860861,0.0,0.25,2,2,0,0,79,gene,Y51H1A.1,0,13860827,0.744964,37403,13898264,34,13860875,-14,-48
II,-,13858697,0.0,0.25,2,2,0,0,1,gene,Y51H1A.1,0,13858666,0.744964,39567,13898264,31,13858697,0,-31
II,-,13840981,0.0,0.0,248,248,0,0,7,gene,F08G2.7,0,13840968,0.329279,14706,13855687,13,13841038,-57,-70
II,-,13833168,0.0,0.000244141,12,12,0,0,58,gene,F08G2.5,0,13833156,0.374108,1837,13835005,12,13833533,-365,-377
II,-,13725706,0.00728332,0.0,1373,1363,10,10,1,gene,Y54G9A.7,0,13725700,0.920425,45183,13770889,6,13725785,-79,-85
II,-,13715756,0.0,0.0,218,218,0,0,28,gene,Y54G9A.4,0,13715744,0.400812,2328,13718084,12,13715773,-17,-29
II,-,13694688,0.0,1.05879e-22,73,73,0,0,1,gene,Y48E1A.1,0,13694682,0.59739,18117,13712805,6,13694682,6,0
II,-,13661989,0.0,0.03125,5,5,0,0,0,gene,C31C9.6,0,13661982,0.0480919,8545,13670534,7,13661982,7,0
II,-,13638381,0.00171768,0.0,6404,6393,11,9,18,gene,C31C9.2,0,13638380,4.94016,17402,13655783,1,13638381,0,-1
II,-,13617811,0.0,0.25,2,2,0,0,252,gene,F37B1.2,0,13617811,0.0850727,5058,13622869,0,13617838,-27,-27
II,-,13613051,0.0,0.0,279,279,0,0,12,gene,F37B1.4,0,13613044,0.223741,1699,13614750,7,13613044,7,0
II,-,13596450,0.0,0.00390625,8,8,0,0,1,gene,Y48E1B.11,0,13596444,0.0422197,11635,13608085,6,13596444,6,0
II,-,13593310,0.0,0.125,3,3,0,0,1,gene,Y48E1B.9,0,13593037,1.00804,1596,13594906,273,13592758,552,279
II,-,13592758,0.0,0.25,2,2,0,0,3,gene,Y48E1B.9,0,13592746,1.00804,506,13593264,12,13592758,0,-12
II,-,13574962,0.00431034,0.0,464,462,2,2,2,gene,Y48E1B.5,1,13574962,0.712194,13975,13588937,0,13574962,0,0
II,-,13567872,0.932353,0.0,340,23,317,198,6,gene,Y48E1B.3,2,13567867,0.838857,111,13567983,5,13567867,5,0
II,-,13553300,0.935484,2.16532e-07,31,2,29,13,6,gene,Y48E1B.3,2,13553293,0.838857,1836,13555136,7,13553300,0,-7
II,-,13550476,0.0,0.5,1,1,0,0,3,gene,Y48E1B.3,2,13550442,0.838857,4660,13555136,34,13550476,0,-34
II,-,13547546,0.926471,3.53183e-14,68,5,63,42,13,gene,Y48E1B.1,3,13547530,0.302303,99,13547645,16,13547530,16,0
II,-,13540985,0.861789,2.80153e-17,123,17,106,71,6,gene,Y48E1B.2,4,13540972,0.46004,1673,13542658,13,13540972,13,0
II,-,13537012,0.571429,0.273438,7,3,4,2,6,gene,Y48E1B.2,4,13536923,0.46004,5646,13542658,89,13537012,0,-89
II,-,13531119,0.79321,8.33009e-28,324,67,257,159,2,gene,Y48E1B.14,5,13531119,0.679784,2327,13533446,0,13531119,0,0
II,-,13494501,0.00200702,0.0,9965,9945,20,17,7,gene,F45H10.3,1,13494494,4.75372,454,13494955,7,13494501,0,-7
II,-,13492949,0.774742,0.0,6113,1377,4736,2996,1,gene,F45H10.2,2,13492943,10.3161,132,13493081,6,13492949,0,-6
II,-,13491687,0.869955,0.0,446,58,388,218,4,gene,F45H10.1,3,13491675,0.789725,14,13491701,12,13491687,0,-12
II,-,13461980,0.0,0.125,3,3,0,0,45,gene,E01G4.3,1,13461913,7.60177,25171,13487151,67,13461912,68,1
II,-,13461943,0.0,0.125,3,3,0,0,4830,gene,E01G4.3,1,13461913,7.60177,25208,13487151,30,13461912,31,1
II,-,13461604,0.00647249,0.0,309,307,2,2,80,gene,E01G4.3,1,13461604,7.60177,132,13461736,0,13461604,0,0
II,-,13460543,0.0013369,0.0,748,747,1,0,1,gene,E01G4.4,2,13460543,1.41592,425,13460968,0,13460543,0,0
II,-,13447494,0.158924,0.0,409,344,65,51,3,gene,E01G4.1,3,13447465,1.31058,1239,13448733,29,13447496,-2,-31
II,-,13436726,0.959381,0.0,517,21,496,328,6,gene,Y48E1C.4,2,13436720,0.819275,107,13436833,6,13436726,0,-6
II,-,13347786,0.0,9.53674e-07,20,20,0,0,0,gene,Y48C3A.11,0,13347785,0.0765016,72421,13420207,1,13347785,1,0
II,-,13330724,0.004914,0.0,407,405,2,2,1,gene,Y48C3A.8,1,13330708,1.31867,9833,13340557,16,13330683,41,25
II,-,13320812,0.953846,4.38122e-30,130,6,124,81,0,gene,Y48C3A.7,2,13320810,0.712601,4045,13324857,2,13320812,0,-2
II,-,13285728,0.0,0.0,254,254,0,0,7,gene,Y48C3A.4,0,13285701,0.651011,25602,13311330,27,13285718,10,-17
II,-,13237808,0.00219619,0.0,4098,4089,9,6,4,gene,F15D4.3,0,13237807,4.91775,1344,13239152,1,13237808,0,-1
II,-,13181460,0.0,5.96046e-08,24,24,0,0,1,gene,W09H1.1,0,13181431,0.056491,4426,13185886,29,13181431,29,0
II,-,13165634,0.0,5.60519e-45,147,147,0,0,7,gene,F32A11.6,0,13165556,1.12011,10124,13175758,78,13165556,78,0
II,-,13165594,0.0,0.03125,5,5,0,0,38,gene,F32A11.6,0,13165556,1.12011,10164,13175758,38,13165556,38,0
II,-,13156948,0.00808625,0.0,371,368,3,3,7,gene,F32A11.2,0,13156935,0.308845,3366,13160314,13,13156948,0,-13
II,-,13116705,0.00295858,0.0,338,337,1,1,1,gene,F29C12.3,0,13116702,0.50212,19647,13136352,3,13116702,3,0
II,-,13043346,0.0,0.5,1,1,0,0,14,gene,F18A11.1,0,13043311,0.47106,2674,13046020,35,13043346,0,-35
II,-,13037007,0.0,0.5,1,1,0,0,52,gene,F18A11.3,0,13036739,2.50972,2684,13039691,268,13036784,223,-45
II,-,13036998,0.5,0.273438,8,4,4,4,19,gene,F18A11.3,0,13036739,2.50972,2693,13039691,259,13036784,214,-45
II,-,13025739,0.00472813,0.0,423,421,2,2,2,gene,Y38F1A.10,0,13025679,1.80727,10507,13036246,60,13025739,0,-60
II,-,13020527,0.0,1.14794e-41,136,136,0,0,1,gene,Y38F1A.10,0,13020433,1.80727,15719,13036246,94,13020433,94,0
II,-,13012427,0.0217391,1.22984e-36,138,135,3,2,17,gene,F18A11.5,1,13012382,0.277793,1805,13014232,45,13012833,-406,-451
II,-,13008066,0.0112613,0.0,444,439,5,3,58,gene,Y38F1A.9,2,13008065,2.72773,674,13008740,1,13008065,1,0
II,-,13000755,0.00555556,0.0,180,179,1,0,0,gene,Y38F1A.8,0,13000705,0.622375,5756,13006511,50,13000755,0,-50
II,-,12996098,0.0,4.44089e-16,51,51,0,0,2,gene,Y38F1A.6,0,12996094,4.28016,749,12996847,4,12996098,0,-4
II,-,12969121,0.0,0.25,2,2,0,0,2,gene,Y38F1A.4,0,12969117,0.0226563,4566,12973687,4,12969117,4,0
II,-,12948100,0.0,9.31323e-10,30,30,0,0,3,gene,F58G1.7,0,12948045,0.159414,4287,12952387,55,12948045,55,0
II,-,12935262,0.0,0.0,198,198,0,0,1,gene,F58G1.5,0,12935259,0.442234,8486,12943748,3,12935259,3,0
II,-,12918910,0.00384862,0.0,1559,1553,6,5,3,gene,F58G1.2,0,12918882,0.505043,6973,12925883,28,12918882,28,0
II,-,12918685,0.97561,1.86446e-11,41,1,40,24,1,gene,F58G1.2,0,12918685,0.505043,7198,12925883,0,12918685,0,0
II,-,12918679,0.8,0.15625,5,1,4,1,28,gene,F58G1.2,0,12918670,0.505043,7204,12925883,9,12918679,0,-9
II,-,12895000,0.00863931,0.0,463,459,4,4,20,gene,F35C5.5,0,12895000,1.08511,15131,12910131,0,12895000,0,0
II,-,12878016,0.00433526,0.0,692,689,3,3,7,gene,Y46G5A.31,0,12877993,1.58194,14950,12892966,23,12878006,10,-13
II,-,12847738,0.0,0.0,223,223,0,0,3,gene,Y46G5A.27,0,12847716,0.171244,14127,12861865,22,12847738,0,-22
II,-,12840059,0.0,1.45519e-11,36,36,0,0,0,gene,Y46G5A.26,0,12840043,0.0576224,6046,12846105,16,12840059,0,-16
II,-,12816365,0.0046729,0.0,214,213,1,1,1,gene,Y46G5A.21,0,12816360,0.402418,376,12816741,5,12816365,0,-5
II,-,12805195,0.0,2.32831e-10,32,32,0,0,21,gene,Y46G5A.18,0,12805172,1.53424,6532,12811727,23,12805164,31,8
II,-,12805164,0.00384615,0.0,780,777,3,3,25,gene,Y46G5A.18,0,12805118,1.53424,6563,12811727,46,12805164,0,-46
II,-,12796354,0.00191205,0.0,1046,1044,2,2,8,gene,Y46G5A.17,1,12796242,4.2217,3965,12800319,112,12796354,0,-112
II,-,12788054,0.966387,1.19479e-29,119,4,115,82,1,gene,Y46G5A.35,2,12788041,0.395354,102,12788156,13,12788041,13,0
II,-,12785311,0.00704225,2.547e-41,142,141,1,1,1,gene,Y46G5A.15,0,12785307,0.199946,926,12786237,4,12785307,4,0
II,-,12768119,0.017341,0.0,519,510,9,7,3,gene,Y46G5A.12,0,12768119,1.49714,14532,12782651,0,12768119,0,0
II,-,12746735,0.0,1.11022e-16,53,53,0,0,0,gene,Y46G5A.6,0,12746721,0.0729617,6018,12752753,14,12746735,0,-14
II,-,12738233,0.014218,0.0,633,624,9,6,3,gene,Y46G5A.5,1,12738227,2.15602,3859,12742092,6,12738233,0,-6
II,-,12736811,0.866359,0.0,651,87,564,407,2,gene,Y46G5A.4,2,12736776,1.94668,121,12736932,35,12736776,35,0
II,-,12677705,0.00796813,0.0,251,249,2,1,0,gene,Y38E10A.23,0,12677700,0.715083,1592,12679297,5,12677700,5,0
II,-,12676092,0.0,0.03125,5,5,0,0,0,gene,Y38E10A.22,0,12676092,0.799375,1087,12677179,0,12676092,0,0
II,-,12612023,0.0,3.30872e-24,78,78,0,0,1,gene,Y38E10A.10,0,12612009,0.133045,3750,12615773,14,12612262,-239,-253
II,-,12603586,0.00291545,0.0,343,342,1,1,1,gene,Y38E10A.6,0,12603586,0.526978,6631,12610217,0,12603586,0,0
II,-,12574694,0.0,3.72529e-09,28,28,0,0,2,gene,Y38E10A.3,0,12574674,0.0546148,904,12575598,20,12574674,20,0
II,-,12502786,0.0,7.27596e-12,37,37,0,0,0,gene,T21B4.4,0,12502768,0.0987205,10739,12513525,18,12502786,0,-18
II,-,12485068,0.00252525,0.0,396,395,1,1,2,gene,F15A4.10,0,12485035,0.646457,8537,12493605,33,12485068,0,-33
II,-,12480818,0.0,0.03125,5,5,0,0,0,gene,F15A4.9,0,12480818,0.0112537,3634,12484452,0,12480818,0,0
II,-,12471117,0.0,5.68434e-14,44,44,0,0,102,gene,F15A4.5,0,12471111,0.191194,4127,12475244,6,12471111,6,0
II,-,12435740,0.0,0.000244141,12,12,0,0,3,gene,Y57A10C.9,0,12435736,0.0255779,4296,12440036,4,12435754,-14,-18
II,-,12425602,0.0015674,0.0,3828,3822,6,2,0,gene,Y57A10C.6,0,12425598,2.71213,2290,12427892,4,12425602,0,-4
II,-,12409850,0.0,1.52588e-05,16,16,0,0,26,gene,F57G9.3,0,12409829,0.0735543,1666,12411516,21,12410115,-265,-286
II,-,12397679,0.0,0.125,3,3,0,0,0,gene,F57G9.7,0,12397664,0.000902895,1626,12399305,15,12397664,15,0
II,-,12379437,0.0,0.03125,5,5,0,0,1,gene,Y57A10B.2,0,12379419,0.0766243,5067,12384504,18,12379419,18,0
II,-,12366931,0.00350877,0.0,285,284,1,1,0,gene,Y57A10B.1,0,12366931,0.35191,7368,12374299,0,12366931,0,0
II,-,12352131,0.0434783,5.64275e-22,92,88,4,3,2,gene,C44C11.1,0,12352058,0.722801,6470,12358601,73,12352058,73,0
II,-,12279289,0.0112867,0.0,443,438,5,4,0,gene,Y57A10A.28,1,12279287,0.516656,21696,12300985,2,12279287,2,0
II,-,12274952,0.836431,7.77016e-31,269,44,225,154,2,gene,Y57A10A.27,2,12274951,0.556023,882,12275834,1,12274952,0,-1
II,-,12266148,0.00657895,0.0,304,302,2,2,1,gene,Y57A10A.36,0,12266128,None,3571,12269719,20,12266149,-1,-21
II,-,12256535,0.661538,7.37723e-05,130,44,86,64,1,gene,Y57A10A.25,2,12256534,0.325665,232,12256767,1,12256535,0,-1
II,-,12221697,0.00241213,0.0,2902,2895,7,6,2,gene,Y57A10A.18,0,12221541,3.40134,26356,12248053,156,12221541,156,0
II,-,12202289,0.622047,2.46994e-05,254,96,158,106,0,gene,Y57A10A.16,1,12202285,0.759602,6726,12209015,4,12202285,4,0
II,-,12199868,0.924242,1.21118e-13,66,5,61,47,1,gene,Y57A10A.15,2,12199867,0.156827,672,12200540,1,12199867,1,0
II,-,12184996,0.0,0.25,2,2,0,0,0,gene,Y57A10A.13,0,12184771,1.02604,4707,12189703,225,12184780,216,-9
II,-,12184789,0.00528169,0.0,568,565,3,1,1,gene,Y57A10A.13,0,12184771,1.02604,4914,12189703,18,12184780,9,-9
II,-,12132805,0.03125,7.45058e-09,32,31,1,1,0,gene,Y43F11A.6,1,12132802,None,43983,12176788,3,12132802,3,0
II,-,12130876,0.910569,1.44924e-22,123,11,112,91,0,gene,Y43F11A.5,2,12130853,0.210848,425,12131301,23,12130876,0,-23
II,-,12107765,0.00529101,0.0,189,188,1,1,0,gene,Y17G7B.18,1,12107755,0.391545,414,12108179,10,12107765,0,-10
II,-,12099897,0.212454,8.10065e-23,273,215,58,45,0,gene,Y17G7B.17,2,12099824,2.50718,3342,12103239,73,12099897,0,-73
II,-,12088774,0.00289855,0.0,345,344,1,1,1,gene,Y17G7B.15,3,12088769,0.829197,3556,12092330,5,12088769,5,0
II,-,12079984,0.0,6.77626e-21,67,67,0,0,2,gene,Y17G7B.15,3,12079983,0.829197,12346,12092330,1,12079983,1,0
II,-,12062529,0.0,0.0,175,175,0,0,6,gene,Y17G7B.11,0,12062527,0.280781,9448,12071977,2,12062527,2,0
II,-,12039047,0.002354,0.0,8921,8900,21,18,2,gene,Y17G7B.7,1,12039040,7.38487,21089,12060136,7,12039047,0,-7
II,-,12036650,1.0,3.72529e-09,28,0,28,21,0,gene,Y17G7B.9,2,12036643,0.476886,95,12036745,7,12036643,7,0
II,-,12036643,0.977143,1.4013e-45,175,4,171,113,27,gene,Y17G7B.9,2,12036643,0.476886,102,12036745,0,12036643,0,0
II,-,12027655,0.0530008,0.0,1283,1215,68,41,4,gene,Y17G7B.8,3,12027654,0.369279,955,12028610,1,12027654,1,0
II,-,12006533,0.0121633,0.0,1151,1137,14,13,1,gene,Y17G7B.5,0,12006516,2.61277,19261,12025794,17,12006533,0,-17
II,-,11979566,0.00781929,0.0,1151,1142,9,8,589,gene,Y17G7B.20,1,11979451,6.41304,21859,12001425,115,11979451,115,0
II,-,11978171,1.0,0.5,1,0,1,1,335,gene,Y17G7B.21,2,11978048,1.50802,23254,12001425,123,11977567,604,481
II,-,11977567,0.893233,0.0,1995,213,1782,1096,16,gene,Y17G7B.21,2,11977552,1.50802,114,11977681,15,11977567,0,-15
II,-,11974007,0.0205479,5.69577e-39,146,143,3,2,10,gene,Y17G7B.1,0,11973849,0.244947,1064,11975071,158,11973599,408,250
II,-,11967439,0.00265152,0.0,2640,2633,7,4,30,gene,W03C9.5,1,11967423,2.75213,4779,11972218,16,11967441,-2,-18
II,-,11966856,0.5,0.5,2,1,1,0,8,gene,W03C9.3,2,11966810,3.95554,96,11966952,46,11966841,15,-31
II,-,11966839,0.820069,0.0,1445,260,1185,642,22,gene,W03C9.3,2,11966810,3.95554,113,11966952,29,11966839,0,-29
II,-,11935252,0.0140845,3.00697e-20,71,70,1,0,3,gene,W03C9.4,0,11935038,0.683772,25643,11960895,214,11935252,0,-214
II,-,11933166,0.0,0.5,1,1,0,0,0,gene,W03C9.4,0,11933133,0.683772,27729,11960895,33,11933133,33,0
II,-,11915761,0.00490196,0.0,408,406,2,2,3,gene,ZK930.1,0,11915754,0.811838,1790,11917551,7,11915754,7,0
II,-,11901119,0.0111111,0.0,270,267,3,3,0,gene,ZK930.3,0,11901104,0.68086,7506,11908625,15,11901121,-2,-17
II,-,11874612,0.00682594,0.0,293,291,2,1,4,gene,K12D12.2,0,11874602,1.24264,13076,11887688,10,11874623,-11,-21
II,-,11854652,0.00310559,0.0,322,321,1,1,27,gene,T27D12.2,0,11854651,0.797332,8737,11863389,1,11854652,0,-1
II,-,11823525,0.0160428,0.0,374,368,6,5,3,gene,Y6D1A.1,0,11823509,0.411194,4317,11827842,16,11823527,-2,-18
II,-,11823441,0.0,0.0625,4,4,0,0,28,gene,Y6D1A.1,0,11823415,0.411194,4401,11827842,26,11823527,-86,-112
II,-,11816517,0.0,6.31089e-30,97,97,0,0,15,gene,F43G6.5,0,11816484,0.102152,1621,11818138,33,11816484,33,0
II,-,11813992,0.0,0.5,1,1,0,0,317,gene,F43G6.8,0,11813937,0.646321,706,11814698,55,11814017,-25,-80
II,-,11777852,0.00249688,0.0,801,799,2,2,1,gene,F43G6.9,1,11777829,2.75995,4217,11782069,23,11777852,0,-23
II,-,11774468,0.935414,0.0,31044,2005,29039,18349,5,gene,F44E5.1,2,11774468,55.8675,106,11774574,0,11774468,0,0
II,-,11748512,0.00267738,0.0,747,745,2,1,1,gene,F13D12.7,0,11748392,7.47124,8507,11757019,120,11748512,0,-120
II,-,11747720,0.00201681,0.0,5950,5938,12,10,0,gene,F13D12.7,0,11747556,7.47124,9299,11757019,164,11747720,0,-164
II,-,11732317,0.0,0.0,500,500,0,0,22,gene,F13D12.8,0,11732287,0.829589,10403,11742720,30,11732503,-186,-216
II,-,11732296,0.0,0.015625,6,6,0,0,1589,gene,F13D12.8,0,11732287,0.829589,10424,11742720,9,11732503,-207,-216
II,-,11709475,0.0178571,7.77156e-16,56,55,1,1,0,gene,F13D12.9,0,11709275,0.904077,7803,11717278,200,11709475,0,-200
II,-,11709276,0.0,0.00390625,8,8,0,0,13,gene,F13D12.9,0,11709275,0.904077,8002,11717278,1,11709276,0,-1
II,-,11700209,0.000594177,0.0,1683,1682,1,1,4,gene,VF13D12L.1,0,11700171,3.9313,7153,11707362,38,11700209,0,-38
II,-,11694202,0.0,4.70198e-38,124,124,0,0,0,gene,C47D12.6,0,11694186,3.16927,4023,11698225,16,11694202,0,-16
II,-,11693986,0.00185874,0.0,538,537,1,1,0,gene,C47D12.6,0,11693983,3.16927,4239,11698225,3,11693986,0,-3
II,-,11685186,0.0,0.0,270,270,0,0,45,gene,C47D12.5,0,11685180,0.325956,6043,11691229,6,11685198,-12,-18
II,-,11675836,0.0,2.22045e-16,52,52,0,0,0,gene,C47D12.1,0,11675765,0.590104,3274,11679110,71,11675765,71,0
II,-,11657081,0.027972,1.49786e-36,143,139,4,4,0,gene,ZK20.6,0,11657076,1.15653,4413,11661494,5,11657081,0,-5
II,-,11652638,0.0119332,0.0,838,828,10,5,4,gene,ZK20.3,1,11652637,4.40015,1485,11654123,1,11652638,0,-1
II,-,11651057,0.892183,0.0,371,40,331,216,3,gene,ZK20.4,2,11651057,0.651716,109,11651166,0,11651057,0,0
II,-,11633518,0.0143885,1.37624e-38,139,137,2,2,2,gene,F07A11.6,0,11633503,1.08187,15525,11649043,15,11633518,0,-15
II,-,11632182,0.0,5.68434e-14,44,44,0,0,1,gene,F07A11.6,0,11631902,1.08187,16861,11649043,280,11632182,0,-280
II,-,11619500,0.0,0.0625,4,4,0,0,42,gene,F07A11.6,0,11619055,1.08187,8873,11628373,445,11619064,436,-9
II,-,11619064,0.0,0.5,1,1,0,0,97,gene,F07A11.6,0,11619055,1.08187,9309,11628373,9,11619064,0,-9
II,-,11599716,0.00511509,0.0,782,778,4,3,2,gene,F07A11.3,1,11599712,0.93739,14816,11614532,4,11599716,0,-4
II,-,11596526,1.0,0.015625,6,0,6,4,0,gene,F07A11.2,2,11596496,3.90743,148,11596674,30,11596368,158,128
II,-,11596446,1.0,0.25,2,0,2,1,0,gene,F07A11.2,2,11596382,3.90743,228,11596674,64,11596368,78,14
II,-,11595315,0.0592885,0.0,1518,1428,90,82,3,gene,F07A11.2,2,11595289,3.90743,1359,11596674,26,11595315,0,-26
II,-,11577105,0.0052356,0.0,191,190,1,1,0,gene,F54D5.1,0,11577095,0.351851,11262,11588367,10,11577095,10,0
II,-,11566625,0.00460123,0.0,652,649,3,3,2,gene,F54D5.5,0,11566608,1.95782,1985,11568610,17,11566625,0,-17
II,-,11563279,0.0,0.000488281,11,11,0,0,2,gene,F54D5.15,0,11563238,0.215175,1010,11564289,41,11563279,0,-41
II,-,11542442,0.924603,0.0,756,57,699,580,93,gene,F54D5.11,2,11542399,1.01143,101,11542543,43,11542404,38,-5
II,-,11542404,0.876457,0.0,429,53,376,300,2180,gene,F54D5.11,2,11542399,1.01143,139,11542543,5,11542404,0,-5
II,-,11540539,0.298587,2.34017e-43,1132,794,338,254,44,gene,F54D5.12,3,11540539,2.32648,142,11540681,0,11540539,0,0
II,-,11538599,1.0,0.5,1,0,1,1,26,gene,Y62F5A.9,0,11538591,0.3286,211,11538810,8,11538724,-125,-133
II,-,11534388,0.0162822,0.0,737,725,12,9,1,gene,Y62F5A.12,1,11534386,None,679,11535067,2,11534386,2,0
II,-,11533723,0.907131,0.0,603,56,547,410,0,gene,Y62F5A.1,2,11533723,1.64955,114,11533837,0,11533723,0,0
II,-,11526971,0.935484,1.20963e-13,62,4,58,42,0,gene,B0334.8,3,11526963,0.447676,120,11527091,8,11526971,0,-8
II,-,11526963,0.898734,4.31603e-14,79,8,71,58,187,gene,B0334.8,3,11526963,0.447676,128,11527091,0,11526971,-8,-8
II,-,11495223,0.00168919,0.0,592,591,1,1,5,gene,B0334.11,1,11495223,0.626195,3639,11498862,0,11495223,0,0
II,-,11492872,0.604113,8.4505e-06,389,154,235,170,980,gene,B0334.3,2,11492872,3.68125,276,11493148,0,11492872,0,0
II,-,11486657,0.0016142,0.0,4956,4948,8,6,43,gene,B0334.1,0,11486656,8.09516,2851,11489508,1,11486657,0,-1
II,-,11485209,0.0,1.26218e-29,96,96,0,0,8,gene,B0334.2,0,11485125,0.363254,210,11485419,84,11485209,0,-84
II,-,11473478,0.00762195,0.0,656,651,5,5,0,gene,W02B12.10,1,11473471,1.6061,2074,11475552,7,11473471,7,0
II,-,11471942,0.970075,0.0,401,12,389,219,2,gene,W02B12.9,2,11471920,1.39973,100,11472042,22,11471942,0,-22
II,-,11469018,0.303068,0.0,2412,1681,731,561,1,gene,W02B12.15,3,11469013,8.49423,900,11469918,5,11469018,0,-5
II,-,11459268,0.0,3.72529e-09,28,28,0,0,0,gene,W02B12.4,0,11459265,0.100901,808,11460076,3,11459265,3,0
II,-,11452864,0.00503461,0.0,1589,1581,8,7,2,gene,W02B12.2,0,11452854,4.91256,2800,11455664,10,11452864,0,-10
II,-,11439686,0.0,0.5,1,1,0,0,9,gene,VW02B12L.2,0,11439666,0.0756337,11667,11451353,20,11439666,20,0
II,-,11438667,0.0,0.0625,4,4,0,0,6,gene,VW02B12L.1,0,11438503,5.31599,419,11439086,164,11438363,304,140
II,-,11438361,0.00126024,0.0,1587,1585,2,2,11,gene,VW02B12L.1,0,11438330,5.31599,115,11438476,31,11438361,0,-31
II,-,11415681,0.0,9.53674e-07,20,20,0,0,6,gene,C05D12.1,0,11415571,0.224188,19436,11435117,110,11415681,0,-110
II,-,11415638,0.0,0.0625,4,4,0,0,12,gene,C05D12.1,0,11415571,0.224188,19479,11435117,67,11415638,0,-67
II,-,11390771,0.0,0.0,213,213,0,0,9,gene,C33B4.3,0,11390745,1.06426,21369,11412140,26,11390771,0,-26
II,-,11376179,0.00487805,0.0,410,408,2,1,2,gene,C33B4.4,0,11376144,0.929398,8219,11384398,35,11376181,-2,-37
II,-,11347868,0.0,0.00195312,9,9,0,0,13,gene,B0491.6,0,11347857,0.441495,22331,11370199,11,11347867,1,-10
II,-,11345530,0.00851064,0.0,1410,1398,12,11,0,gene,B0491.5,0,11345525,5.77396,323,11345853,5,11345530,0,-5
II,-,11337661,0.0,0.5,1,1,0,0,4,gene,B0491.2,0,11337659,6.25963,705,11338366,2,11337661,0,-2
II,-,11329339,0.0,5.29396e-23,74,74,0,0,2,gene,T24F1.6,0,11329292,0.167118,7262,11336601,47,11329339,0,-47
II,-,11319599,0.00367985,0.0,1087,1083,4,1,5,gene,T24F1.5,0,11319587,1.44958,3359,11322958,12,11319670,-71,-83
II,-,11314156,0.0,1.13687e-13,43,43,0,0,0,gene,T24F1.4,0,11314097,0.162875,4979,11319135,59,11314175,-19,-78
II,-,11290069,0.534833,0.000758307,1378,641,737,537,0,gene,C47G2.3,2,11290069,1.17431,690,11290759,0,11290069,0,0
II,-,11261117,0.0,0.00390625,8,8,0,0,25,gene,T05B9.1,0,11261102,3.21082,27481,11288598,15,11261166,-49,-64
II,-,11261102,0.00300687,0.0,2328,2321,7,6,30,gene,T05B9.1,0,11261102,3.21082,27496,11288598,0,11261166,-64,-64
II,-,11261080,0.0,0.125,3,3,0,0,6281,gene,T05B9.1,0,11261068,3.21082,27518,11288598,12,11261166,-86,-98
II,-,11238829,0.0034163,0.0,2049,2042,7,6,374,gene,T06D8.8,1,11238828,4.09696,1202,11240031,1,11238829,0,-1
II,-,11237330,1.0,0.5,1,0,1,1,3,gene,T06D8.7,2,11237330,1.59446,21,11237351,0,11237233,97,97
II,-,11237231,0.836489,0.0,581,95,486,332,9,gene,T06D8.7,2,11237229,1.59446,120,11237351,2,11237233,-2,-4
II,-,11236297,0.29805,0.0,1436,1008,428,338,137,gene,T06D8.6,3,11236284,2.96158,234,11236531,13,11236297,0,-13
II,-,11234877,1.0,0.03125,5,0,5,3,1,gene,T06D8.5,4,11234857,0.977609,85,11234962,20,11234857,20,0
II,-,11234862,0.902913,0.0,515,50,465,327,11,gene,T06D8.5,4,11234857,0.977609,100,11234962,5,11234857,5,0
II,-,11184723,0.00877193,5.4889e-33,114,113,1,1,0,gene,F37H8.1,0,11184722,0.147649,47942,11232665,1,11184722,1,0
II,-,11162185,0.0,0.0,184,184,0,0,23,gene,K07C10.1,0,11162185,0.390447,9448,11171633,0,11162248,-63,-63
II,-,11152510,0.00128755,0.0,2330,2327,3,3,5,gene,F40F8.7,0,11152481,1.83298,4312,11156822,29,11152481,29,0
II,-,11134845,0.0,0.0,3809,3809,0,0,18,gene,F40F8.5,0,11134844,6.91649,4479,11139324,1,11134845,0,-1
II,-,11132514,0.00805153,0.0,621,616,5,5,19,gene,F40F8.11,0,11132501,1.6322,250,11132764,13,11132514,0,-13
II,-,11132325,1.0,0.5,1,0,1,1,96,gene,F40F8.11,0,11131845,1.6322,439,11132764,480,11132514,-189,-669
II,-,11126279,0.00861751,0.0,27154,26920,234,204,2,gene,F40F8.10,0,11126270,154.536,4327,11130606,9,11126279,0,-9
II,-,11111118,0.0526316,3.62396e-05,19,18,1,0,0,gene,C09H10.8,0,11111096,0.0814867,2094,11113212,22,11111086,32,10
II,-,11102877,0.00254777,0.0,785,783,2,2,0,gene,C09H10.5,0,11102874,0.750262,6622,11109499,3,11102863,14,11
II,-,11097121,0.00193808,0.0,275014,274481,533,484,45,gene,C09H10.2,1,11097116,282.068,3273,11100394,5,11097121,0,-5
II,-,11096392,0.911765,3.70842e-13,68,6,62,44,0,gene,C09H10.10,2,11096392,0.297164,65,11096457,0,11096392,0,0
II,-,11089373,0.0,9.09495e-13,40,40,0,0,0,gene,F45E10.1,0,11089352,0.86264,5588,11094961,21,11089373,0,-21
II,-,11083876,0.0,0.000244141,12,12,0,0,0,gene,F45E10.1,0,11083806,0.86264,11085,11094961,70,11083876,0,-70
II,-,11080457,0.0,5.96046e-08,24,24,0,0,0,gene,F45E10.1,0,11080247,0.86264,14504,11094961,210,11080457,0,-210
II,-,11078708,0.0,1.52588e-05,16,16,0,0,0,gene,F45E10.1,0,11078704,0.86264,16253,11094961,4,11078708,0,-4
II,-,11073798,0.0,1.16415e-10,33,33,0,0,0,gene,F45E10.1,0,11073676,0.86264,21163,11094961,122,11073798,0,-122
II,-,11055098,0.0,0.00195312,9,9,0,0,8,gene,F45E10.2,0,11055070,0.265927,2921,11058019,28,11055220,-122,-150
II,-,11049830,0.00361272,0.0,2768,2758,10,7,3,gene,F33A8.5,1,11049829,6.18306,2231,11052061,1,11049830,0,-1
II,-,11048947,0.900763,0.0,393,39,354,245,2,gene,F33A8.4,2,11048947,0.632941,71,11049018,0,11048947,0,0
II,-,11045892,1.0,0.5,1,0,1,1,5,gene,F33A8.9,0,11045885,0.0249232,112,11046004,7,11045885,7,0
II,-,11041123,0.00382409,0.0,3661,3647,14,11,1,gene,F33A8.3,0,11041044,20.1843,2915,11044038,79,11041123,0,-79
II,-,11030313,0.00390843,0.0,1791,1784,7,3,6,gene,F33A8.2,0,11030290,3.52984,8952,11039265,23,11030320,-7,-30
II,-,10953066,0.0198864,0.0,352,345,7,7,0,gene,R03D7.7,0,10953056,0.39682,393,10953459,10,10953080,-14,-24
II,-,10945575,0.00707214,0.0,707,702,5,5,21,gene,R03D7.4,0,10945482,1.41058,5944,10951519,93,10945575,0,-93
II,-,10935093,0.0163934,2.64545e-17,61,60,1,1,3,gene,R03D7.2,0,10935076,0.200309,2789,10937882,17,10935152,-59,-76
II,-,10910240,0.0,0.125,3,3,0,0,0,gene,F44F4.13,0,10910234,0.00712853,4955,10915195,6,10910234,6,0
II,-,10895005,0.0,0.000488281,11,11,0,0,0,gene,F44F4.5,0,10895003,0.0296417,4910,10899915,2,10895003,2,0
II,-,10884356,0.000798085,0.0,1253,1252,1,1,13,gene,F44F4.2,0,10884355,0.686562,264,10884620,1,10884356,0,-1
II,-,10872526,0.00442478,0.0,226,225,1,1,0,gene,F59E10.2,0,10872521,0.808189,9796,10882322,5,10872526,0,-5
II,-,10866703,0.00497512,0.0,201,200,1,1,3,gene,M106.4,1,10866649,1.27441,1385,10868088,54,10866703,0,-54
II,-,10860808,0.0527241,0.0,1138,1078,60,50,234,gene,M106.3,2,10860799,1.42273,2787,10863595,9,10860808,0,-9
II,-,10857091,0.950237,0.0,422,21,401,280,1,gene,M106.7,3,10857091,1.39567,310,10857401,0,10857091,0,0
II,-,10849915,0.0644567,0.0,543,508,35,30,5,gene,M106.2,1,10849913,0.857133,5641,10855556,2,10849913,2,0
II,-,10843537,0.812749,6.53885e-25,251,47,204,149,11,gene,M106.8,2,10843536,None,165,10843702,1,10843536,1,0
II,-,10823996,0.0,0.0,384,384,0,0,2,gene,R06F6.12,0,10823994,0.740391,3612,10827608,2,10823994,2,0
II,-,10820499,0.0,0.125,3,3,0,0,1,gene,R06F6.8,0,10820305,0.541325,1735,10822234,194,10819893,606,412
II,-,10819893,0.0,0.0,243,243,0,0,11,gene,R06F6.8,0,10819880,0.541325,2341,10822234,13,10819893,0,-13
II,-,10798394,0.00206469,0.0,1453,1450,3,2,6,gene,R06F6.5,1,10798391,1.4954,14470,10812864,3,10798394,0,-3
II,-,10796209,0.734513,3.52277e-13,226,60,166,111,0,gene,R06F6.4,2,10796203,0.413059,350,10796559,6,10796209,0,-6
II,-,10793408,0.9375,6.97724e-24,112,7,105,76,1,gene,R06F6.2,3,10793407,0.390041,101,10793509,1,10793408,0,-1
II,-,10783205,0.00854701,7.04168e-34,117,116,1,1,5,gene,T19E10.1,0,10783180,0.981009,4630,10787835,25,10783180,25,0
II,-,10772762,0.0,4.76837e-07,21,21,0,0,1,gene,C52A11.4,0,10772735,0.318007,5545,10778307,27,10772728,34,7
II,-,10767285,0.0,0.00195312,9,9,0,0,4,gene,C52A11.4,0,10767241,0.318007,11022,10778307,44,10767285,0,-44
II,-,10766651,0.0,0.25,2,2,0,0,0,gene,C52A11.4,0,10766556,0.318007,11656,10778307,95,10766651,0,-95
II,-,10731762,0.0,0.5,1,1,0,0,0,gene,C52A11.2,0,10731744,0.0475061,6749,10738511,18,10731477,285,267
II,-,10731559,0.0,0.03125,5,5,0,0,1,gene,C52A11.2,0,10731539,0.0475061,6952,10738511,20,10731477,82,62
II,-,10714212,0.0,0.0,271,271,0,0,1,gene,C09G5.2,0,10714210,0.411046,15506,10729718,2,10714210,2,0
II,-,10665003,0.0,1.57772e-30,99,99,0,0,18,gene,D2089.3,0,10664801,0.445745,25363,10690366,202,10664801,202,0
II,-,10658541,0.0106236,0.0,10166,10058,108,96,6,gene,M28.5,0,10658529,18.2492,1598,10660139,12,10658541,0,-12
II,-,10657687,0.916667,1.03901e-07,36,3,33,30,32,gene,M28.6,0,10657583,0.85836,133,10657820,104,10657716,-29,-133
II,-,10607190,0.00508475,0.0,590,587,3,3,9,gene,C14A4.11,1,10607180,1.2202,41621,10648811,10,10607190,0,-10
II,-,10605549,1.0,0.5,1,0,1,1,3,gene,C14A4.10,2,10605517,2.6185,83,10605632,32,10605517,32,0
II,-,10605527,0.963061,0.0,1137,42,1095,782,1,gene,C14A4.10,2,10605517,2.6185,105,10605632,10,10605517,10,0
II,-,10597806,0.0,0.03125,5,5,0,0,6,gene,C14A4.8,0,10597754,0.10419,2708,10600514,52,10597987,-181,-233
II,-,10594691,0.00548446,0.0,547,544,3,3,0,gene,C14A4.6,0,10594671,0.84796,486,10595177,20,10594691,0,-20
II,-,10578122,0.0,0.0,1179,1179,0,0,1,gene,C06A1.4,0,10578108,None,15322,10593444,14,10578108,14,0
II,-,10563321,0.00586907,0.0,2215,2202,13,12,21,gene,C06A1.1,0,10563304,4.74319,766,10564087,17,10563321,0,-17
II,-,10554970,1.0,0.5,1,0,1,0,0,gene,R166.5,1,10554830,5.06794,1367,10556337,140,10554958,12,-128
II,-,10554958,0.329497,5.60519e-45,1651,1107,544,476,2,gene,R166.5,1,10554830,5.06794,1379,10556337,128,10554958,0,-128
II,-,10553606,0.015625,3.46945e-18,64,63,1,1,1,gene,R166.5,1,10553536,5.06794,2731,10556337,70,10553606,0,-70
II,-,10542407,0.0,0.000976562,10,10,0,0,85,gene,R166.4,2,10542405,0.477302,50,10542457,2,10541910,497,495
II,-,10541910,0.206704,3.92623e-16,179,142,37,20,0,gene,R166.4,2,10541899,0.477302,431,10542341,11,10541910,0,-11
II,-,10539246,0.890722,0.0,485,53,432,227,3,gene,R166.3,3,10539246,0.869301,106,10539352,0,10539246,0,0
II,-,10537585,0.740964,1.72697e-19,332,86,246,182,7,gene,R166.2,4,10537584,0.955039,128,10537713,1,10537585,0,-1
II,-,10524392,0.0,0.00012207,13,13,0,0,6,gene,F59B10.6,0,10524388,0.135448,9065,10533457,4,10524388,4,0
II,-,10524378,0.0,1.45519e-11,36,36,0,0,21,gene,F59B10.6,0,10524363,0.135448,9079,10533457,15,10524388,-10,-25
II,-,10502455,0.0,0.0,450,450,0,0,1,gene,F59B10.1,0,10502401,1.0236,4720,10507175,54,10502455,0,-54
II,-,10481780,0.0,6.16298e-33,107,107,0,0,0,gene,ZK666.6,0,10481731,1.00154,6864,10488644,49,10481731,49,0
II,-,10421956,0.0,2.98023e-08,25,25,0,0,0,gene,E04D5.2,0,10421940,0.579125,40824,10462780,16,10421940,16,0
II,-,10369511,0.00847458,0.0,236,234,2,2,0,gene,C07E3.6,0,10369496,0.540281,49543,10419054,15,10369511,0,-15
II,-,10357432,0.00564972,0.0,177,176,1,0,0,gene,C07E3.3,0,10357416,1.12948,3006,10360438,16,10357432,0,-16
II,-,10349919,0.00557103,0.0,359,357,2,2,2,gene,C07E3.1,1,10349919,0.572926,3627,10353546,0,10349919,0,0
II,-,10345026,0.937255,0.0,255,16,239,145,1,gene,C07E3.2,2,10345025,0.999086,1972,10346998,1,10345026,0,-1
II,-,10303627,0.0119966,0.0,2334,2306,28,25,3,gene,ZK970.4,1,10303627,12.7739,424,10304051,0,10303627,0,0
II,-,10302756,0.760234,3.64685e-23,342,82,260,194,31,gene,ZK970.2,2,10302741,1.13919,33,10302789,15,10302773,-17,-32
II,-,10302707,0.6,0.3125,5,2,3,3,168,gene,ZK970.2,2,10302696,1.13919,82,10302789,11,10302696,11,0
II,-,10302527,0.0,0.5,1,1,0,0,4,gene,ZK970.2,2,10302523,1.13919,262,10302789,4,10302527,0,-4
II,-,10295707,0.0263158,1.38243e-10,38,37,1,1,1,gene,ZK970.1,0,10295658,0.338276,4926,10300633,49,10295678,29,-20
II,-,10288851,0.0,1.45519e-11,36,36,0,0,2,gene,ZK970.1,0,10288827,0.338276,11782,10300633,24,10288851,0,-24
II,-,10271078,0.0,7.45058e-09,27,27,0,0,6,gene,F54B3.4,0,10271064,None,7496,10278574,14,10271064,14,0
II,-,10247552,0.00338983,0.0,295,294,1,1,9,gene,T01E8.5,1,10247531,0.98798,20536,10268088,21,10247552,0,-21
II,-,10242404,0.901778,0.0,1181,116,1065,681,1,gene,T01E8.6,2,10242404,1.81167,103,10242507,0,10242404,0,0
II,-,10239609,0.818182,0.0,539,98,441,333,6,gene,T01E8.4,3,10239602,0.880247,584,10240193,7,10239609,0,-7
II,-,10200732,0.0101351,0.0,296,293,3,3,0,gene,R05H5.5,0,10200730,0.858017,344,10201076,2,10200730,2,0
II,-,10199675,0.666667,0.375,3,1,2,1,48,gene,R05H5.4,0,10199652,0.224334,24,10199699,23,10199683,-8,-31
II,-,10169261,0.1,0.00976562,10,9,1,1,0,gene,F33H1.1,0,10169236,0.626556,10853,10180114,25,10169236,25,0
II,-,10164301,0.0,0.5,1,1,0,0,6,gene,F33H1.1,0,10164293,0.626556,3770,10168071,8,10164293,8,0
II,-,10131768,0.0,7.62939e-06,17,17,0,0,1,gene,F27E5.5,0,10131747,0.0118262,9517,10141285,21,10131739,29,8
II,-,10127402,0.0,0.5,1,1,0,0,0,gene,F27E5.8,0,10127370,0.000565421,729,10128131,32,10127370,32,0
II,-,10105619,0.0,1.19209e-07,23,23,0,0,1,gene,ZK945.4,0,10105611,0.0538285,377,10105996,8,10105619,0,-8
II,-,10099769,0.00309598,0.0,2261,2254,7,6,4,gene,ZK945.2,0,10099768,3.74174,3259,10103028,1,10099769,0,-1
II,-,10074356,0.0,2.06795e-25,82,82,0,0,0,gene,C18D1.1,0,10074114,1.84759,24377,10098733,242,10074358,-2,-244
II,-,10067895,0.0,1.81899e-12,39,39,0,0,2,gene,C18D1.1,0,10067832,1.84759,30838,10098733,63,10067895,0,-63
II,-,10045199,0.0,0.25,2,2,0,0,0,gene,F52H3.3,0,10045078,0.817023,11025,10056224,121,10045104,95,-26
II,-,10045064,0.0,8.67362e-19,60,60,0,0,225,gene,F52H3.3,0,10044997,0.817023,11160,10056224,67,10045104,-40,-107
II,-,10038035,0.0,0.0,357,357,0,0,2,gene,F52H3.1,1,10038032,0.627697,4517,10042552,3,10038035,0,-3
II,-,10033128,0.751678,1.96398e-10,149,37,112,83,0,gene,F52H3.2,2,10033123,0.4902,93,10033221,5,10033128,0,-5
II,-,10015760,0.0,0.5,1,1,0,0,108,gene,F52H3.7,0,10015707,9.29897,10750,10026510,53,10015975,-215,-268
II,-,10011248,0.00340715,0.0,2935,2925,10,6,1,gene,F52H3.7,0,10011200,9.29897,15262,10026510,48,10011248,0,-48
II,-,10001032,0.00578035,0.0,173,172,1,0,327,gene,ZK892.2,0,10001017,5.87892,8489,10009521,15,10001057,-25,-40
II,-,10001025,0.00207828,0.0,2887,2881,6,3,333,gene,ZK892.2,0,10001017,5.87892,8496,10009521,8,10001057,-32,-40
II,-,9981665,0.0,1.54074e-33,109,109,0,0,0,gene,ZK892.7,0,9981662,0.090335,18583,10000248,3,9981662,3,0
II,-,9980045,0.0,0.000488281,11,11,0,0,0,gene,ZK892.6,0,9980033,0.0187661,762,9980807,12,9979991,54,42
II,-,9974922,0.0,0.5,1,1,0,0,220,gene,R53.7,1,9974909,1.52078,4005,9978927,13,9974961,-39,-52
II,-,9974619,0.00108696,0.0,920,919,1,1,25,gene,R53.7,1,9974619,1.52078,4308,9978927,0,9974619,0,0
II,-,9970403,0.433757,0.000268336,551,312,239,188,13,gene,R53.5,2,9970400,1.55016,567,9970970,3,9970400,3,0
II,-,9967964,0.0153926,0.0,7731,7612,119,101,5,gene,R53.4,3,9967962,33.7665,1566,9969530,2,9967964,0,-2
II,-,9967014,0.727455,2.15651e-25,499,136,363,252,348,gene,R53.2,4,9966996,1.72878,172,9967186,18,9967047,-33,-51
II,-,9936808,0.092081,0.0,1086,986,100,76,2,gene,C05C10.3,0,9936803,2.45936,1221,9938029,5,9936808,0,-5
II,-,9890996,0.00528701,0.0,3972,3951,21,20,0,gene,C08H9.2,1,9890856,9.13261,6673,9897669,140,9890996,0,-140
II,-,9890946,0.0,0.5,1,1,0,0,447,gene,C08H9.2,1,9890856,9.13261,6723,9897669,90,9890996,-50,-140
II,-,9886357,0.881188,4.70181e-16,101,12,89,70,2,gene,C08H9.3,2,9886353,0.244766,104,9886461,4,9886357,0,-4
II,-,9868696,0.0,0.25,2,2,0,0,0,gene,C08H9.5,0,9868676,0.0181304,673,9869369,20,9868676,20,0
II,-,9868656,0.0,0.00195312,9,9,0,0,0,gene,C08H9.5,0,9868651,0.0181304,713,9869369,5,9868676,-20,-25
II,-,9866389,1.0,0.5,1,0,1,1,1,gene,C08H9.9,0,9866388,None,172,9866561,1,9866314,75,74
II,-,9864322,1.0,0.5,1,0,1,1,2,gene,C08H9.4,1,9864315,0.0121374,910,9865232,7,9864286,36,29
II,-,9859578,1.0,0.5,1,0,1,0,0,gene,C08H9.11,3,9859546,0.00522042,120,9859698,32,9859546,32,0
II,-,9857801,0.5,0.5,2,1,1,1,0,gene,C08H9.12,4,9857772,0.00569926,222,9858023,29,9857772,29,0
II,-,9845253,0.0,0.5,1,1,0,0,1,gene,ZK938.6,3,9845224,0.00137168,1051,9846304,29,9845224,29,0
II,-,9841949,0.0128205,0.0,234,231,3,3,13,gene,ZK938.7,0,9841936,0.215997,1344,9843293,13,9841936,13,0
II,-,9838218,0.0,2.8026e-45,148,148,0,0,1,gene,ZK938.2,0,9838217,0.424722,886,9839104,1,9838217,1,0
II,-,9838153,0.0,0.03125,5,5,0,0,46,gene,ZK938.2,0,9838098,0.424722,951,9839104,55,9838217,-64,-119
II,-,9782409,0.75,0.25,4,1,3,2,13,gene,T10B9.8,0,9782352,0.0139109,879,9783288,57,9781865,544,487
II,-,9775798,0.0,2.38419e-07,22,22,0,0,0,gene,T10B9.9,0,9775791,0.156704,3303,9779101,7,9775798,0,-7
II,-,9773802,0.00373832,0.0,535,533,2,2,2,gene,ZK1321.4,0,9773792,1.91544,1237,9775039,10,9773799,3,-7
II,-,9769762,0.00814111,0.0,737,731,6,6,4,gene,ZK1321.3,0,9769756,2.54313,906,9770668,6,9769762,0,-6
II,-,9752232,0.0,7.88861e-31,100,100,0,0,4,gene,Y53C12B.7,0,9752219,0.371859,16130,9768362,13,9752219,13,0
II,-,9745987,0.0,0.0,472,472,0,0,4,gene,Y53C12B.1,1,9745982,0.547541,4341,9750328,5,9745982,5,0
II,-,9742799,0.964583,0.0,2880,102,2778,1627,1,gene,Y53C12B.2,2,9742788,4.51155,99,9742898,11,9742799,0,-11
II,-,9716382,0.210573,0.0,1135,896,239,194,1,gene,Y53C12A.1,2,9716377,1.07892,835,9717217,5,9716382,0,-5
II,-,9708800,0.00609756,0.0,164,163,1,1,0,gene,Y53C12A.2,0,9708795,0.232451,4850,9713650,5,9708800,0,-5
II,-,9706155,0.00329218,0.0,1215,1211,4,4,0,gene,Y53C12A.3,1,9706153,0.71749,246,9706401,2,9706155,0,-2
II,-,9704702,0.933628,1.4013e-45,226,15,211,136,7,gene,Y53C12A.10,2,9704695,None,95,9704797,7,9704695,7,0
II,-,9703645,0.0,0.25,2,2,0,0,8,gene,Y53C12A.4,3,9703614,1.24911,82,9703727,31,9703616,29,-2
II,-,9703616,0.972632,0.0,475,13,462,335,156,gene,Y53C12A.4,3,9703614,1.24911,111,9703727,2,9703616,0,-2
II,-,9703605,1.0,0.5,1,0,1,1,987,gene,Y53C12A.4,3,9703550,1.24911,122,9703727,55,9703616,-11,-66
II,-,9691854,0.00229885,0.0,870,868,2,1,2,gene,ZK1320.10,0,9691801,1.83367,6338,9698192,53,9691854,0,-53
II,-,9686628,0.00484966,0.0,1031,1026,5,4,9,gene,ZK1320.9,0,9686626,1.92651,2952,9689580,2,9686628,0,-2
II,-,9665584,0.0,0.125,3,3,0,0,0,gene,ZK1320.5,0,9665579,0.0211082,18419,9684003,5,9665579,5,0
II,-,9660353,0.0,0.00195312,9,9,0,0,3,gene,ZK1320.3,0,9660330,6.29339,405,9660758,23,9660334,19,-4
II,-,9660334,0.00178571,0.0,2800,2795,5,3,230,gene,ZK1320.3,0,9660330,6.29339,424,9660758,4,9660334,0,-4
II,-,9658917,0.00247302,0.0,4448,4437,11,9,164,gene,ZK1320.2,0,9658913,7.03403,241,9659158,4,9658917,0,-4
II,-,9655333,0.0,0.0,323,323,0,0,1,gene,ZK1307.1,0,9655324,3.57123,2456,9657789,9,9655333,0,-9
II,-,9644381,0.0047081,0.0,1062,1057,5,5,1,gene,ZK1307.6,0,9644339,1.53368,6490,9650871,42,9644381,0,-42
II,-,9624091,0.00479233,0.0,626,623,3,2,3,gene,T15H9.7,0,9624085,1.17457,16001,9640092,6,9624091,0,-6
II,-,9619158,0.00117925,0.0,848,847,1,1,1,gene,T15H9.7,0,9619141,1.17457,20934,9640092,17,9619158,0,-17
II,-,9617040,0.0147059,2.30393e-19,68,67,1,1,3,gene,T15H9.2,0,9617038,0.289207,294,9617334,2,9617038,2,0
II,-,9609347,0.0,2.64698e-23,75,75,0,0,3,gene,T15H9.6,0,9609310,0.0894834,1246,9610593,37,9609310,37,0
II,-,9605162,0.0,2.38419e-07,22,22,0,0,1,gene,E02H1.7,0,9605156,0.488672,2285,9607447,6,9605162,0,-6
II,-,9591078,0.00490196,0.0,204,203,1,1,24,gene,E02H1.1,1,9591061,0.890167,7018,9598096,17,9591078,0,-17
II,-,9589675,0.994253,0.0,348,2,346,246,91,gene,E02H1.2,2,9589675,0.502941,103,9589778,0,9589675,0,0
II,-,9586698,0.0,0.0,980,980,0,0,7,gene,F35H8.6,0,9586691,1.05355,1413,9588111,7,9586698,0,-7
II,-,9583468,0.0,0.00195312,9,9,0,0,3,gene,F35H8.7,0,9583462,0.0268855,826,9584294,6,9583462,6,0
II,-,9560018,0.0,0.5,1,1,0,0,0,gene,F35H8.4,0,9559854,0.454518,21619,9581637,164,9559854,164,0
II,-,9549621,0.0,0.25,2,2,0,0,3,gene,AH6.10,0,9549613,0.00728468,2128,9551749,8,9549613,8,0
II,-,9547565,0.0,0.25,2,2,0,0,0,gene,AH6.9,0,9547561,None,759,9548324,4,9547561,4,0
II,-,9487300,0.00184587,0.0,2167,2163,4,3,5,gene,T19H5.4,0,9487270,1.25532,15370,9502670,30,9487300,0,-30
II,-,9471845,0.0,0.5,1,1,0,0,0,gene,T19H5.5,0,9471837,None,757,9472602,8,9471837,8,0
II,-,9466108,0.0,3.46945e-18,58,58,0,0,6,gene,R09D1.10,0,9466099,0.119034,709,9466817,9,9466108,0,-9
II,-,9461719,0.0,0.5,1,1,0,0,5,gene,R09D1.8,0,9461699,0,1421,9463140,20,9461885,-166,-186
II,-,9452183,0.0,4.54747e-13,41,41,0,0,4,gene,R09D1.12,0,9452176,0.0665227,429,9452612,7,9452263,-80,-87
II,-,9438010,0.0,0.00195312,9,9,0,0,3,gene,M176.8,0,9438002,0.295556,516,9438526,8,9438115,-105,-113
II,-,9436023,0.0,1.35525e-20,66,66,0,0,0,gene,M176.7,1,9435998,0.235413,557,9436580,25,9436023,0,-25
II,-,9435979,0.0,0.5,1,1,0,0,18,gene,M176.7,1,9435976,0.235413,601,9436580,3,9436023,-44,-47
II,-,9433592,0.0,0.25,2,2,0,0,7,gene,M176.6,2,9433539,0.138774,343,9433935,53,9433566,26,-27
II,-,9427604,0.011236,1.43787e-25,89,88,1,0,28,gene,M176.5,0,9427600,0.758429,3693,9431297,4,9427650,-46,-50
II,-,9416347,0.00194553,0.0,514,513,1,1,1,gene,M176.2,0,9416346,1.10968,6884,9423231,1,9416347,0,-1
II,-,9397457,0.0,0.5,1,1,0,0,7,gene,Y51B9A.9,0,9397450,0.128764,290,9397747,7,9397466,-9,-16
II,-,9381270,0.0,0.03125,5,5,0,0,5,gene,C06C3.5,0,9381251,None,4729,9385999,19,9381251,19,0
II,-,9381262,0.0,1.16415e-10,33,33,0,0,12,gene,C06C3.5,0,9381251,None,4737,9385999,11,9381251,11,0
II,-,9376220,0.0,1.32349e-23,76,76,0,0,8,gene,C06C3.10,0,9376209,None,3694,9379914,11,9376209,11,0
II,-,9372407,0.0,0.5,1,1,0,0,0,gene,C06C3.3,0,9372366,0.0210496,3369,9375776,41,9372287,120,79
II,-,9352647,0.00415282,0.0,1204,1199,5,5,69,gene,F42A8.2,0,9352647,7.53311,16445,9369092,0,9352647,0,0
II,-,9322830,0.00175439,0.0,570,569,1,1,4,gene,D2013.1,0,9322825,0.775441,18487,9341317,5,9322825,5,0
II,-,9310219,0.0,0.0,395,395,0,0,0,gene,C01G6.8,0,9310217,1.78753,7260,9317479,2,9310217,2,0
II,-,9304769,0.0,0.0,155,155,0,0,2,gene,C01G6.8,0,9304737,1.78753,12710,9317479,32,9304737,32,0
II,-,9304738,0.0,0.0,504,504,0,0,35,gene,C01G6.8,0,9304737,1.78753,12741,9317479,1,9304737,1,0
II,-,9298891,0.0,0.00012207,13,13,0,0,0,gene,C01G6.8,0,9298891,1.78753,18588,9317479,0,9298888,3,3
II,-,9280013,0.0145985,0.0,411,405,6,6,7,gene,C01G6.5,1,9280004,2.0342,13940,9293953,9,9280013,0,-9
II,-,9272957,0.453752,0.00287408,573,313,260,213,4,gene,C01G6.4,2,9272939,1.9259,1872,9274829,18,9272957,0,-18
II,-,9261894,0.00274941,0.0,7638,7617,21,17,4,gene,C01G6.1,0,9261888,20.0607,9309,9271203,6,9261894,0,-6
II,-,9252941,0.00408719,0.0,734,731,3,3,0,gene,H32K21.1,0,9252941,1.24752,6019,9258960,0,9252941,0,0
II,-,9246663,0.0,5.55112e-17,54,54,0,0,248,gene,T26C5.5,0,9246633,0.41494,2303,9248966,30,9246663,0,-30
II,-,9227120,0.333333,0.375,3,2,1,1,578,gene,ZK1067.7,0,9227071,5.9689,18701,9245821,49,9227147,-27,-76
II,-,9188394,0.0,0.00195312,9,9,0,0,2,gene,ZK1067.6,0,9188281,1.09715,2713,9191107,113,9188394,0,-113
II,-,9177065,0.0120482,0.0,166,164,2,1,0,gene,T23G7.4,1,9177060,0.640875,1362,9178427,5,9177065,0,-5
II,-,9172838,0.951923,4.5341e-24,104,5,99,65,18,gene,T23G7.2,2,9172838,0.479868,234,9173072,0,9172838,0,0
II,-,9167743,0.968862,0.0,835,26,809,396,1,gene,T23G7.3,3,9167713,3.3418,102,9167845,30,9167743,0,-30
II,-,9108470,0.0130719,0.0,306,302,4,4,28,gene,T24H10.3,1,9108460,1.34873,54890,9163360,10,9108476,-6,-16
II,-,9107057,0.893494,0.0,2075,221,1854,1272,3,gene,T24H10.6,2,9107057,3.84226,236,9107293,0,9107057,0,0
II,-,9098515,0.00306748,0.0,652,650,2,2,0,gene,C07H4.2,0,9098509,0.924272,7911,9106426,6,9098758,-243,-249
II,-,9092060,0.0,1.13687e-13,43,43,0,0,4,gene,C07H4.1,0,9092059,0.421569,2184,9094244,1,9092044,16,15
II,-,9070817,0.00662252,5.32493e-44,151,150,1,1,11,gene,T24B8.4,0,9070753,0.683043,11777,9082594,64,9070753,64,0
II,-,9061050,0.00272851,0.0,15393,15351,42,29,2,gene,T24B8.3,0,9061015,8.15959,2533,9063583,35,9061015,35,0
II,-,9057069,0.0,0.0078125,7,7,0,0,2,gene,T24B8.1,0,9057025,115.497,2228,9059297,44,9057024,45,1
II,-,9056998,0.00317289,0.0,53894,53723,171,162,175,gene,T24B8.1,0,9056993,115.497,2299,9059297,5,9056998,0,-5
II,-,9041319,0.919343,0.0,1339,108,1231,1013,4,gene,F37B12.3,2,9041319,1.70772,108,9041427,0,9041319,0,0
II,-,9041306,0.75,0.25,4,1,3,3,2191,gene,F37B12.3,2,9041262,1.70772,121,9041427,44,9041319,-13,-57
II,-,9038214,0.623264,7.1539e-10,576,217,359,288,5,gene,F37B12.2,3,9038213,1.48971,1519,9039733,1,9038214,0,-1
II,-,9029173,0.0,2.71051e-20,65,65,0,0,1,gene,F37B12.1,0,9029170,0.294144,6300,9035473,3,9029170,3,0
II,-,9009103,0.0,0.0,162,162,0,0,0,gene,F44G4.8,0,9008935,0.735006,17758,9026861,168,9009103,0,-168
II,-,9007971,0.0,2.38419e-07,22,22,0,0,2,gene,F44G4.8,0,9007904,0.735006,18890,9026861,67,9007971,0,-67
II,-,9001705,0.0,3.23117e-27,88,88,0,0,0,gene,F44G4.6,0,9001700,0.220978,773,9002478,5,9001700,5,0
II,-,8989456,0.0101868,0.0,589,583,6,5,1,gene,C18E9.9,0,8989450,1.89603,7484,8996940,6,8989456,0,-6
II,-,8987955,1.0,0.5,1,0,1,1,0,gene,C18E9.8,0,8987933,0.172272,311,8988266,22,8987972,-17,-39
II,-,8982693,0.0,8.07794e-28,90,90,0,0,2,gene,C18E9.7,0,8982677,0.18089,3119,8985812,16,8982590,103,87
II,-,8973478,0.00617871,0.0,2104,2091,13,10,117,gene,C18E9.6,0,8973478,2.44819,5014,8978492,0,8973478,0,0
II,-,8969238,0.00369004,0.0,271,270,1,1,9,gene,C18E9.3,0,8969206,1.19306,2631,8971869,32,8969238,0,-32
II,-,8964803,0.00464103,0.0,10558,10509,49,41,8,gene,C18E9.4,1,8964802,11.1829,2031,8966834,1,8964803,0,-1
II,-,8964059,0.875817,3.78351e-44,306,38,268,176,0,gene,C18E9.10,2,8964056,0.913119,96,8964155,3,8964056,3,0
II,-,8947601,0.00740741,3.09945e-39,135,134,1,0,2,gene,T21B10.6,0,8947497,0.444986,7549,8955150,104,8947602,-1,-105
II,-,8940365,0.0129032,0.0,310,306,4,4,0,gene,T21B10.5,0,8940365,1.07151,2175,8942540,0,8940401,-36,-36
II,-,8909967,0.0,0.25,2,2,0,0,0,gene,B0457.3,0,8909954,None,859,8910826,13,8909908,59,46
II,-,8884247,0.05,5.93914e-23,100,95,5,4,56,gene,T07D4.5,1,8884244,None,24534,8908781,3,8884265,-18,-21
II,-,8883574,1.0,0.0,211,0,211,163,1,gene,T07D4.3,2,8883574,0.915389,104,8883678,0,8883574,0,0
II,-,8873857,0.0,4.93038e-32,104,104,0,0,7,gene,T07D4.2,0,8873855,0.254103,4553,8878410,2,8873855,2,0
II,-,8873313,0.0,6.10352e-05,14,14,0,0,1,gene,T07D4.2,0,8873310,0.254103,5097,8878410,3,8873313,0,-3
II,-,8871869,0.0,0.000244141,12,12,0,0,0,gene,T07D4.2,0,8871862,0.254103,6541,8878410,7,8871862,7,0
II,-,8865086,0.0,3.72529e-09,28,28,0,0,0,gene,T07D4.1,0,8865086,0.0591574,4382,8869468,0,8865098,-12,-12
II,-,8852011,0.0,1.61559e-27,89,89,0,0,2,gene,T14D7.2,0,8852011,1.35002,6968,8858979,0,8852011,0,0
II,-,8844430,0.0,1.65436e-24,79,79,0,0,4,gene,F46C5.6,0,8844401,0.219699,4287,8848717,29,8844430,0,-29
II,-,8829203,0.00250627,0.0,399,398,1,0,2,gene,F46C5.2,0,8829157,0.445603,10911,8840114,46,8829203,0,-46
II,-,8810648,0.0121681,0.0,904,893,11,11,0,gene,F46C5.9,1,8810640,1.24226,6862,8817510,8,8810648,0,-8
II,-,8808501,0.912014,0.0,591,52,539,473,21,gene,F07H5.10,2,8808501,0.351712,54,8808555,0,8808501,0,0
II,-,8794080,0.0,9.86076e-32,103,103,0,0,0,gene,F07H5.7,0,8794074,0.220617,10677,8804757,6,8794074,6,0
II,-,8758552,0.0,5.73972e-42,137,137,0,0,3,gene,K08F8.3,0,8758537,0.403885,4035,8762587,15,8758552,0,-15
II,-,8755181,0.0,0.000244141,12,12,0,0,4,gene,K08F8.7,0,8755168,0.119662,1032,8756213,13,8755151,30,17
II,-,8737664,0.0,0.25,2,2,0,0,1,gene,T01B7.8,0,8737614,0.217844,16325,8753989,50,8737478,186,136
II,-,8726725,0.0153846,1.76183e-18,65,64,1,1,0,gene,T01B7.9,0,8726709,0.255956,9926,8736651,16,8726704,21,5
II,-,8716206,0.00817996,0.0,489,485,4,3,2,gene,T01B7.4,1,8716205,1.15862,594,8716800,1,8716206,0,-1
II,-,8714938,0.922807,0.0,285,22,263,175,0,gene,T01B7.3,2,8714933,0.767607,113,8715051,5,8714938,0,-5
II,-,8702133,0.0,0.5,1,1,0,0,2,gene,C34C6.5,1,8702040,0.430133,1125,8703258,93,8701593,540,447
II,-,8701522,0.0,3.55271e-15,48,48,0,0,6,gene,C34C6.5,1,8701485,0.430133,1736,8703258,37,8701522,0,-37
II,-,8701479,0.0,0.0,159,159,0,0,16,gene,C34C6.5,1,8701443,0.430133,1779,8703258,36,8701479,0,-36
II,-,8698853,0.677083,2.77892e-07,192,62,130,91,4,gene,C34C6.4,2,8698851,0.578434,73,8698926,2,8698853,0,-2
II,-,8684846,0.0,5.68434e-14,44,44,0,0,3,gene,C34C6.2,0,8684836,0.490832,9504,8694350,10,8684869,-23,-33
II,-,8683218,0.00298507,0.0,335,334,1,1,1,gene,C34C6.2,0,8683210,0.490832,11132,8694350,8,8683200,18,10
II,-,8677815,0.0,5.82077e-11,34,34,0,0,3,gene,D2085.5,0,8677815,1.14596,1452,8679267,0,8677803,12,12
II,-,8676561,0.0,0.0625,4,4,0,0,2,gene,D2085.5,0,8676309,1.14596,2706,8679267,252,8676795,-234,-486
II,-,8674930,0.0,0.5,1,1,0,0,4,gene,D2085.5,0,8674930,1.14596,4337,8679267,0,8674930,0,0
II,-,8637634,0.0103093,0.0,194,192,2,1,1,gene,T22C8.8,0,8637597,0.929713,22073,8659707,37,8637597,37,0
II,-,8621900,0.0217391,8.45356e-25,92,90,2,0,0,gene,T22C8.3,0,8621898,0.192139,468,8622368,2,8621898,2,0
II,-,8617534,0.0,2.1684e-19,62,62,0,0,0,gene,T22C8.2,0,8617460,0.119722,2782,8620316,74,8617527,7,-67
II,-,8610036,0.0,0.03125,5,5,0,0,2,gene,F28C6.9,0,8610034,0.0164515,4435,8614471,2,8610034,2,0
II,-,8600048,0.9,0.00976562,10,1,9,6,57,gene,F28C6.4,2,8599986,0.233723,325,8600373,62,8600189,-141,-203
II,-,8599241,0.930233,6.07661e-18,86,6,80,59,2,gene,F28C6.4,2,8599146,0.233723,614,8599855,95,8599241,0,-95
II,-,8585010,0.0,0.0,289,289,0,0,4,gene,F54C9.11,0,8584982,0.431154,11199,8596209,28,8584974,36,8
II,-,8566781,0.00363769,0.0,2749,2739,10,6,8,gene,F54C9.3,2,8566780,8.02955,1169,8567950,1,8566781,0,-1
II,-,8566063,0.0625,4.20152e-27,128,120,8,4,2,gene,F54C9.2,3,8566048,1.0004,376,8566439,15,8566063,0,-15
II,-,8561432,0.0,0.000976562,10,10,0,0,3,gene,F54C9.1,0,8561325,52.2651,2205,8563637,107,8561276,156,49
II,-,8560888,0.0016323,0.0,30019,29970,49,39,2,gene,F54C9.1,0,8560879,52.2651,2749,8563637,9,8560888,0,-9
II,-,8548557,0.0,0.000244141,12,12,0,0,0,gene,W01C9.5,0,8548552,0.123851,10754,8559311,5,8548552,5,0
II,-,8534323,0.0,0.03125,5,5,0,0,8,gene,W01C9.1,0,8534312,0.0659597,12943,8547266,11,8534287,36,25
II,-,8534026,0.0,0.03125,5,5,0,0,12,gene,W01C9.1,0,8534011,0.0659597,13240,8547266,15,8534287,-261,-276
II,-,8531146,0.0,0.0,167,167,0,0,0,gene,T13H5.6,0,8531114,0.496865,1873,8533019,32,8531146,0,-32
II,-,8525320,0.00273038,0.0,1465,1461,4,3,14,gene,T13H5.4,0,8525318,1.33325,1403,8526723,2,8525320,0,-2
II,-,8525233,1.0,0.5,1,0,1,0,128,gene,T13H5.4,0,8525176,1.33325,1490,8526723,57,8525320,-87,-144
II,-,8508972,0.125,0.03125,8,7,1,1,0,gene,T13H5.1,0,8508940,0.406708,14445,8523417,32,8508889,83,51
II,-,8501656,0.0,2.38419e-07,22,22,0,0,2,gene,T13H5.1,0,8501656,0.406708,21761,8523417,0,8501656,0,0
II,-,8499686,0.0,1.52588e-05,16,16,0,0,3,gene,T13H5.1,0,8499685,0.406708,23731,8523417,1,8499685,1,0
II,-,8483193,0.00951087,0.0,1472,1458,14,11,63,gene,M05D6.6,1,8483188,4.0344,2889,8486082,5,8483193,0,-5
II,-,8482140,0.686734,4.17577e-30,897,281,616,321,4,gene,M05D6.5,2,8482118,1.7932,160,8482300,22,8482140,0,-22
II,-,8482099,0.692308,0.0872803,13,4,9,7,506,gene,M05D6.5,2,8482094,1.7932,201,8482300,5,8482140,-41,-46
II,-,8480402,0.0113636,2.84343e-25,88,87,1,0,2,gene,M05D6.4,3,8480397,1.15161,7,8480409,5,8480402,0,-5
II,-,8471409,0.5,0.5,2,1,1,1,0,gene,M05D6.8,0,8471329,0.027584,951,8472360,80,8471148,261,181
II,-,8446755,0.0042735,0.0,234,233,1,1,2,gene,F22B5.3,0,8446754,2.48085,6426,8453181,1,8446755,0,-1
II,-,8434949,0.0,0.5,1,1,0,0,2,gene,F14E5.6,0,8434941,0.0191777,322,8435271,8,8435029,-80,-88
II,-,8431854,0.0,7.88861e-31,100,100,0,0,0,gene,F14E5.4,0,8431837,0.142339,810,8432664,17,8431854,0,-17
II,-,8428779,0.00790514,0.0,759,753,6,5,1,gene,F14E5.2,0,8428762,2.10961,1105,8429884,17,8428779,0,-17
II,-,8404772,0.0,0.0,590,590,0,0,1,gene,F49E12.1,0,8404768,0.662961,19106,8423878,4,8404768,4,0
II,-,8399082,0.00772911,0.0,2717,2696,21,17,1,gene,F49E12.2,0,8399078,4.55299,1141,8400223,4,8399078,4,0
II,-,8396063,0.0,0.03125,5,5,0,0,1,gene,F49E12.7,0,8396052,0.0195657,2036,8398099,11,8396052,11,0
II,-,8369083,0.0,1.49012e-08,26,26,0,0,0,gene,M195.3,0,8369055,0.0845943,23410,8392493,28,8369083,0,-28
II,-,8369076,0.0,0.03125,5,5,0,0,5,gene,M195.3,0,8369055,0.0845943,23417,8392493,21,8369083,-7,-28
II,-,8354625,0.0,0.0,176,176,0,0,5,gene,C26D10.6,0,8354595,0.35802,3526,8358151,30,8354625,0,-30
II,-,8354619,0.0,0.0625,4,4,0,0,28,gene,C26D10.6,0,8354595,0.35802,3532,8358151,24,8354625,-6,-30
II,-,8328795,0.00975244,0.0,2666,2640,26,22,1,gene,C26D10.2,0,8328794,12.2309,21665,8350460,1,8328795,0,-1
II,-,8324977,0.047812,0.0,1234,1175,59,51,4,gene,C26D10.1,0,8324975,1.72698,1800,8326777,2,8324977,0,-2
II,-,8320222,0.142857,0.0546875,7,6,1,1,0,gene,F14F11.1,0,8320222,0.26399,2309,8322531,0,8320222,0,0
II,-,8319087,0.0,9.53674e-07,20,20,0,0,0,gene,F14F11.1,0,8319074,0.26399,3444,8322531,13,8319087,0,-13
II,-,8317678,0.0,3.8147e-06,18,18,0,0,1,gene,F14F11.1,0,8317674,0.26399,4853,8322531,4,8317674,4,0
II,-,8315642,0.0,0.25,2,2,0,0,1,gene,F14F11.1,0,8315625,0.26399,6889,8322531,17,8315642,0,-17
II,-,8310529,0.0,0.0,153,153,0,0,2,gene,F14F11.1,0,8310523,0.26399,12002,8322531,6,8310529,0,-6
II,-,8295319,0.00331785,0.0,1507,1502,5,2,3,gene,F14F11.2,0,8295277,3.06081,10352,8305671,42,8295321,-2,-44
II,-,8283133,0.00922509,0.0,1084,1074,10,9,2,gene,K01C8.9,0,8283113,2.74131,11623,8294756,20,8283133,0,-20
II,-,8278440,0.853881,0.0,876,128,748,532,6,gene,K01C8.6,0,8278439,1.22242,2311,8280751,1,8278440,0,-1
II,-,8275946,0.0125,8.40779e-45,160,158,2,2,0,gene,K01C8.5,0,8275944,0.335743,1510,8277456,2,8275946,0,-2
II,-,8259061,0.00763359,4.81218e-38,131,130,1,0,4,gene,F35C11.6,0,8259055,0.27701,8092,8267153,6,8259055,6,0
II,-,8216556,0.0,0.25,2,2,0,0,1,gene,M110.3,0,8216540,0.839848,27620,8244176,16,8216476,80,64
II,-,8208274,0.0,0.25,2,2,0,0,0,gene,M110.8,0,8208273,0.0442373,2311,8210585,1,8208273,1,0
II,-,8190468,0.0,0.0078125,7,7,0,0,1,gene,T05C12.8,0,8190452,0.0720914,1223,8191691,16,8190452,16,0
II,-,8184944,0.00552486,0.0,543,540,3,3,7,gene,T05C12.6,0,8184931,0.82523,2593,8187537,13,8184931,13,0
II,-,8180304,0.0,0.000244141,12,12,0,0,3,gene,T05C12.4,0,8180299,0.0712753,1939,8182243,5,8180304,0,-5
II,-,8170326,0.0,0.015625,6,6,0,0,5,gene,T05C12.11,0,8170319,0.10046,1826,8172152,7,8170281,45,38
II,-,8162093,0.00135135,0.0,740,739,1,1,28,gene,F10B5.6,0,8162092,0.866717,6454,8168547,1,8162093,0,-1
II,-,8156866,0.0,5.29396e-23,74,74,0,0,1,gene,F10B5.4,0,8156860,0.0756069,2922,8159788,6,8156860,6,0
II,-,8149953,0.0,1.77636e-15,49,49,0,0,2,gene,F10B5.3,0,8149938,0.449377,4062,8154015,15,8149953,0,-15
II,-,8143242,0.0,0.00195312,9,9,0,0,52,gene,F10B5.8,0,8143220,1.09286,3341,8146583,22,8143320,-78,-100
II,-,8136839,0.00100705,0.0,993,992,1,1,22,gene,C41C4.7,0,8136838,1.20228,4247,8141086,1,8136839,0,-1
II,-,8124826,0.00759494,0.0,395,392,3,3,2,gene,C41C4.4,0,8124802,0.730431,9834,8134660,24,8124763,63,39
II,-,8106705,0.0,0.5,1,1,0,0,3,gene,C41C4.1,0,8106637,0.0401589,2157,8108862,68,8106890,-185,-253
II,-,8104975,0.0155039,1.21311e-35,129,127,2,2,23,gene,C41C4.10,0,8104974,1.2494,561,8105536,1,8104975,0,-1
II,-,8092677,0.0,5.16988e-26,84,84,0,0,4,gene,K02C4.4,0,8092612,0.672213,7619,8100296,65,8092677,0,-65
II,-,8070611,0.0143369,0.0,279,275,4,4,0,gene,T05H10.7,0,8070609,1.54933,10100,8080711,2,8070611,0,-2
II,-,8038088,0.910987,0.0,719,64,655,458,36,gene,C08B11.9,2,8038088,1.36626,106,8038194,0,8038090,-2,-2
II,-,8037269,0.941026,0.0,390,23,367,299,18,gene,C08B11.6,3,8037269,1.38626,95,8037364,0,8037269,0,0
II,-,8035690,0.969582,0.0,526,16,510,352,2,gene,C08B11.5,4,8035690,2.62618,69,8035759,0,8035690,0,0
II,-,8032632,0.0,0.0,304,304,0,0,31,gene,C08B11.4,0,8032626,0.983266,1626,8034258,6,8032632,0,-6
II,-,8027680,0.00411523,0.0,486,484,2,2,0,gene,C08B11.3,1,8027666,1.85125,1196,8028876,14,8027680,0,-14
II,-,8022485,0.902439,2.62829e-28,164,16,148,96,3,gene,C08B11.2,2,8022470,0.457712,93,8022578,15,8022485,0,-15
II,-,7946804,0.0,3.55271e-15,48,48,0,0,7,gene,ZK669.5,0,7946800,0.286283,48702,7995506,4,7946800,4,0
II,-,7945130,0.00118906,0.0,841,840,1,0,40,gene,ZK669.4,0,7945099,2.24883,294,7945424,31,7945130,0,-31
II,-,7928618,0.0,2.27374e-13,42,42,0,0,1,gene,ZK669.7,0,7928579,0.228096,7898,7936516,39,7928579,39,0
II,-,7907513,0.0,1.86265e-09,29,29,0,0,0,gene,ZK675.3,0,7907510,None,4438,7911951,3,7907510,3,0
II,-,7879239,0.00584112,0.0,856,851,5,3,34,gene,T01H3.1,1,7879236,9.37274,25317,7904556,3,7879239,0,-3
II,-,7877937,0.333333,0.234375,6,4,2,1,26,gene,T01H3.2,2,7877911,0.446081,59,7877996,26,7877917,20,-6
II,-,7877917,0.944444,1.3769e-12,54,3,51,27,20,gene,T01H3.2,2,7877911,0.446081,79,7877996,6,7877917,0,-6
II,-,7873837,0.0357143,1.04308e-07,28,27,1,1,1,gene,T01H3.3,0,7873804,1.08622,335,7874172,33,7873816,21,-12
II,-,7873816,0.0183486,0.0,1308,1284,24,20,71,gene,T01H3.3,0,7873804,1.08622,356,7874172,12,7873816,0,-12
II,-,7873663,0.0,6.10352e-05,14,14,0,0,168,gene,T01H3.3,0,7873618,1.08622,509,7874172,45,7873816,-153,-198
II,-,7873657,0.1,0.00976562,10,9,1,0,182,gene,T01H3.3,0,7873618,1.08622,515,7874172,39,7873816,-159,-198
II,-,7870084,0.177778,2.52458e-28,270,222,48,41,1,gene,T09A5.12,0,7870075,0.82178,718,7870802,9,7870084,0,-9
II,-,7855642,0.911141,0.0,754,67,687,444,4,gene,T09A5.7,2,7855640,1.82103,98,7855740,2,7855642,0,-2
II,-,7855472,0.8,0.0439453,10,2,8,6,223,gene,T09A5.7,2,7855464,1.82103,268,7855740,8,7855642,-170,-178
II,-,7854963,0.882068,0.0,619,73,546,394,2,gene,T09A5.6,3,7854963,0.516656,45,7855008,0,7854963,0,0
II,-,7853702,0.958272,0.0,1366,57,1309,930,5,gene,T09A5.5,4,7853702,1.30409,99,7853801,0,7853702,0,0
II,-,7835065,0.0058651,0.0,341,339,2,2,35,gene,T09A5.1,0,7835063,0.729314,10489,7845554,2,7835063,2,0
II,-,7794242,0.0,4.76837e-07,21,21,0,0,0,gene,C06A8.9,0,7794242,0.109941,38525,7832767,0,7794242,0,0
II,-,7781155,0.0,0.03125,5,5,0,0,292,gene,C06A8.2,1,7781132,0.754553,3868,7785023,23,7781177,-22,-45
II,-,7781148,0.0,0.03125,5,5,0,0,425,gene,C06A8.2,1,7781132,0.754553,3875,7785023,16,7781177,-29,-45
II,-,7777746,0.630909,1.8362e-10,550,203,347,254,2,gene,C06A8.1,2,7777672,3.90878,1519,7779265,74,7777746,0,-74
II,-,7776428,0.0,0.125,3,3,0,0,10,gene,C06A8.1,2,7776400,3.90878,938,7777366,28,7776428,0,-28
II,-,7769976,0.0,3.38813e-21,68,68,0,0,0,gene,C06A8.8,0,7769828,0.536846,3816,7773792,148,7769976,0,-148
II,-,7769370,0.0,0.5,1,1,0,0,0,gene,C06A8.8,0,7769317,0.536846,4422,7773792,53,7769370,0,-53
II,-,7767705,0.010989,3.67546e-26,91,90,1,1,10,gene,C06A8.8,0,7767702,0.536846,6087,7773792,3,7767705,0,-3
II,-,7758313,0.00675676,0.0,296,294,2,2,228,gene,B0228.7,0,7758301,1.90321,1202,7759515,12,7758313,0,-12
II,-,7755083,0.00483092,0.0,207,206,1,1,6,gene,B0228.6,0,7755079,0.700228,2027,7757110,4,7755079,4,0
II,-,7718508,0.0,1.69407e-21,69,69,0,0,0,gene,B0495.10,0,7718504,0.405474,34046,7752554,4,7718504,4,0
II,-,7714660,0.0,3.63798e-12,38,38,0,0,0,gene,B0495.10,0,7714581,0.405474,37894,7752554,79,7714660,0,-79
II,-,7707398,0.852632,0.0,665,98,567,397,1,gene,B0495.8,2,7707386,1.12669,101,7707499,12,7707386,12,0
II,-,7705150,0.835616,0.0,438,72,366,262,20,gene,B0495.7,3,7705147,2.06548,306,7705456,3,7705150,0,-3
II,-,7698953,0.00383409,0.0,2869,2858,11,11,1079,gene,B0495.6,1,7698950,4.71318,2898,7701851,3,7699095,-142,-145
II,-,7698429,1.0,0.25,2,0,2,2,4,gene,B0495.5,2,7698401,0.447429,87,7698516,28,7698424,5,-23
II,-,7698424,1.0,0.25,2,0,2,2,6,gene,B0495.5,2,7698401,0.447429,92,7698516,23,7698424,0,-23
II,-,7698412,0.96319,2.02993e-39,163,6,157,112,44,gene,B0495.5,2,7698401,0.447429,104,7698516,11,7698412,0,-11
II,-,7693876,0.0186335,2.34017e-43,161,158,3,3,1,gene,B0495.4,0,7693866,0.987976,1977,7695853,10,7693876,0,-10
II,-,7663674,0.00404709,0.0,5436,5414,22,21,9,gene,F18A1.7,1,7663674,4.52421,25953,7689627,0,7663674,0,0
II,-,7662208,0.467626,0.0505745,139,74,65,58,15,gene,F18A1.6,2,7662185,0.63755,415,7662623,23,7662208,0,-23
II,-,7643074,0.0,1.45519e-11,36,36,0,0,2,gene,R153.1,0,7642947,1.56202,7319,7650393,127,7643074,0,-127
II,-,7620453,0.0,4.81482e-35,114,114,0,0,1,gene,R07G3.8,0,7620449,0.794009,6718,7627171,4,7620438,15,11
II,-,7620438,0.0,1.50463e-36,119,119,0,0,258,gene,R07G3.8,0,7620437,0.794009,6733,7627171,1,7620438,0,-1
II,-,7613654,0.00214592,0.0,466,465,1,1,78,gene,R07G3.7,0,7613605,0.970587,4508,7618162,49,7613654,0,-49
II,-,7613594,0.0,0.03125,5,5,0,0,226,gene,R07G3.7,0,7613575,0.970587,4568,7618162,19,7613654,-60,-79
II,-,7598676,0.00706215,0.0,708,703,5,5,0,gene,R07G3.5,0,7598676,2.90506,5445,7604121,0,7598676,0,0
II,-,7594836,0.0,0.0078125,7,7,0,0,3,gene,F35D2.5,0,7594832,0.231435,2628,7597464,4,7594836,0,-4
II,-,7591948,0.0,7.45058e-09,27,27,0,0,0,gene,F35D2.5,0,7591930,0.231435,5516,7597464,18,7591948,0,-18
II,-,7589488,0.0,7.27596e-12,37,37,0,0,1,gene,F35D2.5,0,7589485,0.231435,7976,7597464,3,7589488,0,-3
II,-,7554751,0.0,0.0,1032,1032,0,0,3,gene,ZK1290.14,0,7554749,0.726693,5973,7560724,2,7554768,-17,-19
II,-,7553727,0.0,0.0625,4,4,0,0,2,gene,ZK1290.10,0,7553727,0.0778409,289,7554016,0,7553830,-103,-103
II,-,7534536,0.0,0.0625,4,4,0,0,3,gene,ZK1290.8,0,7534526,3.20792,12207,7546743,10,7534439,97,87
II,-,7534325,0.0,0.00195312,9,9,0,0,177,gene,ZK1290.8,0,7534319,3.20792,12418,7546743,6,7534439,-114,-120
II,-,7525566,0.0,0.25,2,2,0,0,0,gene,ZK1290.7,0,7525523,0.016986,7662,7533228,43,7525484,82,39
II,-,7513901,0.0,3.38813e-21,68,68,0,0,2,gene,C28F5.2,0,7513900,0.127515,4892,7518793,1,7513901,0,-1
II,-,7499412,0.0,0.000488281,11,11,0,0,4,gene,R10H1.2,0,7499403,0.0632579,7638,7507050,9,7499403,9,0
II,-,7493627,0.0,1.05879e-22,73,73,0,0,2,gene,R10H1.5,0,7493571,0.149599,3673,7497300,56,7493571,56,0
II,-,7489398,0.0,0.00390625,8,8,0,0,0,gene,D1022.9,0,7489303,0.129952,1840,7491238,95,7489207,191,96
II,-,7483037,0.0,2.38419e-07,22,22,0,0,3,gene,D1022.8,0,7483019,0.155563,5015,7488052,18,7483037,0,-18
II,-,7478467,0.00477707,0.0,1884,1875,9,7,3,gene,D1022.7,0,7478462,1.14616,2214,7480681,5,7478467,0,-5
II,-,7456175,0.0,0.5,1,1,0,0,32,gene,D1022.3,0,7456140,0.0118285,70,7456245,35,7456140,35,0
II,-,7456170,0.0,0.015625,6,6,0,0,30,gene,D1022.3,0,7456140,0.0118285,1,7456171,30,7456140,30,0
II,-,7411962,0.0,1.05879e-22,73,73,0,0,0,gene,K02A2.5,0,7411836,0.141507,13903,7425865,126,7411962,0,-126
II,-,7402647,0.0,1.32349e-23,76,76,0,0,8,gene,C07D10.4,0,7402638,0.584171,8329,7410976,9,7402638,9,0
II,-,7374103,0.0116959,0.0,1197,1183,14,12,2,gene,F43E2.7,0,7374097,8.08779,5140,7379243,6,7374103,0,-6
II,-,7368241,0.875,0.00183105,16,2,14,6,0,gene,F43E2.6,0,7368235,0.108057,943,7369184,6,7368241,0,-6
II,-,7363971,0.00322061,0.0,621,619,2,2,4,gene,F43E2.5,0,7363964,2.41255,2415,7366386,7,7363971,0,-7
II,-,7356357,0.00826446,0.0,363,360,3,3,1,gene,F43E2.4,0,7356357,0.625294,6789,7363146,0,7356357,0,0
II,-,7352449,0.0150468,0.0,2459,2422,37,29,68,gene,F43E2.8,0,7352405,5.3442,1060,7353509,44,7352449,0,-44
II,-,7330328,0.0,0.5,1,1,0,0,2,gene,F21D12.5,0,7330240,0.0465189,19722,7350050,88,7330133,195,107
II,-,7322845,0.0,0.0,366,366,0,0,3,gene,F21D12.3,0,7322834,0.754846,5847,7328692,11,7322845,0,-11
II,-,7322799,0.0,0.5,1,1,0,0,108,gene,F21D12.3,0,7322753,0.754846,5893,7328692,46,7322845,-46,-92
II,-,7314112,0.0289855,3.97428e-18,69,67,2,1,4,gene,F45E12.6,0,7314100,0.279175,5722,7319834,12,7314100,12,0
II,-,7310037,0.00898693,0.0,1224,1213,11,9,84,gene,F45E12.5,0,7310035,2.72183,3768,7313805,2,7310037,0,-2
II,-,7298180,0.0,0.0,295,295,0,0,0,gene,C30G12.7,1,7298162,0.947232,10450,7308630,18,7298180,0,-18
II,-,7295948,0.986486,3.91753e-21,74,1,73,60,0,gene,C30G12.6,2,7295948,0.262365,104,7296052,0,7295948,0,0
II,-,7253096,0.00287356,0.0,696,694,2,0,19,gene,F32A5.7,0,7253034,1.70514,39051,7292147,62,7253096,0,-62
II,-,7251946,0.00772201,0.0,259,257,2,2,0,gene,F32A5.6,0,7251936,0.470861,219,7252165,10,7251943,3,-7
II,-,7236970,0.0,2.8026e-45,148,148,0,0,57,gene,F32A5.5,0,7236964,1.8637,13175,7250145,6,7236970,0,-6
II,-,7225594,0.0277778,5.23869e-10,36,35,1,1,1,gene,E04F6.11,0,7225581,0.190881,10190,7235784,13,7225581,13,0
II,-,7222987,0.0,1.16415e-10,33,33,0,0,0,gene,E04F6.11,0,7222930,0.190881,12797,7235784,57,7222987,0,-57
II,-,7216917,0.0,0.0078125,7,7,0,0,0,gene,E04F6.10,0,7216890,0.118947,971,7217888,27,7216917,0,-27
II,-,7212092,0.00132587,0.0,6788,6779,9,6,5,gene,E04F6.9,0,7212089,13.0165,1830,7213922,3,7212092,0,-3
II,-,7211313,0.00254453,0.0,2358,2352,6,3,9,gene,E04F6.8,0,7211312,5.13148,245,7211558,1,7211313,0,-1
II,-,7210203,0.0,2.38419e-07,22,22,0,0,4,gene,E04F6.15,0,7210202,0.167964,473,7210676,1,7210205,-2,-3
II,-,7194703,0.00260417,0.0,1920,1915,5,4,12,gene,E04F6.5,0,7194696,1.92248,2628,7197331,7,7194703,0,-7
II,-,7174869,0.0075188,1.22141e-38,133,132,1,1,0,gene,C27H5.8,0,7174811,0.187425,10339,7185208,58,7174871,-2,-60
II,-,7166029,0.0,0.015625,6,6,0,0,0,gene,C27H5.4,0,7166022,0.166776,1416,7167445,7,7165770,259,252
II,-,7165776,0.0,9.31323e-10,30,30,0,0,0,gene,C27H5.4,0,7165770,0.166776,1669,7167445,6,7165770,6,0
II,-,7131964,0.020979,4.2796e-38,143,140,3,3,23,gene,T07F8.4,0,7131948,0.358507,30433,7162397,16,7131966,-2,-18
II,-,7131957,0.0133333,7.83046e-42,150,148,2,0,119,gene,T07F8.4,0,7131948,0.358507,30440,7162397,9,7131966,-9,-18
II,-,7121714,0.0,8.47033e-22,70,70,0,0,5,gene,F10E7.11,0,7121586,0.0843807,8747,7130461,128,7121714,0,-128
II,-,7121704,0.0,5.82077e-11,34,34,0,0,53,gene,F10E7.11,0,7121586,0.0843807,8757,7130461,118,7121714,-10,-128
II,-,7109988,0.00943396,1.30655e-30,106,105,1,0,0,gene,F10E7.9,0,7109942,0.457341,3655,7113643,46,7109989,-1,-47
II,-,7104960,0.00845666,0.0,473,469,4,4,13,gene,F10E7.8,1,7104938,1.08651,1337,7106297,22,7104933,27,5
II,-,7101095,0.961712,0.0,444,17,427,269,2,gene,T02G5.13,2,7101095,1.37178,100,7101195,0,7101095,0,0
II,-,7098525,0.0314961,6.07415e-32,127,123,4,2,0,gene,T02G5.12,0,7098522,0.347655,995,7099520,3,7098525,0,-3
II,-,7072347,0.00882724,0.0,1586,1572,14,13,1,gene,T02G5.9,0,7072321,5.06259,6168,7078515,26,7072347,0,-26
II,-,7069898,0.0,1.00974e-28,93,93,0,0,4,gene,ZK1127.11,0,7069898,0.179522,207,7070105,0,7069898,0,0
II,-,7057892,0.00265781,0.0,1505,1501,4,3,742,gene,ZK1127.10,0,7057875,6.33893,7078,7064970,17,7057892,0,-17
II,-,7050003,0.00314183,0.0,2228,2221,7,6,2,gene,ZK1127.9,0,7050003,1.63701,6100,7056103,0,7050003,0,0
II,-,7022474,0.00263505,0.0,759,757,2,2,0,gene,C52E12.4,1,7022458,0.574732,10413,7032887,16,7022442,32,16
II,-,7012623,0.646766,8.96807e-06,201,71,130,84,11,gene,C52E12.3,2,7012623,1.09663,98,7012721,0,7012623,0,0
II,-,7012577,0.76,0.00527799,25,6,19,15,21,gene,C52E12.3,2,7012568,1.09663,144,7012721,9,7012623,-46,-55
II,-,6977763,0.0,0.00195312,9,9,0,0,0,gene,C15F1.8,0,6977627,0.0652641,32980,7010743,136,6977300,463,327
II,-,6973828,0.0625,0.000244141,16,15,1,1,1,gene,C15F1.7,1,6973813,6.29066,2089,6975917,15,6973825,3,-12
II,-,6973820,0.00132802,0.0,753,752,1,1,9,gene,C15F1.7,1,6973813,6.29066,2097,6975917,7,6973825,-5,-12
II,-,6973789,0.0,0.5,1,1,0,0,423,gene,C15F1.7,1,6973713,6.29066,2128,6975917,76,6973825,-36,-112
II,-,6973434,0.0039704,0.0,5541,5519,22,19,34,gene,C15F1.7,1,6973416,6.29066,2483,6975917,18,6973434,0,-18
II,-,6972583,1.0,0.5,1,0,1,0,4,gene,C15F1.6,2,6972561,6.32191,60,6972643,22,6972170,413,391
II,-,6972192,0.0,0.0625,4,4,0,0,0,gene,C15F1.6,2,6972167,6.32191,451,6972643,25,6972168,24,-1
II,-,6972168,0.644068,1.26754e-32,1652,588,1064,687,23,gene,C15F1.6,2,6972167,6.32191,475,6972643,1,6972168,0,-1
II,-,6969900,0.142857,0.000634193,21,18,3,2,2,gene,C15F1.5,3,6969876,0.151506,704,6970604,24,6969900,0,-24
II,-,6967581,0.0106762,0.0,281,278,3,3,2,gene,C15F1.4,1,6967575,0.597826,273,6967854,6,6967581,0,-6
II,-,6965620,0.938462,1.83512e-14,65,4,61,46,1,gene,C15F1.3,2,6965614,0.46051,111,6965731,6,6965620,0,-6
II,-,6959354,0.0,9.53674e-07,20,20,0,0,6,gene,C15F1.3,2,6959085,0.46051,4803,6964157,269,6959354,0,-269
II,-,6957038,0.0,0.25,2,2,0,0,2,gene,C15F1.3,2,6956904,0.46051,965,6958003,134,6957038,0,-134
II,-,6951233,0.0625,1.15484e-07,32,30,2,2,8,gene,F22D3.6,0,6951232,0.535725,4102,6955335,1,6951233,0,-1
II,-,6938806,0.0,0.125,3,3,0,0,0,gene,F22D3.5,0,6938800,0.002383,8979,6947785,6,6938800,6,0
II,-,6913294,0.00330033,0.0,1212,1208,4,4,8,gene,B0252.4,0,6913293,1.48628,3635,6916929,1,6913293,1,0
II,-,6907221,0.0,5.42101e-20,64,64,0,0,4,gene,B0252.3,0,6907197,0.311736,5250,6912471,24,6907221,0,-24
II,-,6897471,0.0102041,3.09233e-28,98,97,1,1,0,gene,C44B7.11,1,6897462,0.418338,5313,6902784,9,6897462,9,0
II,-,6893568,0.0134048,0.0,746,736,10,4,0,gene,C44B7.12,2,6893566,0.798741,542,6894110,2,6893566,2,0
II,-,6890331,0.067139,0.0,5928,5530,398,338,13,gene,C44B7.10,3,6890330,11.4067,1306,6891637,1,6890331,0,-1
II,-,6887619,0.0,0.03125,5,5,0,0,230,gene,C44B7.9,0,6887582,0.741258,857,6888476,37,6887695,-76,-113
II,-,6883685,0.0,7.88861e-31,100,100,0,0,3,gene,C44B7.8,0,6883668,0.635944,289,6883974,17,6883685,0,-17
II,-,6880089,0.0176991,6.09364e-31,113,111,2,1,36,gene,C44B7.7,0,6880050,0.704013,541,6880630,39,6880098,-9,-48
II,-,6876989,0.00925926,0.0,216,214,2,2,33,gene,C44B7.6,0,6876985,0.336707,2180,6879169,4,6876989,0,-4
II,-,6863684,0.0,7.62939e-06,17,17,0,0,0,gene,C44B7.3,0,6863684,0.11775,5194,6868878,0,6863684,0,0
II,-,6858220,0.00313339,0.0,2234,2227,7,7,54,gene,C04A2.7,0,6858220,2.29729,2296,6860516,0,6858220,0,0
II,-,6800079,0.00226757,0.0,441,440,1,1,9,gene,F31E8.4,0,6800076,1.09529,4878,6804957,3,6800076,3,0
II,-,6754714,0.0,0.000488281,11,11,0,0,0,gene,F41G3.11,0,6754707,0.00976474,5919,6760633,7,6754707,7,0
II,-,6749459,0.00280112,0.0,1071,1068,3,2,23,gene,F41G3.10,0,6749452,1.38741,269,6749728,7,6749459,0,-7
II,-,6744670,0.0,1.45519e-11,36,36,0,0,0,gene,F41G3.17,0,6744667,0.0763387,701,6745371,3,6744667,3,0
II,-,6721604,0.0,1.42109e-14,46,46,0,0,6,gene,T14B4.8,0,6721561,0.235863,8483,6730087,43,6721561,43,0
II,-,6712875,0.00518135,0.0,193,192,1,1,2,gene,T14B4.7,0,6712841,2.60879,7327,6720202,34,6712876,-1,-35
II,-,6712171,0.00392157,0.0,255,254,1,1,4,gene,T14B4.7,0,6711810,2.60879,8031,6720202,361,6712171,0,-361
II,-,6711452,0.0,0.5,1,1,0,0,0,gene,T14B4.7,0,6711412,2.60879,8750,6720202,40,6711452,0,-40
II,-,6705587,0.0128205,2.5808e-22,78,77,1,1,0,gene,C18H9.7,0,6705587,0.490081,4511,6710098,0,6705500,87,87
II,-,6701413,0.0,3.8147e-06,18,18,0,0,30,gene,C18H9.6,0,6701400,0.77795,772,6702185,13,6701569,-156,-169
II,-,6695331,0.0,0.03125,5,5,0,0,1,gene,C18H9.5,0,6695250,0.0834277,5272,6700603,81,6695250,81,0
II,-,6643062,0.00364299,0.0,549,547,2,1,3,gene,T19D12.6,0,6643055,0.869216,4057,6647119,7,6643062,0,-7
II,-,6609310,0.00373134,0.0,268,267,1,1,0,gene,C56C10.12,0,6609303,0.324549,14119,6623429,7,6609303,7,0
II,-,6601077,0.0,0.125,3,3,0,0,3,gene,C56C10.11,1,6601066,0.541004,4110,6605187,11,6601066,11,0
II,-,6598027,0.625,0.000725676,144,54,90,69,0,gene,C56C10.13,2,6598017,0.906662,262,6598289,10,6598017,10,0
II,-,6597488,0.0,9.09495e-13,40,40,0,0,2,gene,C56C10.13,2,6597468,0.906662,801,6598289,20,6597488,0,-20
II,-,6594198,0.954054,0.0,370,17,353,204,1,gene,C56C10.10,3,6594197,0.708425,127,6594325,1,6594197,1,0
II,-,6592298,0.813008,4.73431e-13,123,23,100,75,2,gene,C56C10.9,4,6592296,0.338624,83,6592381,2,6592298,0,-2
II,-,6588602,0.00303911,0.0,22375,22307,68,62,3,gene,C56C10.8,1,6588587,55.7289,2391,6590993,15,6588602,0,-15
II,-,6587516,0.783505,6.30178e-09,97,21,76,58,4,gene,C56C10.7,2,6587425,0.842355,2,6587518,91,6587516,0,-91
II,-,6587429,0.887755,7.00368e-31,196,22,174,131,14,gene,C56C10.7,2,6587425,0.842355,89,6587518,4,6587429,0,-4
II,-,6587328,1.0,0.5,1,0,1,1,1,gene,C56C10.7,2,6587326,0.842355,190,6587518,2,6587328,0,-2
II,-,6586329,0.0,0.5,1,1,0,0,1,gene,C56C10.7,2,6586323,0.842355,1189,6587518,6,6586329,0,-6
II,-,6561391,0.00379507,0.0,527,525,2,1,220,gene,F18C5.10,0,6561390,3.05111,2360,6563751,1,6561391,0,-1
II,-,6519616,0.00358423,0.0,1395,1390,5,5,11,gene,C56E6.3,0,6519609,0.918229,6731,6526347,7,6519609,7,0
II,-,6519586,0.0,9.53674e-07,20,20,0,0,573,gene,C56E6.3,0,6519578,0.918229,6761,6526347,8,6519609,-23,-31
II,-,6519554,0.0,1.13687e-13,43,43,0,0,235,gene,C56E6.3,0,6519486,0.918229,6793,6526347,68,6519609,-55,-123
II,-,6513957,0.0,1.11022e-16,53,53,0,0,2,gene,R05G9R.1,0,6513931,0.151988,3178,6517135,26,6513931,26,0
II,-,6501468,0.00840336,1.79051e-34,119,118,1,1,5,gene,R05G9.3,0,6501466,0.234197,8027,6509495,2,6501466,2,0
II,-,6497660,0.0070922,5.05813e-41,141,140,1,0,3,gene,R05G9.2,0,6497657,1.63638,2686,6500346,3,6497657,3,0
II,-,6489710,0.0131579,0.0,2432,2400,32,28,3,gene,T28D9.10,0,6489702,3.39889,2047,6491757,8,6489710,0,-8
II,-,6482043,0.0,1.19209e-07,23,23,0,0,5,gene,T28D9.7,0,6481992,0.11519,1842,6483885,51,6481992,51,0
II,-,6453340,0.0035524,0.0,563,561,2,2,0,gene,K06A1.5,1,6453337,0.65168,3132,6456472,3,6453340,0,-3
II,-,6449670,0.049505,3.12423e-23,101,96,5,3,13,gene,K06A1.4,2,6449482,0.354103,1298,6450968,188,6449737,-67,-255
II,-,6410230,0.0,0.0,521,521,0,0,0,gene,T25D10.4,0,6410223,1.07344,35848,6446078,7,6410230,0,-7
II,-,6360855,0.357798,1.4194e-29,1526,980,546,464,1378,gene,K10B2.4,2,6360828,3.67232,255,6361110,27,6360908,-53,-80
II,-,6360835,0.0,0.125,3,3,0,0,4053,gene,K10B2.4,2,6360828,3.67232,275,6361110,7,6360908,-73,-80
II,-,6358954,0.0,0.0,289,289,0,0,1,gene,C32D5.12,0,6358950,0.350183,1279,6360233,4,6358954,0,-4
II,-,6351936,0.5375,0.0402536,160,74,86,54,3,gene,C32D5.10,2,6351899,0.493562,544,6352480,37,6351936,0,-37
II,-,6351934,0.0,0.5,1,1,0,0,3,gene,C32D5.10,2,6351899,0.493562,546,6352480,35,6351936,-2,-37
II,-,6351848,0.7,0.117188,10,3,7,4,34,gene,C32D5.10,2,6351830,0.493562,632,6352480,18,6351936,-88,-106
II,-,6347668,0.0477694,0.0,25979,24738,1241,907,51,gene,C32D5.9,3,6347635,39.3379,1487,6349155,33,6347668,0,-33
II,-,6343654,0.412738,1.00622e-15,1994,1171,823,601,3,gene,C32D5.8,0,6343646,5.33841,3259,6346913,8,6343654,0,-8
II,-,6333929,0.117647,0.0010376,17,15,2,2,0,gene,C32D5.6,0,6333915,0.204671,2375,6336304,14,6333915,14,0
II,-,6331241,0.0125392,0.0,319,315,4,4,205,gene,C32D5.5,0,6331238,1.01668,608,6331849,3,6331267,-26,-29
II,-,6321048,0.00692042,0.0,289,287,2,2,7,gene,C32D5.3,0,6321024,0.976199,241,6321289,24,6321048,0,-24
II,-,6309248,0.00995025,0.0,201,199,2,0,0,gene,C29F5.7,0,6309232,0.178354,8787,6318035,16,6309232,16,0
II,-,6290047,0.00234009,0.0,1282,1279,3,3,2,gene,F13H8.7,0,6290041,3.52692,500,6290547,6,6290047,0,-6
II,-,6281052,0.0,4.76837e-07,21,21,0,0,4,gene,F13H8.9,0,6281031,0.100347,3715,6284767,21,6281052,0,-21
II,-,6281000,0.0,0.015625,6,6,0,0,6,gene,F13H8.9,0,6280994,0.100347,3767,6284767,6,6281052,-52,-58
II,-,6267587,0.153846,0.00952148,13,11,2,2,2,gene,F13H8.8,0,6267573,0.0944968,12099,6279686,14,6267573,14,0
II,-,6259919,0.0,0.5,1,1,0,0,49,gene,F13H8.11,0,6259905,0.148861,5639,6265558,14,6259948,-29,-43
II,-,6244202,0.0,0.00012207,13,13,0,0,35,gene,T24H7.5,0,6244192,3.7279,8416,6252618,10,6244184,18,8
II,-,6244194,0.0,2.40741e-35,115,115,0,0,35,gene,T24H7.5,0,6244192,3.7279,8424,6252618,2,6244184,10,8
II,-,6235456,0.00312678,0.0,3518,3507,11,9,3,gene,T24H7.5,0,6235448,3.7279,1317,6236773,8,6235456,0,-8
II,-,6227024,0.0,9.53674e-07,20,20,0,0,2,gene,C30B5.7,0,6227004,0.0654516,7407,6234431,20,6227046,-22,-42
II,-,6208168,0.0,1.32349e-23,76,76,0,0,2,gene,C30B5.5,0,6208161,0.118661,10399,6218567,7,6208139,29,22
II,-,6196895,0.00355872,0.0,843,840,3,2,1,gene,C30B5.4,0,6196889,0.809406,4633,6201528,6,6196889,6,0
II,-,6191346,0.0,1.92593e-34,112,112,0,0,1,gene,F40H3.4,0,6191329,0.1911,4421,6195767,17,6191329,17,0
II,-,6169204,0.0,6.10352e-05,14,14,0,0,2,gene,F40H3.5,0,6169201,0.13343,17699,6186903,3,6169186,18,15
II,-,6161112,0.0,0.000976562,10,10,0,0,4,gene,H35N03.1,0,6161060,0.0450018,4495,6165607,52,6160977,135,83
II,-,6161060,0.0,0.015625,6,6,0,0,6,gene,H35N03.1,0,6161060,0.0450018,4547,6165607,0,6160977,83,83
II,-,6161004,0.0,0.0625,4,4,0,0,7,gene,H35N03.1,0,6160998,0.0450018,4603,6165607,6,6160977,27,21
II,-,6118275,0.0,0.0078125,7,7,0,0,0,gene,C29H12.6,0,6118215,0.502405,38847,6157122,60,6118219,56,-4
II,-,6118219,0.0,9.40395e-38,123,123,0,0,0,gene,C29H12.6,0,6118215,0.502405,38903,6157122,4,6118219,0,-4
II,-,6097480,0.0,9.40395e-38,123,123,0,0,7,gene,F21H12.6,0,6097387,1.50447,1959,6099439,93,6097553,-73,-166
II,-,6061476,0.0625,1.15484e-07,32,30,2,2,0,gene,R12C12.8,0,6061464,0.20215,372,6061848,12,6061032,444,432
II,-,6056693,0.0,0.5,1,1,0,0,0,gene,R12C12.7,0,6056672,1.17987,642,6057335,21,6056345,348,327
II,-,6055942,0.0305677,0.0,687,666,21,19,1,gene,R12C12.7,0,6055942,1.17987,1393,6057335,0,6056345,-403,-403
II,-,6047685,0.00409836,0.0,244,243,1,1,61,gene,R12C12.6,0,6047680,1.16901,7243,6054928,5,6047750,-65,-70
II,-,6046856,0.0,0.000488281,11,11,0,0,0,gene,R12C12.6,0,6046801,1.16901,8072,6054928,55,6046856,0,-55
II,-,6045083,0.00813008,1.15669e-35,123,122,1,0,139,gene,R12C12.5,0,6045080,1.08534,1159,6046242,3,6045131,-48,-51
II,-,6043223,0.0555556,9.16771e-09,36,34,2,1,64,gene,R12C12.10,0,6043222,0.729705,800,6044023,1,6043222,1,0
II,-,6031164,0.0,1.86265e-09,29,29,0,0,0,gene,R12C12.3,0,6031140,0.0617574,11588,6042752,24,6031140,24,0
II,-,6024937,0.0,0.0,537,537,0,0,41,gene,R12C12.9,0,6024932,1.01065,4512,6029449,5,6024932,5,0
II,-,5990729,0.0,0.03125,5,5,0,0,4,gene,ZK75.3,0,5990671,0.200371,25485,6016214,58,5990707,22,-36
II,-,5974934,0.0,0.03125,5,5,0,0,2,gene,B0034.5,0,5974926,0.0345849,15130,5990064,8,5974926,8,0
II,-,5956644,0.00363196,0.0,826,823,3,2,5,gene,B0034.3,0,5956605,3.93348,11378,5968022,39,5956644,0,-39
II,-,5947276,0.0,2.06795e-25,82,82,0,0,3,gene,B0034.3,0,5947264,3.93348,20746,5968022,12,5947276,0,-12
II,-,5873579,0.00338983,0.0,295,294,1,1,4,gene,F55C12.5,0,5873540,0.927504,916,5874495,39,5873579,0,-39
II,-,5858389,0.0344828,6.84977e-22,87,84,3,1,0,gene,F55C12.4,0,5858375,0.298896,8831,5867220,14,5858389,0,-14
II,-,5858379,0.0,0.00390625,8,8,0,0,214,gene,F55C12.4,0,5858375,0.298896,8841,5867220,4,5858389,-10,-14
II,-,5841069,0.00509626,0.0,3532,3514,18,10,2,gene,ZK1248.16,0,5841068,6.23289,4151,5845220,1,5841069,0,-1
II,-,5838519,0.938776,3.32148e-21,98,6,92,74,20,gene,ZK1248.15,2,5838509,0.475231,113,5838632,10,5838519,0,-10
II,-,5836176,0.0,0.03125,5,5,0,0,0,gene,ZK1248.14,1,5836166,0.751559,568,5836744,10,5836169,7,-3
II,-,5836169,0.0,0.0,155,155,0,0,5,gene,ZK1248.14,1,5836166,0.751559,575,5836744,3,5836169,0,-3
II,-,5833200,0.952229,0.0,314,15,299,225,4,gene,ZK1248.13,2,5833198,0.462666,93,5833293,2,5833198,2,0
II,-,5833188,1.0,0.03125,5,0,5,3,338,gene,ZK1248.13,2,5833182,0.462666,105,5833293,6,5833198,-10,-16
II,-,5828552,0.938776,3.32148e-21,98,6,92,61,0,gene,ZK1248.11,3,5828552,0.797204,100,5828652,0,5828552,0,0
II,-,5827409,0.934911,7.71203e-35,169,11,158,124,4,gene,ZK1248.10,4,5827392,0.687851,142,5827551,17,5827409,0,-17
II,-,5827401,0.904762,0.000100136,21,2,19,14,320,gene,ZK1248.10,4,5827392,0.687851,150,5827551,9,5827409,-8,-17
II,-,5805439,0.00943396,0.0,318,315,3,3,38,gene,K05F1.10,0,5805428,1.11321,4474,5809913,11,5805428,11,0
II,-,5774135,0.0,0.25,2,2,0,0,46,gene,F10C1.5,0,5774134,0.989213,17184,5791319,1,5774186,-51,-52
II,-,5744371,0.0026738,0.0,374,373,1,0,17,gene,F10C1.9,0,5744366,0.598546,12486,5756857,5,5744366,5,0
II,-,5727639,0.0,3.72529e-09,28,28,0,0,4,gene,C18A3.6,0,5727618,0.942459,1925,5729564,21,5727618,21,0
II,-,5724697,0.0326087,2.53607e-23,92,89,3,2,0,gene,C18A3.6,0,5724697,0.942459,4867,5729564,0,5724697,0,0
II,-,5715582,0.0,1.90735e-06,19,19,0,0,30,gene,C18A3.10,0,5715573,0.170544,6154,5721736,9,5715661,-79,-88
II,-,5714790,0.00527307,0.0,2655,2641,14,13,2,gene,C18A3.5,0,5714772,3.03861,329,5715119,18,5714790,0,-18
II,-,5714774,0.0,0.000488281,11,11,0,0,7507,gene,C18A3.5,0,5714772,3.03861,345,5715119,2,5714790,-16,-18
II,-,5691322,0.00462963,0.0,3240,3225,15,14,2,gene,C25H3.9,1,5691302,8.63363,5264,5696586,20,5691322,0,-20
II,-,5688999,0.538462,0.143911,26,12,14,10,28,gene,C25H3.11,2,5688964,0.361156,370,5689369,35,5688999,0,-35
II,-,5669650,0.949333,0.0,1125,57,1068,746,8,gene,C25H3.17,2,5669650,None,96,5669746,0,5669652,-2,-2
II,-,5668900,0.939885,0.0,1048,63,985,708,1,gene,C25H3.7,3,5668899,1.9775,98,5668998,1,5668900,0,-1
II,-,5660819,0.0,4.76837e-07,21,21,0,0,5,gene,C25H3.12,1,5660769,0.457735,5907,5666726,50,5660756,63,13
II,-,5659745,0.92145,0.0,331,26,305,246,1,gene,F59E12.13,2,5659737,0.819598,101,5659846,8,5659737,8,0
II,-,5659737,0.974576,0.0,354,9,345,272,729,gene,F59E12.13,2,5659737,0.819598,109,5659846,0,5659737,0,0
II,-,5649440,0.00468384,0.0,1281,1275,6,6,0,gene,F59E12.11,1,5649411,1.40508,1922,5651362,29,5649440,0,-29
II,-,5647854,0.961957,5.1848e-44,184,7,177,113,2,gene,F59E12.10,2,5647844,0.510065,72,5647926,10,5647844,10,0
II,-,5647846,0.5,0.5,2,1,1,1,251,gene,F59E12.10,2,5647844,0.510065,80,5647926,2,5647844,2,0
II,-,5647012,0.835616,3.68845e-33,292,48,244,170,3,gene,F59E12.9,3,5647007,0.72001,110,5647122,5,5647012,0,-5
II,-,5622453,0.0066586,0.0,1652,1641,11,9,0,gene,C17G10.9,1,5622451,3.02804,3831,5626284,2,5622453,0,-2
II,-,5619289,0.576369,0.000744475,347,147,200,125,0,gene,C17G10.8,2,5619250,1.96621,265,5619554,39,5619289,0,-39
II,-,5607826,0.0,3.67342e-40,131,131,0,0,1,gene,C17G10.7,0,5607794,0.268376,9272,5617098,32,5607794,32,0
II,-,5603332,0.0,0.125,3,3,0,0,0,gene,C17G10.6,0,5603304,0.0592394,3180,5606512,28,5603264,68,40
II,-,5593396,0.00559701,0.0,536,533,3,3,1,gene,C17G10.4,0,5593386,1.9592,4975,5598371,10,5593396,0,-10
II,-,5582383,0.0,0.03125,5,5,0,0,0,gene,T25E4.2,0,5582380,0.00162584,5211,5587594,3,5582380,3,0
II,-,5547461,0.0,0.0,430,430,0,0,5,gene,C17C3.12,0,5547460,0.43554,20294,5567755,1,5547461,0,-1
II,-,5533707,0.0,0.5,1,1,0,0,0,gene,C17C3.8,0,5533693,0.00448521,5345,5539052,14,5533693,14,0
II,-,5517712,0.142857,0.0546875,7,6,1,1,1,gene,ZK177.9,0,5517709,0.0201826,6457,5524169,3,5517709,3,0
II,-,5513753,0.0,1.86265e-09,29,29,0,0,0,gene,ZK177.8,0,5513705,1.02673,3378,5517131,48,5513719,34,-14
II,-,5511179,0.0144144,0.0,555,547,8,8,2,gene,ZK177.8,0,5511172,1.02673,5952,5517131,7,5511179,0,-7
II,-,5493998,0.0,0.5,1,1,0,0,0,gene,F12A10.6,0,5493995,0.00407353,3258,5497256,3,5494476,-478,-481
II,-,5482012,0.047619,1.00136e-05,21,20,1,0,3,gene,F12A10.5,0,5482007,0.121221,11773,5493785,5,5482007,5,0
II,-,5446577,0.0,0.5,1,1,0,0,1,gene,F07F6.6,0,5446575,0.00740947,33784,5480361,2,5446577,0,-2
II,-,5433134,0.0,0.25,2,2,0,0,0,gene,F07F6.9,0,5433096,0.00632621,2561,5435695,38,5433019,115,77
II,-,5429543,0.00756144,0.0,529,525,4,2,3,gene,F07F6.4,1,5429538,1.45171,1902,5431445,5,5429543,0,-5
II,-,5425704,0.01288,0.0,1941,1916,25,21,53,gene,F07F6.8,2,5425689,1.64918,17,5425721,15,5425704,0,-15
II,-,5425694,0.0,0.125,3,3,0,0,1909,gene,F07F6.8,2,5425689,1.64918,27,5425721,5,5425704,-10,-15
II,-,5423829,0.0,1.73472e-18,59,59,0,0,0,gene,F07F6.7,0,5423802,0.0836944,284,5424113,27,5423802,27,0
II,-,5414021,0.00414938,0.0,241,240,1,1,2,gene,EEED8.14,1,5413985,0.216148,8793,5422814,36,5413985,36,0
II,-,5412579,0.892857,1.22041e-05,28,3,25,20,0,gene,EEED8.18,2,5412578,None,114,5412693,1,5412578,1,0
II,-,5408993,0.0,0.0,523,523,0,0,2,gene,EEED8.12,0,5408975,0.258502,2521,5411514,18,5408991,2,-16
II,-,5398873,0.0077821,0.0,257,255,2,1,3,gene,EEED8.10,1,5398853,1.04871,6855,5405728,20,5398873,0,-20
II,-,5395665,0.933862,0.0,378,25,353,197,0,gene,EEED8.9,2,5395650,0.680976,195,5395860,15,5395665,0,-15
II,-,5395658,0.857143,0.0055542,14,2,12,6,142,gene,EEED8.9,2,5395650,0.680976,202,5395860,8,5395665,-7,-15
II,-,5393190,0.8,0.15625,5,1,4,4,0,gene,EEED8.16,3,5393157,0.582133,73,5393263,33,5393161,29,-4
II,-,5393161,0.942857,0.0,350,20,330,243,1,gene,EEED8.16,3,5393157,0.582133,102,5393263,4,5393161,0,-4
II,-,5388799,0.286603,0.0,2411,1720,691,558,11,gene,EEED8.7,5,5388797,13.8489,89,5388888,2,5388797,2,0
II,-,5369071,0.0,1.52588e-05,16,16,0,0,1,gene,F09E5.12,0,5369071,0.0924713,2935,5372006,0,5369071,0,0
II,-,5365692,0.0,3.8147e-06,18,18,0,0,29,gene,F09E5.16,0,5365659,0.624321,2030,5367722,33,5365666,26,-7
II,-,5358158,0.00384615,0.0,260,259,1,1,0,gene,F09E5.11,0,5358152,1.18158,6318,5364476,6,5358152,6,0
II,-,5357831,1.0,0.5,1,0,1,1,314,gene,F09E5.11,0,5357797,1.18158,6645,5364476,34,5358152,-321,-355
II,-,5344846,0.0108303,0.0,277,274,3,1,0,gene,F09E5.14,0,5344823,1.0081,2717,5347563,23,5344848,-2,-25
II,-,5282494,0.0,1.26218e-29,96,96,0,0,0,gene,ZK622.3,0,5282480,9.62499,60140,5342634,14,5282494,0,-14
II,-,5282488,0.00684932,0.0,292,290,2,2,19,gene,ZK622.3,0,5282480,9.62499,60146,5342634,8,5282488,0,-8
II,-,5280250,0.00389972,0.0,1795,1788,7,7,3,gene,ZK622.3,0,5280246,9.62499,62384,5342634,4,5280246,4,0
II,-,5271816,0.0,1.11022e-16,53,53,0,0,0,gene,C54A12.4,0,5271683,0.346545,6238,5278054,133,5271590,226,93
II,-,5255508,0.0,0.0078125,7,7,0,0,2,gene,C54A12.2,0,5255504,0.0538323,14599,5270107,4,5255798,-290,-294
II,-,5246811,0.0,1.69407e-21,69,69,0,0,0,gene,C54A12.1,0,5246811,0.205152,4082,5250893,0,5246811,0,0
II,-,5238442,0.0,3.76158e-37,121,121,0,0,2,gene,T16D1.2,0,5238436,0.344305,2765,5241207,6,5238442,0,-6
II,-,5235823,0.003861,0.0,259,258,1,0,21,gene,EGAP2.3,0,5235809,1.54186,405,5236228,14,5235823,0,-14
II,-,5225355,0.00625,0.0,320,318,2,2,1,gene,C34F11.9,0,5225346,0.766872,7779,5233134,9,5225346,9,0
II,-,5210727,0.0,2.98023e-08,25,25,0,0,62,gene,C34F11.8,0,5210694,0.950053,3715,5214442,33,5210944,-217,-250
II,-,5187551,0.00766284,0.0,261,259,2,2,0,gene,C27D6.4,0,5187541,2.07297,6184,5193735,10,5187551,0,-10
II,-,5181418,0.0,0.125,3,3,0,0,3,gene,C27D6.4,0,5181324,2.07297,12317,5193735,94,5181071,347,253
II,-,5181071,0.000892857,0.0,1120,1119,1,1,9,gene,C27D6.4,0,5181054,2.07297,12664,5193735,17,5181071,0,-17
II,-,5177989,0.00446429,0.0,1568,1561,7,5,5,gene,C27D6.12,0,5177974,3.12363,1027,5179016,15,5177974,15,0
II,-,5177919,0.0,3.63798e-12,38,38,0,0,415,gene,C27D6.12,0,5177907,3.12363,1097,5179016,12,5177878,41,29
II,-,5150891,0.0,0.000976562,10,10,0,0,1,gene,F58A6.6,0,5150809,0.0420985,2208,5153099,82,5150836,55,-27
II,-,5142209,0.0,3.05176e-05,15,15,0,0,2,gene,F58A6.4,0,5142207,0.0840572,4741,5146950,2,5142019,190,188
II,-,5141896,0.0,0.0078125,7,7,0,0,12,gene,F58A6.4,0,5141832,0.0840572,5054,5146950,64,5142019,-123,-187
II,-,5141886,0.0,0.125,3,3,0,0,8,gene,F58A6.4,0,5141832,0.0840572,5064,5146950,54,5142019,-133,-187
II,-,5099739,0.0,0.5,1,1,0,0,0,gene,C04G6.6,0,5099732,0.0672802,1300,5101039,7,5099732,7,0
II,-,5091674,0.00662252,5.32493e-44,151,150,1,1,1,gene,C04G6.3,1,5091620,0.853794,7738,5099412,54,5091620,54,0
II,-,5083425,0.93007,0.0,572,40,532,334,6,gene,C04G6.4,2,5083417,0.552429,407,5083832,8,5083425,0,-8
II,-,5081151,0.0423453,0.0,307,294,13,10,1,gene,C27A2.6,3,5081141,0.916072,321,5081472,10,5081145,6,-4
II,-,5071350,0.0,0.125,3,3,0,0,2,gene,C27A2.7,0,5071348,0.0229581,1752,5073102,2,5071350,0,-2
II,-,5060716,0.125,0.03125,8,7,1,1,4,gene,C27A2.4,0,5060697,0.0967719,6420,5067136,19,5060697,19,0
II,-,5055164,0.00460405,0.0,1086,1081,5,4,1116,gene,C27A2.3,0,5055140,2.77964,1049,5056213,24,5055164,0,-24
II,-,5040664,0.0228758,0.0,306,299,7,5,0,gene,F33G12.7,1,5040664,1.06338,13404,5054068,0,5040664,0,0
II,-,5040076,0.860759,1.49505e-11,79,11,68,48,62,gene,F33G12.5,2,5040019,0.959201,115,5040191,57,5040076,0,-57
II,-,5036424,0.867624,0.0,627,83,544,430,3,gene,F33G12.4,3,5036411,0.624914,122,5036546,13,5036424,0,-13
II,-,5034020,0.918919,0.0,296,24,272,220,0,gene,F33G12.3,4,5034013,0.408616,109,5034129,7,5034020,0,-7
II,-,5031697,0.899038,8.00051e-35,208,21,187,124,1,gene,F33G12.2,5,5031693,0.450324,110,5031807,4,5031693,4,0
II,-,4993566,0.00794176,0.0,3022,2998,24,18,9,gene,T27F7.3,0,4993537,9.05686,4431,4997997,29,4993566,0,-29
II,-,4993456,0.1,0.00976562,10,9,1,1,3,gene,T27F7.3,0,4993341,9.05686,51,4993507,115,4993456,0,-115
II,-,4959828,0.0,1.14794e-41,136,136,0,0,293,gene,Y38A8.3,1,4959803,0.819059,30930,4990758,25,4959861,-33,-58
II,-,4955441,1.0,0.5,1,0,1,1,2,gene,Y38A8.2,2,4955373,6.07145,185,4955626,68,4955417,24,-44
II,-,4955413,0.155705,0.0,2235,1887,348,230,12,gene,Y38A8.2,2,4955373,6.07145,213,4955626,40,4955413,0,-40
II,-,4955392,0.0,0.125,3,3,0,0,7023,gene,Y38A8.2,2,4955373,6.07145,234,4955626,19,4955413,-21,-40
II,-,4945783,0.0,0.000244141,12,12,0,0,11,gene,ZK546.14,1,4945775,1.46062,2355,4948138,8,4945775,8,0
II,-,4945775,0.0184332,0.0,217,213,4,4,3,gene,ZK546.14,1,4945775,1.46062,2363,4948138,0,4945775,0,0
II,-,4943935,0.937576,0.0,817,51,766,560,1,gene,ZK546.13,2,4943928,1.11379,92,4944027,7,4943928,7,0
II,-,4943921,1.0,0.5,1,0,1,1,3656,gene,ZK546.13,2,4943915,1.11379,106,4944027,6,4943928,-7,-13
II,-,4941136,0.68314,2.54631e-12,344,109,235,193,4,gene,ZK546.17,3,4941134,0.987947,957,4942093,2,4941136,0,-2
II,-,4925243,0.0,1.03398e-25,83,83,0,0,1,gene,R05F9.12,0,4925230,2.24619,8626,4933869,13,4925234,9,-4
II,-,4925234,0.00158479,0.0,631,630,1,1,110,gene,R05F9.12,0,4925230,2.24619,8635,4933869,4,4925234,0,-4
II,-,4914205,0.0,1.97215e-31,102,102,0,0,8,gene,R05F9.11,0,4914202,0.10221,275,4914480,3,4914202,3,0
II,-,4903783,0.00385604,0.0,1556,1550,6,6,1,gene,R05F9.10,1,4903780,5.08393,8072,4911855,3,4903783,0,-3
II,-,4902087,0.304348,1.25634e-18,483,336,147,103,3,gene,R05F9.9,2,4902086,0.636317,184,4902271,1,4902086,1,0
II,-,4875533,0.0,0.000976562,10,10,0,0,6,gene,F11G11.13,0,4875485,0.0277624,16765,4892298,48,4875689,-156,-204
II,-,4873114,0.000635849,0.0,15727,15717,10,7,4,gene,F11G11.12,0,4873113,4.15502,2120,4875234,1,4873114,0,-1
II,-,4867561,0.00173654,0.0,4031,4024,7,5,2,gene,F11G11.10,0,4867561,5.14696,2113,4869674,0,4867561,0,0
II,-,4820820,0.0,1.32349e-23,76,76,0,0,0,gene,C33F10.7,0,4820817,0.523036,2511,4823331,3,4820820,0,-3
II,-,4812124,0.0,2.22045e-16,52,52,0,0,1,gene,C33F10.5,0,4812094,0.944961,6436,4818560,30,4812124,0,-30
II,-,4771371,0.0030581,0.0,1635,1630,5,4,0,gene,F26G1.5,0,4771370,1.37872,1453,4772824,1,4771370,1,0
II,-,4766373,0.0,0.0,402,402,0,0,0,gene,F26G1.4,0,4766359,0.192472,4152,4770525,14,4766373,0,-14
II,-,4733935,0.0,2.35099e-38,125,125,0,0,0,gene,F41C3.11,0,4733917,0.315051,21598,4755533,18,4733930,5,-13
II,-,4727866,0.0,1.13687e-13,43,43,0,0,2,gene,F10G7.11,0,4727850,8.39209,3258,4731124,16,4727859,7,-9
II,-,4727857,0.00196288,0.0,5604,5593,11,10,66,gene,F10G7.11,0,4727850,8.39209,3267,4731124,7,4727859,-2,-9
II,-,4726143,0.0,4.33681e-19,61,61,0,0,0,gene,F10G7.10,0,4726127,0.505133,1171,4727314,16,4726127,16,0
II,-,4706376,0.0,0.0625,4,4,0,0,41,gene,F10G7.9,0,4706350,1.0026,7285,4713661,26,4706350,26,0
II,-,4706343,0.0,4.76837e-07,21,21,0,0,49,gene,F10G7.9,0,4706211,1.0026,7318,4713661,132,4706343,0,-132
II,-,4698282,0.00273879,0.0,2921,2913,8,7,0,gene,F10G7.8,0,4698280,2.78226,4960,4703242,2,4698282,0,-2
II,-,4665445,0.0,5.42101e-20,64,64,0,0,0,gene,T05A7.11,0,4665433,0.0791641,432,4665877,12,4665433,12,0
II,-,4655922,0.0,0.0,270,270,0,0,3,gene,T05A7.5,0,4655920,0.222971,3252,4659174,2,4655922,0,-2
II,-,4638370,0.0,6.77626e-21,67,67,0,0,0,gene,F35D11.11,0,4638369,0.429393,14794,4653164,1,4638329,41,40
II,-,4602621,0.00388802,0.0,1286,1281,5,5,2,gene,F35D11.5,1,4602621,0.849691,12939,4615560,0,4602621,0,0
II,-,4601342,0.560538,0.0104445,223,98,125,92,3,gene,M03A1.6,2,4601328,0.941507,1,4601343,14,4601328,14,0
II,-,4597977,0.0,2.38419e-07,22,22,0,0,3,gene,M03A1.6,2,4597950,0.941507,3366,4601343,27,4597987,-10,-37
II,-,4537230,0.0,0.5,1,1,0,0,1,gene,B0304.6,0,4537229,0.0388844,1744,4538974,1,4537229,1,0
II,-,4523180,0.00749064,0.0,267,265,2,2,22,gene,B0304.4,0,4523135,0.405065,1381,4524561,45,4523210,-30,-75
II,-,4505122,0.00428266,0.0,467,465,2,2,2,gene,T05C1.4,0,4505027,1.56195,17331,4522453,95,4505135,-13,-108
II,-,4493470,0.0,1.50463e-36,119,119,0,0,25,gene,T05C1.4,0,4493371,1.56195,28983,4522453,99,4493371,99,0
II,-,4489377,0.0,2.46519e-32,105,105,0,0,15,gene,T05C1.3,0,4489371,0.179604,963,4490340,6,4489371,6,0
II,-,4460365,0.0,0.125,3,3,0,0,132,gene,T12C9.7,0,4460342,0.212551,20569,4480934,23,4460342,23,0
II,-,4453233,0.0,2.91038e-11,35,35,0,0,0,gene,T12C9.3,0,4453151,0.0893145,5019,4458252,82,4453142,91,9
II,-,4424906,0.0,0.25,2,2,0,0,1,gene,ZK430.7,0,4424885,1.23945,16180,4441086,21,4424893,13,-8
II,-,4424893,0.00253807,0.0,394,393,1,1,22,gene,ZK430.7,0,4424885,1.23945,16193,4441086,8,4424893,0,-8
II,-,4376452,0.00392927,0.0,1018,1014,4,2,12,gene,B0286.4,0,4376448,2.81954,3139,4379591,4,4376452,0,-4
II,-,4375705,0.0,4.76837e-07,21,21,0,0,0,gene,B0286.4,0,4375537,2.81954,3886,4379591,168,4375705,0,-168
II,-,4375342,0.0,0.03125,5,5,0,0,6,gene,B0286.4,0,4375225,2.81954,4249,4379591,117,4375342,0,-117
II,-,4374692,0.0,0.0,188,188,0,0,0,gene,B0286.4,0,4374684,2.81954,4899,4379591,8,4374692,0,-8
II,-,4312242,0.0,0.000488281,11,11,0,0,1,gene,Y52E8A.4,0,4312208,0.0111447,4411,4316653,34,4312208,34,0
II,-,4306964,0.0,9.18355e-41,133,133,0,0,18,gene,Y52E8A.3,0,4306943,0.147937,2754,4309718,21,4306975,-11,-32
II,-,4288202,0.0055371,0.0,903,898,5,5,1,gene,C01F1.6,0,4288166,0.757608,17150,4305352,36,4288203,-1,-37
II,-,4237743,0.0,0.0078125,7,7,0,0,6,gene,C16A11.6,0,4237731,0.191926,18097,4255840,12,4237743,0,-12
II,-,4235988,0.0,0.5,1,1,0,0,1,gene,C16A11.9,0,4235976,None,506,4236494,12,4235976,12,0
II,-,4178926,0.0,0.00195312,9,9,0,0,0,gene,R03H10.7,0,4178921,0.134038,10050,4188976,5,4178921,5,0
II,-,4173486,0.0,1.90735e-06,19,19,0,0,6,gene,R03H10.6,0,4173481,0.0734578,1729,4175215,5,4173869,-383,-388
II,-,4061748,0.0,0.125,3,3,0,0,10,gene,W06A11.2,0,4061734,0.0318936,1222,4062970,14,4061692,56,42
II,-,4044324,0.00981267,0.0,1121,1110,11,10,0,gene,K07D4.3,0,4044318,5.24329,439,4044763,6,4044324,0,-6
II,-,4032387,0.0,6.77626e-21,67,67,0,0,3,gene,K07D4.4,0,4032379,0.00302474,10666,4043053,8,4032642,-255,-263
II,-,4023673,0.0,0.25,2,2,0,0,2,gene,K07D4.5,0,4023645,0.0796972,7432,4031105,28,4023841,-168,-196
II,-,4018709,0.0,1.52588e-05,16,16,0,0,2,gene,K07D4.6,0,4018695,0.0499046,1610,4020319,14,4018695,14,0
II,-,3933733,0.00932401,0.0,429,425,4,3,0,gene,Y14H12B.2,0,3933708,0.922745,39001,3972734,25,3933733,0,-25
II,-,3927975,0.275441,1.12884e-35,737,534,203,174,0,gene,F53C3.13,0,3927901,3.43617,4195,3932170,74,3927975,0,-74
II,-,3910899,0.0,0.5,1,1,0,0,0,gene,F53C3.12,0,3910825,0.269049,9696,3920595,74,3910830,69,-5
II,-,3910830,0.0,0.0,220,220,0,0,0,gene,F53C3.12,0,3910825,0.269049,9765,3920595,5,3910830,0,-5
II,-,3877839,0.0,0.00390625,8,8,0,0,9,gene,C49D10.11,0,3877835,0.0410368,9270,3887109,4,3877903,-64,-68
II,-,3821289,0.0,3.76158e-37,121,121,0,0,0,gene,F54D10.7,0,3821274,0.161972,4363,3825652,15,3821278,11,-4
II,-,3815855,0.0,2.22045e-16,52,52,0,0,5,gene,F54D10.6,0,3815840,0.173032,4290,3820145,15,3815451,404,389
II,-,3815466,0.0,9.09495e-13,40,40,0,0,3,gene,F54D10.6,0,3815451,0.173032,4679,3820145,15,3815451,15,0
II,-,3808170,0.00276243,0.0,362,361,1,1,3,gene,F54D10.5,1,3808163,0.550009,5205,3813375,7,3808216,-46,-53
II,-,3807052,0.833333,0.09375,6,1,5,4,1,gene,F54D10.4,2,3807046,0.0208589,20,3807072,6,3807046,6,0
II,-,3779557,0.0,0.0,179,179,0,0,1,gene,T24E12.11,0,3779549,0.0719252,12931,3792488,8,3779549,8,0
II,-,3773222,0.0,1.52588e-05,16,16,0,0,0,gene,T24E12.10,0,3773185,0.0217697,5188,3778410,37,3773185,37,0
II,-,3764797,0.0,0.5,1,1,0,0,0,gene,T24E12.8,0,3764794,0.000232684,282,3765079,3,3764580,217,214
II,-,3763193,0.0,0.5,1,1,0,0,0,gene,T24E12.7,0,3763073,None,246,3763439,120,3762832,361,241
II,-,3750779,0.0,0.25,2,2,0,0,4,gene,F12E12.8,0,3750713,0.175986,474,3751253,66,3750713,66,0
II,-,3736941,0.0,1.16415e-10,33,33,0,0,0,gene,F12E12.6,0,3736927,0.0363212,5518,3742459,14,3736926,15,1
II,-,3704945,0.0,0.5,1,1,0,0,0,gene,F40H7.10,0,3704939,None,10010,3714955,6,3704939,6,0
II,-,3680431,0.0223464,0.0,179,175,4,3,8,gene,F19B10.10,0,3680424,0.242344,7356,3687787,7,3680431,0,-7
II,-,3673587,0.0,0.0,351,351,0,0,2,gene,F19B10.9,0,3673584,0.374012,3942,3677529,3,3673584,3,0
II,-,3639345,0.0,0.5,1,1,0,0,7,gene,M151.5,0,3639255,0.392336,284,3639629,90,3639278,67,-23
II,-,3609856,0.0,5.96046e-08,24,24,0,0,2,gene,Y49F6A.5,0,3609855,0.0108476,27950,3637806,1,3609855,1,0
II,-,3546425,0.0037594,0.0,266,265,1,1,1,gene,W09G10.4,0,3546415,0.545952,13218,3559643,10,3546425,0,-10
II,-,3528510,0.0833333,0.00292969,12,11,1,1,0,gene,W09G10.3,0,3528377,0.127743,4010,3532520,133,3528510,0,-133
II,-,3502563,0.0,3.8147e-06,18,18,0,0,4,gene,Y49F6B.10,0,3502497,4.66548,8310,3510873,66,3502444,119,53
II,-,3499382,0.00869565,2.76852e-33,115,114,1,1,6,gene,Y49F6B.9,0,3499375,0.23065,686,3500068,7,3499388,-6,-13
II,-,3498907,0.0,0.5,1,1,0,0,0,gene,Y49F6B.9,0,3498892,0.23065,1161,3500068,15,3498892,15,0
II,-,3445374,0.00581395,0.0,172,171,1,1,0,gene,C16C8.5,1,3445359,0.317045,6167,3451541,15,3445359,15,0
II,-,3444375,0.164234,2.99901e-31,274,229,45,37,0,gene,C16C8.4,2,3444360,0.297269,290,3444665,15,3444360,15,0
II,-,3436507,0.0,1.16415e-10,33,33,0,0,0,gene,C16C8.2,0,3436454,1.19248,5886,3442393,53,3436507,0,-53
II,-,3425528,0.0,3.08149e-33,108,108,0,0,0,gene,F18A12.8,0,3425527,0.359328,5753,3431281,1,3425527,1,0
II,-,3370104,0.00917431,1.67941e-31,109,108,1,1,20,gene,Y49F6C.8,0,3370087,0.317996,3057,3373161,17,3370140,-36,-53
II,-,3370093,0.0196078,2.26485e-14,51,50,1,1,362,gene,Y49F6C.8,0,3370087,0.317996,3068,3373161,6,3370140,-47,-53
II,-,3349897,0.0,1.13687e-13,43,43,0,0,0,gene,F14D2.8,0,3349893,0.041654,4401,3354298,4,3349865,32,28
II,-,3346373,0.0100671,0.0,298,295,3,3,0,gene,F14D2.12,1,3346366,0.331235,369,3346742,7,3346366,7,0
II,-,3344962,0.0829016,7.44641e-36,193,177,16,15,0,gene,F14D2.13,2,3344929,0.270101,251,3345213,33,3344962,0,-33
II,-,3343546,0.885417,1.1131e-15,96,11,85,64,1,gene,F14D2.15,3,3343532,0.10436,116,3343662,14,3343532,14,0
II,-,3342081,0.02,4.44089e-14,50,49,1,0,7,gene,F14D2.11,0,3342066,0.0833763,245,3342326,15,3342111,-30,-45
II,-,3275017,0.0,0.000244141,12,12,0,0,1,gene,F02E11.3,0,3274991,0.00644521,1233,3276250,26,3275046,-29,-55
II,-,3245911,0.0,1.49012e-08,26,26,0,0,32308,gene,C17F4.7,0,3245896,79.1039,399,3246310,15,3246011,-100,-115
II,-,3234818,0.0,2.32831e-10,32,32,0,0,0,gene,C17F4.8,0,3234808,0.0391614,1103,3235921,10,3234808,10,0
II,-,3224652,1.0,0.5,1,0,1,0,2,gene,ZC239.15,2,3224638,0.0440405,114,3224766,14,3224638,14,0
II,-,3220749,0.0,0.000976562,10,10,0,0,100,gene,ZC239.22,0,3220674,None,92,3220841,75,3220769,-20,-95
II,-,3206536,0.0106383,4.74579e-27,94,93,1,1,3,gene,ZC239.20,0,3206518,0.116208,1264,3207800,18,3206536,0,-18
II,-,3111226,0.00238095,0.0,1260,1257,3,3,3,gene,Y25C1A.13,0,3111217,1.46613,14806,3126032,9,3111222,4,-5
II,-,3076948,0.00471698,0.0,212,211,1,1,1,gene,Y25C1A.8,1,3076941,0.440393,11122,3088070,7,3076941,7,0
II,-,3071057,0.593511,3.51827e-06,524,213,311,203,1,gene,Y25C1A.7,2,3071032,1.1903,115,3071172,25,3071057,0,-25
II,-,3054316,0.0,0.0,276,276,0,0,1,gene,B0454.9,0,3054311,0.335828,8216,3062532,5,3054343,-27,-32
II,-,2927290,0.00140845,0.0,710,709,1,1,4,gene,ZK355.3,0,2927287,0.328121,6212,2933502,3,2927629,-339,-342
II,-,2919311,0.0,0.0,158,158,0,0,2,gene,Y110A2AR.3,1,2919148,0.951622,7702,2927013,163,2919311,0,-163
II,-,2913600,0.878307,0.0,378,46,332,244,0,gene,Y110A2AR.2,2,2913544,0.965682,107,2913707,56,2913600,0,-56
II,-,2900345,0.875796,2.8026e-45,314,39,275,168,4,gene,Y110A2AM.3,2,2900325,0.747775,90,2900435,20,2900345,0,-20
II,-,2894392,0.920732,0.0,328,26,302,228,2,gene,Y110A2AL.14,3,2894388,0.418297,380,2894772,4,2894392,0,-4
II,-,2889053,0.0,0.5,1,1,0,0,6,gene,Y110A2AL.13,4,2889002,0.834562,51,2889104,51,2889002,51,0
II,-,2889002,0.737772,7.56993e-40,736,193,543,380,7,gene,Y110A2AL.13,4,2889002,0.834562,102,2889104,0,2889002,0,0
II,-,2884907,0.82243,3.35017e-12,107,19,88,55,0,gene,Y110A2AL.12,5,2884893,0.333458,1415,2886322,14,2884893,14,0
II,-,2871909,0.0,0.5,1,1,0,0,1,gene,Y110A2AL.10,0,2871909,0.00221958,7036,2878945,0,2871909,0,0
II,-,2852592,0.0,0.0,236,236,0,0,1,gene,Y110A2AL.8,0,2852511,1.35111,13376,2865968,81,2852592,0,-81
II,-,2836849,0.0,1.52588e-05,16,16,0,0,2,gene,K12H6.7,0,2836836,0.0844687,4160,2841009,13,2836617,232,219
II,-,2831232,0.0,0.0,272,272,0,0,25,gene,K12H6.6,0,2831219,1.83817,3714,2834946,13,2831232,0,-13
II,-,2815305,0.0,0.5,1,1,0,0,5,gene,K12H6.2,0,2815282,0.176612,4131,2819436,23,2815543,-238,-261
II,-,2814767,0.00591716,0.0,169,168,1,1,1,gene,K12H6.2,0,2814764,0.176612,436,2815203,3,2814767,0,-3
II,-,2800597,0.0384615,2.94431e-13,52,50,2,2,0,gene,K12H6.1,0,2800581,0.441484,12360,2812957,16,2800548,49,33
II,-,2769119,0.00757576,2.42446e-38,132,131,1,1,8,gene,F08D12.7,0,2769117,0.192829,395,2769514,2,2769130,-11,-13
II,-,2752611,0.00486224,0.0,617,614,3,3,3,gene,F29A7.6,0,2752608,0.495237,3569,2756180,3,2752611,0,-3
II,-,2742349,0.0,0.03125,5,5,0,0,0,gene,T05A8.7,0,2742341,0.00682568,9413,2751762,8,2742341,8,0
II,-,2735248,0.0,4.23516e-22,71,71,0,0,2,gene,T05A8.5,0,2735242,0.0625186,3277,2738525,6,2735250,-2,-8
II,-,2725757,0.0,7.10543e-15,47,47,0,0,0,gene,T05A8.4,0,2725687,0.498081,5381,2731138,70,2725541,216,146
II,-,2705189,0.0,0.25,2,2,0,0,0,gene,Y47G7B.1,0,2705164,0.00330842,734,2705923,25,2705267,-78,-103
II,-,2648992,0.0,6.10352e-05,14,14,0,0,0,gene,F22E5.13,0,2648959,0.117117,4078,2653070,33,2648992,0,-33
II,-,2637324,0.0,0.25,2,2,0,0,0,gene,F22E5.21,0,2637304,0.0451058,6360,2643684,20,2637609,-285,-305
II,-,2563838,0.0,0.125,3,3,0,0,2,gene,K02F6.9,0,2563758,0.0855942,14803,2578641,80,2563678,160,80
II,-,2534314,0.0,0.125,3,3,0,0,0,gene,K02F6.8,0,2534279,0,23467,2557781,35,2534279,35,0
II,-,2529256,0.0,0.0,348,348,0,0,3,gene,K02F6.7,0,2529245,0.225937,4188,2533444,11,2529245,11,0
II,-,2529247,0.0,0.03125,5,5,0,0,123,gene,K02F6.7,0,2529245,0.225937,4197,2533444,2,2529245,2,0
II,-,2524490,0.0,0.25,2,2,0,0,1,gene,F40B1.2,0,2524476,None,731,2525221,14,2524476,14,0
II,-,2522059,0.0,5.42101e-20,64,64,0,0,0,gene,F40B1.1,0,2522045,0.0456946,504,2522563,14,2522045,14,0
II,-,2516114,0.0,1.52588e-05,16,16,0,0,0,gene,F59H5.3,0,2516098,None,4732,2520846,16,2516098,16,0
II,-,2479091,0.00775194,0.0,387,384,3,2,13,gene,F53G2.7,1,2479077,1.31821,23722,2502813,14,2479091,0,-14
II,-,2478808,0.0,6.10352e-05,14,14,0,0,4,gene,F53G2.7,1,2478584,1.31821,24005,2502813,224,2478808,0,-224
II,-,2478329,0.0,2.38419e-07,22,22,0,0,1,gene,F53G2.7,1,2478277,1.31821,24484,2502813,52,2478329,0,-52
II,-,2473371,0.869767,2.01524e-30,215,28,187,126,1,gene,F53G2.6,2,2473360,0.477028,149,2473520,11,2472863,508,497
II,-,2458982,0.00505051,0.0,198,197,1,1,0,gene,F53G2.4,0,2458973,0.35134,1857,2460839,9,2458982,0,-9
II,-,2429946,0.0,1.03398e-25,83,83,0,0,0,gene,F42G2.6,0,2429926,0.202851,23049,2452995,20,2429945,1,-19
II,-,2429786,0.0,0.5,1,1,0,0,30,gene,F42G2.6,0,2429713,0.202851,23209,2452995,73,2429945,-159,-232
II,-,2417979,0.0,2.84217e-14,45,45,0,0,1,gene,F42G2.5,0,2417972,0.1008,8392,2426371,7,2417972,7,0
II,-,2415476,0.0357143,1.04308e-07,28,27,1,1,3,gene,F42G2.8,0,2415476,0.119115,522,2415998,0,2415449,27,27
II,-,2412748,0.0,0.00195312,9,9,0,0,0,gene,F42G2.4,0,2412742,0.235306,1441,2414189,6,2412742,6,0
II,-,2407685,0.0,0.000244141,12,12,0,0,0,gene,F16G10.15,0,2407682,0.0156764,1949,2409634,3,2407682,3,0
II,-,2340747,0.0,0.0,284,284,0,0,2,gene,F43C11.9,0,2340738,0.582857,9398,2350145,9,2340747,0,-9
II,-,2329654,0.0,0.5,1,1,0,0,0,gene,ZK1240.8,0,2329382,0.0108582,8246,2337900,272,2329053,601,329
II,-,2318044,0.0,0.25,2,2,0,0,0,gene,ZK1240.5,0,2318027,0.0391878,4512,2322556,17,2318125,-81,-98
II,-,2317927,0.0,0.0078125,7,7,0,0,3,gene,ZK1240.5,0,2317878,0.0391878,4629,2322556,49,2318125,-198,-247
II,-,2316973,0.0,0.5,1,1,0,0,2,gene,ZK1240.10,0,2316941,None,5583,2322556,32,2316803,170,138
II,-,2300838,0.0,3.72529e-09,28,28,0,0,118,gene,B0281.5,0,2300819,0.607682,472,2301310,19,2300819,19,0
II,-,2298836,0.0,0.015625,6,6,0,0,2,gene,B0281.4,0,2298818,0.0158287,1017,2299853,18,2298794,42,24
II,-,2292172,0.0,5.55112e-17,54,54,0,0,0,gene,K09F6.7,0,2292128,0.0984866,2479,2294651,44,2292128,44,0
II,-,2279155,0.0,0.25,2,2,0,0,2,gene,K09F6.6,0,2279147,0.0411004,1716,2280871,8,2279147,8,0
II,-,2232345,0.0,0.0078125,7,7,0,0,47,gene,F54A3.6,1,2232332,0.462332,29851,2262196,13,2232471,-126,-139
II,-,2225709,0.948842,0.0,1036,53,983,545,0,gene,F54A3.5,2,2225707,3.86188,108,2225817,2,2225709,0,-2
II,-,2219922,0.00857143,0.0,350,347,3,3,2,gene,Y59C2A.3,2,2219911,0.698056,465,2220387,11,2219922,0,-11
II,-,2204138,0.0,0.0,501,501,0,0,0,gene,Y59C2A.2,0,2204121,0.413206,11339,2215477,17,2204130,8,-9
II,-,2194115,0.00196078,0.0,510,509,1,1,9,gene,C33C12.10,0,2194109,0.611552,652,2194767,6,2194115,0,-6
II,-,2189458,0.686869,4.28354e-08,198,62,136,89,0,gene,C33C12.9,0,2189458,0.589659,2901,2192359,0,2189458,0,0
II,-,2150987,0.0,0.25,2,2,0,0,1,gene,C40A11.8,0,2150936,0.0348559,10231,2161218,51,2151291,-304,-355
II,-,2129297,0.0,1.90735e-06,19,19,0,0,0,gene,R52.10,0,2129282,None,4368,2133665,15,2129282,15,0
II,-,2122185,0.0909091,0.00537109,11,10,1,0,0,gene,R52.9,0,2122182,0.0628017,1259,2123444,3,2122182,3,0
II,-,2116840,0.666667,0.375,3,1,2,2,3,gene,R52.7,2,2116779,0.00837332,372,2117212,61,2116895,-55,-116
II,-,2090640,0.0,0.25,2,2,0,0,0,gene,T16A1.7,0,2090632,0.0278706,901,2091541,8,2090619,21,13
II,-,2059071,0.0150376,8.06132e-37,133,131,2,1,1,gene,F07E5.5,0,2059064,1.37274,713,2059784,7,2059071,0,-7
II,-,2049194,0.0,6.10352e-05,14,14,0,0,0,gene,B0047.5,0,2049180,None,4722,2053916,14,2049176,18,4
II,-,2045600,0.0,5.82077e-11,34,34,0,0,1,gene,B0047.3,0,2045586,0.135403,484,2046084,14,2045586,14,0
II,-,2044103,0.0,0.015625,6,6,0,0,1,gene,B0047.2,0,2044088,0.0164451,495,2044598,15,2044060,43,28
II,-,2041630,0.0,0.125,3,3,0,0,0,gene,B0047.1,0,2041616,0.0257306,733,2042363,14,2041616,14,0
II,-,2039389,0.0,1.86265e-09,29,29,0,0,0,gene,F59H6.1,0,2039387,0.0494389,889,2040278,2,2039387,2,0
II,-,2031953,0.0,7.27596e-12,37,37,0,0,0,gene,F59H6.11,1,2031939,0.295556,3750,2035703,14,2031939,14,0
II,-,2030468,0.25,0.00244898,32,24,8,8,1,gene,F59H6.10,2,2030464,0.0462877,285,2030753,4,2030464,4,0
II,-,2028813,0.175258,2.38472e-11,97,80,17,13,0,gene,F59H6.9,3,2028799,0.133254,420,2029233,14,2028813,0,-14
II,-,2026624,0.45,0.160179,20,11,9,6,0,gene,F59H6.8,4,2026611,0.0744985,988,2027612,13,2026611,13,0
II,-,1939751,0.0,7.62939e-06,17,17,0,0,7,gene,ZK250.5,0,1939745,0.116116,1075,1940826,6,1939751,0,-6
II,-,1930401,0.0,0.000976562,10,10,0,0,0,gene,F52C6.13,0,1930401,0.0185991,589,1930990,0,1930748,-347,-347
II,-,1922760,0.0121951,1.69572e-23,82,81,1,1,1,gene,F52C6.11,0,1922746,0.161732,6393,1929153,14,1922746,14,0
II,-,1921118,0.0,7.62939e-06,17,17,0,0,0,gene,F52C6.10,1,1921106,0.0761162,332,1921450,12,1921106,12,0
II,-,1919455,0.615385,0.079151,26,10,16,13,0,gene,F52C6.9,2,1919441,None,465,1919920,14,1919441,14,0
II,-,1917958,0.302326,0.00415831,43,30,13,11,1,gene,F52C6.8,3,1917954,0.0905965,275,1918233,4,1917954,4,0
II,-,1916402,0.0,0.00390625,8,8,0,0,0,gene,F52C6.7,4,1916378,None,313,1916715,24,1916378,24,0
II,-,1916390,0.114286,1.52388e-06,35,31,4,3,7,gene,F52C6.7,4,1916378,None,325,1916715,12,1916378,12,0
II,-,1912851,0.5,0.5,2,1,1,1,0,gene,F52C6.6,0,1912837,0.001771,572,1913423,14,1912837,14,0
II,-,1848157,0.0,1.05879e-22,73,73,0,0,3,gene,C52E2.6,0,1848156,0.0541846,1205,1849362,1,1848156,1,0
II,-,1842945,0.0,0.000976562,10,10,0,0,2,gene,C52E2.5,0,1842939,0.0542947,4040,1846985,6,1842945,0,-6
II,-,1782323,0.0,2.38419e-07,22,22,0,0,52,gene,C08F1.5,0,1782310,0.22274,1134,1783457,13,1782310,13,0
II,-,1736446,0.0,2.1684e-19,62,62,0,0,60,gene,F45C12.15,0,1736426,0.251074,421,1736867,20,1736446,0,-20
II,-,1695864,0.0,0.00390625,8,8,0,0,0,gene,F58E1.13,0,1695851,0.0186196,632,1696496,13,1695830,34,21
II,-,1662952,0.0555556,6.86646e-05,18,17,1,0,0,gene,ZC204.14,0,1662809,0.206539,4571,1667523,143,1662915,37,-106
II,-,1657406,0.0,3.8147e-06,18,18,0,0,5,gene,ZC204.12,0,1657374,1.71323,3069,1660475,32,1657305,101,69
II,-,1657305,0.000618302,0.0,4852,4849,3,3,9,gene,ZC204.12,0,1657280,1.71323,3170,1660475,25,1657305,0,-25
II,-,1621278,0.0,0.000488281,11,11,0,0,0,gene,C08E3.10,0,1621265,0.103211,10514,1631792,13,1621265,13,0
II,-,1621184,0.0,0.125,3,3,0,0,11,gene,C08E3.10,0,1621150,0.103211,10608,1631792,34,1621142,42,8
II,-,1619039,0.285714,0.164062,7,5,2,1,1,gene,C08E3.9,0,1619008,0.0544167,785,1619824,31,1619008,31,0
II,-,1619021,0.0,0.015625,6,6,0,0,72,gene,C08E3.9,0,1619008,0.0544167,803,1619824,13,1619008,13,0
II,-,1614048,0.0,0.00012207,13,13,0,0,11,gene,C08E3.7,0,1614006,0.0180146,723,1614771,42,1614063,-15,-57
II,-,1610732,0.0,6.46235e-27,87,87,0,0,0,gene,C08E3.6,0,1610719,0.0653081,2062,1612794,13,1610719,13,0
II,-,1609018,0.0,1.19209e-07,23,23,0,0,2,gene,C08E3.5,0,1609005,0.0576524,240,1609258,13,1609005,13,0
II,-,1600764,0.015873,6.83047e-18,63,62,1,1,2,gene,T07H3.6,0,1600720,0.121872,3904,1604668,44,1600719,45,1
II,-,1579989,0.00645161,2.8026e-45,155,154,1,1,1,gene,T07H3.3,0,1579977,0.125671,2890,1582879,12,1579977,12,0
II,-,1576129,0.0,1.52588e-05,16,16,0,0,0,gene,K05F6.10,0,1576121,0.0319095,1251,1577380,8,1576121,8,0
II,-,1517402,0.0,0.5,1,1,0,0,7,gene,Y51H7BM.1,0,1517385,0.09304,2915,1520317,17,1517398,4,-13
II,-,1500336,0.019337,0.0,362,355,7,7,0,gene,H17B01.4,0,1500332,1.57027,9958,1510294,4,1500336,0,-4
II,-,1473587,0.0,0.0,306,306,0,0,0,gene,H17B01.5,0,1473561,0.490618,2923,1476510,26,1473561,26,0
II,-,1466552,0.0,0.0,158,158,0,0,0,gene,Y51H7C.13,0,1466550,1.20474,6066,1472618,2,1466552,0,-2
II,-,1437505,0.00740741,0.0,270,268,2,2,1,gene,Y51H7C.11,0,1437503,0.356682,2549,1440054,2,1437505,0,-2
II,-,1374994,0.0,0.0,427,427,0,0,0,gene,F54D12.6,0,1374991,0.439697,2079,1377073,3,1374991,3,0
II,-,1358011,0.0,0.0,226,226,0,0,5,gene,C13A10.2,0,1357994,0.424668,11041,1369052,17,1358011,0,-17
II,-,1355512,0.0,0.0625,4,4,0,0,1,gene,C13A10.1,0,1355504,0.0772971,1671,1357183,8,1355512,0,-8
II,-,1309760,0.00168776,0.0,1185,1183,2,1,0,gene,F56D12.1,1,1309757,1.43024,40940,1350700,3,1309760,0,-3
II,-,1309364,0.0,1.19209e-07,23,23,0,0,8,gene,F56D12.1,1,1309271,1.43024,41336,1350700,93,1309364,0,-93
II,-,1306142,0.928934,0.0,591,42,549,356,0,gene,Y57G7A.10,2,1306125,1.54074,100,1306242,17,1306142,0,-17
II,-,1266898,0.0,0.03125,5,5,0,0,5,gene,F47F6.3,0,1266896,0.100324,2627,1269525,2,1266896,2,0
II,-,1244041,0.0,0.0,601,601,0,0,1,gene,F47F6.1,0,1244021,2.11629,9235,1253276,20,1244041,0,-20
II,-,1179157,0.0,1.16415e-10,33,33,0,0,0,gene,T23F4.4,0,1179144,0.0767346,54081,1233238,13,1179329,-172,-185
II,-,1140523,0.0,0.125,3,3,0,0,1,gene,W09B6.4,0,1140480,0.45972,29029,1169552,43,1140465,58,15
II,-,1140465,0.0,0.015625,6,6,0,0,63,gene,W09B6.4,0,1140414,0.45972,29087,1169552,51,1140465,0,-51
II,-,1134156,0.00607903,0.0,329,327,2,2,1,gene,W09B6.4,0,1134149,0.45972,6202,1140358,7,1134156,0,-7
II,-,1133267,0.0,6.10352e-05,14,14,0,0,0,gene,W09B6.4,0,1133252,0.45972,7091,1140358,15,1133267,0,-15
II,-,1123265,0.00414938,0.0,241,240,1,1,10,gene,T13B5.8,0,1123259,1.29435,9020,1132285,6,1123259,6,0
II,-,1118046,0.0,0.125,3,3,0,0,0,gene,T13B5.7,0,1118039,0.00721663,2977,1121023,7,1118039,7,0
II,-,1114239,0.0625,0.000244141,16,15,1,1,0,gene,T13B5.6,0,1114232,0.0230414,1375,1115614,7,1114232,7,0
II,-,1111005,0.0,0.000244141,12,12,0,0,0,gene,T13B5.5,0,1110998,0.0265647,1184,1112189,7,1110998,7,0
II,-,1100840,0.0,0.125,3,3,0,0,1,gene,T13B5.3,0,1100818,0.664144,540,1101380,22,1100818,22,0
II,-,1100825,0.003125,0.0,320,319,1,0,23,gene,T13B5.3,0,1100818,0.664144,555,1101380,7,1100818,7,0
II,-,1100783,0.0,0.25,2,2,0,0,39,gene,T13B5.3,0,1100611,0.664144,597,1101380,172,1100818,-35,-207
II,-,1067011,0.0,9.53674e-07,20,20,0,0,2,gene,K02E7.10,0,1067004,0.033959,4502,1071513,7,1067004,7,0
II,-,1060768,0.0,0.125,3,3,0,0,7,gene,K02E7.9,0,1060754,0.203816,4594,1065362,14,1060809,-41,-55
II,-,1024790,0.0,1.42109e-14,46,46,0,0,42,gene,M01D1.3,0,1024785,0.210631,14911,1039701,5,1024785,5,0
II,-,972933,0.0,2.98023e-08,25,25,0,0,0,gene,C32B5.15,0,972932,0.0386397,3315,976248,1,972956,-23,-24
II,-,966724,0.0,0.0625,4,4,0,0,45,gene,C32B5.14,0,966624,0.138287,3841,970565,100,966965,-241,-341
II,-,952856,0.0,0.03125,5,5,0,0,3,gene,C32B5.12,0,952841,0.0905153,8500,961356,15,952849,7,-8
II,-,952849,0.0,8.07794e-28,90,90,0,0,3,gene,C32B5.12,0,952841,0.0905153,8507,961356,8,952849,0,-8
II,-,948197,0.0,0.0,202,202,0,0,1,gene,C32B5.10,0,948187,0.146969,250,948447,10,948187,10,0
II,-,900741,0.0,0.0,265,265,0,0,1,gene,T07D3.9,0,900734,0.33802,6717,907458,7,900741,0,-7
II,-,850671,0.0,0.5,1,1,0,0,0,gene,F28A10.5,0,850660,0.00195832,989,851660,11,850660,11,0
II,-,848609,0.00802568,0.0,623,618,5,4,23,gene,F28A10.6,0,848606,1.51323,1073,849682,3,848608,1,-2
II,-,765327,0.0,0.0078125,7,7,0,0,0,gene,C08G5.7,0,765323,0.615233,14057,779384,4,765323,4,0
II,-,762460,0.0,0.0,172,172,0,0,0,gene,C08G5.7,0,762348,0.615233,16924,779384,112,762460,0,-112
II,-,756924,0.0,8.27181e-25,80,80,0,0,1,gene,C08G5.5,0,756924,0.589744,22460,779384,0,756897,27,27
II,-,750208,0.0285714,1.01863e-09,35,34,1,0,0,gene,C08G5.4,0,750170,0.493537,5993,756201,38,750170,38,0
II,-,701131,0.00357888,0.0,6706,6682,24,19,0,gene,T02H6.11,0,701123,13.7018,33523,734654,8,701131,0,-8
II,-,650367,0.0102041,3.09233e-28,98,97,1,1,3,gene,K07E8.7,0,650357,0.275872,5751,656118,10,650373,-6,-16
II,-,624549,0.00154083,0.0,649,648,1,1,0,gene,T04B8.5,0,624546,0.884023,12852,637401,3,624549,0,-3
II,-,620980,0.0,0.5,1,1,0,0,0,gene,T04B8.5,0,620938,0.884023,16421,637401,42,620980,0,-42
II,-,602126,0.0,8.27181e-25,80,80,0,0,0,gene,W04H10.3,0,602123,0.42579,3622,605748,3,602126,0,-3
II,-,601211,0.0,1.86265e-09,29,29,0,0,0,gene,W04H10.3,0,600826,0.42579,4537,605748,385,601211,0,-385
II,-,600846,0.0,0.25,2,2,0,0,0,gene,W04H10.3,0,600826,0.42579,4902,605748,20,600846,0,-20
II,-,594330,0.0,0.25,2,2,0,0,5,gene,W08F4.11,0,594120,1.07471,871,595201,210,594701,-371,-581
II,-,584409,0.0,3.46945e-18,58,58,0,0,0,gene,W08F4.12,0,584388,0.0420221,6165,590574,21,584401,8,-13
II,-,579890,0.00816131,0.0,2083,2066,17,16,6,gene,W08F4.8,0,579883,2.47648,2219,582109,7,579890,0,-7
II,-,572108,0.00239234,0.0,1254,1251,3,2,2,gene,W08F4.6,0,572105,3.97952,2790,574898,3,572108,0,-3
II,-,509096,0.0,0.5,1,1,0,0,0,gene,T27A1.7,0,509086,0.00143179,21751,530847,10,509325,-229,-239
II,-,506015,0.0,0.125,3,3,0,0,0,gene,T27A1.1,0,506013,0.00520858,2227,508242,2,506013,2,0
II,-,484385,0.0232558,5.1355e-34,129,126,3,3,5,gene,W07E6.2,0,484377,0.854821,18841,503226,8,484385,0,-8
II,-,475939,0.0121951,0.0,246,243,3,2,2,gene,W07E6.1,1,475934,1.49727,4782,480721,5,475939,0,-5
II,-,470474,0.879781,0.0,1098,132,966,684,1,gene,W10D9.5,2,470469,3.33882,767,471241,5,470474,0,-5
II,-,470432,1.0,0.25,2,0,2,2,263,gene,W10D9.5,2,470420,3.33882,809,471241,12,470474,-42,-54
II,-,467364,0.791367,9.82553e-13,139,29,110,71,1,gene,W10D9.4,3,467335,0.563388,623,467987,29,467364,0,-29
II,-,460322,0.84375,7.73006e-20,160,25,135,83,1,gene,W10D9.3,4,460310,0.442551,1344,461666,12,460310,12,0
II,-,457883,0.908397,1.4013e-45,262,24,238,158,1,gene,W10D9.6,5,457870,None,884,458767,13,457885,-2,-15
II,-,453348,0.0,0.00390625,8,8,0,0,0,gene,W10D9.2,0,453338,0.0457568,2772,456120,10,453147,201,191
II,-,419378,0.0,0.5,1,1,0,0,0,gene,C24H12.6,0,419376,0.00849405,1695,421073,2,418881,497,495
II,-,410927,0.0,0.0,317,317,0,0,3,gene,C24H12.5,0,410918,0.435701,6416,417343,9,410918,9,0
II,-,385357,0.0,3.30872e-24,78,78,0,0,0,gene,C03H5.5,0,385353,0.196629,10737,396094,4,385353,4,0
II,-,385317,0.0,0.000488281,11,11,0,0,28,gene,C03H5.5,0,385098,0.196629,10777,396094,219,385353,-36,-255
II,-,367552,0.0105263,2.39814e-27,95,94,1,0,1,gene,C41D7.2,0,367423,0.276619,14756,382308,129,367423,129,0
II,-,367425,0.0,0.25,2,2,0,0,1,gene,C41D7.2,0,367423,0.276619,14883,382308,2,367423,2,0
II,-,357066,0.0,9.31323e-10,30,30,0,0,0,gene,C41D7.1,0,357028,0.0142995,5425,362491,38,357457,-391,-429
II,-,350591,0.0,0.25,2,2,0,0,0,gene,D1069.4,0,350586,0.0517738,11900,362491,5,350586,5,0
II,-,347844,0.0,0.5,1,1,0,0,8,gene,D1069.3,0,347805,0.51567,326,348170,39,347860,-16,-55
II,-,332512,0.0,3.15544e-30,98,98,0,0,0,gene,K01A2.11,0,332510,0.386204,9205,341717,2,332512,0,-2
II,-,323095,0.000931099,0.0,1074,1073,1,0,0,gene,K01A2.10,0,323094,1.11978,5490,328585,1,323097,-2,-3
II,-,285687,0.0138889,0.0,216,213,3,3,3,gene,B0432.10,1,285678,0.228641,8176,293863,9,285687,0,-9
II,-,283693,0.833333,7.29559e-10,78,13,65,36,2,gene,B0432.9,2,283682,0.119398,193,283886,11,283682,11,0
II,-,282575,0.27551,8.12942e-11,196,142,54,42,12,gene,B0432.13,3,282560,0.317526,1,282576,15,282575,0,-15
II,-,278735,0.930233,6.07661e-18,86,6,80,65,0,gene,B0432.8,4,278731,0.281679,400,279135,4,278731,4,0
II,-,273965,0.485437,0.0751058,103,53,50,39,1,gene,B0432.7,5,273902,0.217044,2461,276426,63,273965,0,-63
II,-,255193,0.0,0.0,437,437,0,0,0,gene,Y43H11AL.3,1,255186,0.724825,10657,265850,7,255181,12,5
II,-,237820,0.737374,5.20453e-12,198,52,146,89,0,gene,Y43H11AL.2,2,237805,1.00835,2900,240720,15,237820,0,-15
II,-,232749,0.966102,2.96811e-15,59,2,57,43,4,gene,Y43H11AL.1,3,232717,1.2389,91,232840,32,232719,30,-2
II,-,232738,0.967585,0.0,617,20,597,438,238,gene,Y43H11AL.1,3,232717,1.2389,102,232840,21,232738,0,-21
II,-,232719,1.0,0.0625,4,0,4,2,1490,gene,Y43H11AL.1,3,232717,1.2389,121,232840,2,232719,0,-2
II,-,220640,0.19477,0.0,2218,1786,432,307,56,gene,F48A11.5,4,220620,2.68203,1998,222638,20,220620,20,0
II,-,216620,0.242105,2.01978e-13,190,144,46,41,0,gene,F48A11.4,5,216616,0.610469,249,216869,4,216620,0,-4
II,-,179093,0.000982801,0.0,2035,2033,2,2,1,gene,T01D1.4,0,179051,3.14033,8276,187369,42,179093,0,-42
II,-,175642,0.00537634,0.0,186,185,1,0,2,gene,T01D1.3,0,175638,0.549222,1354,176996,4,175642,0,-4
II,-,156024,0.0,0.0625,4,4,0,0,39,gene,T25D3.2,0,156007,1.31653,5927,161951,17,156043,-19,-36
II,-,156009,0.00740741,0.0,270,268,2,2,159,gene,T25D3.2,0,156007,1.31653,5942,161951,2,156043,-34,-36
II,-,133598,0.00796813,0.0,251,249,2,1,8,gene,K10B4.6,0,133582,0.65999,21189,154787,16,133592,6,-10
II,-,133591,0.0,0.03125,5,5,0,0,126,gene,K10B4.6,0,133582,0.65999,21196,154787,9,133592,-1,-10
II,-,125002,0.0,0.015625,6,6,0,0,0,gene,K10B4.4,0,125002,0.0142751,1865,126867,0,125002,0,0
II,-,121220,0.00757576,2.42446e-38,132,131,1,1,0,gene,K10B4.3,0,121208,0.548414,2117,123337,12,121208,12,0
II,-,121191,0.0,0.00195312,9,9,0,0,108,gene,K10B4.3,0,121132,0.548414,2146,123337,59,121208,-17,-76
II,-,97944,0.00155521,0.0,643,642,1,1,1,gene,C50D2.8,1,97942,0.506417,16487,114431,2,97942,2,0
II,-,95277,0.68932,1.5921e-08,206,64,142,86,0,gene,C50D2.7,2,95256,0.917858,848,96125,21,95277,0,-21
II,-,95269,0.666667,0.164062,9,3,6,1,340,gene,C50D2.7,2,95256,0.917858,856,96125,13,95277,-8,-21
II,-,91519,0.820106,1.98152e-38,378,68,310,230,2,gene,C50D2.9,3,91519,0.46948,664,92183,0,91519,0,0
II,-,55304,0.0,1.13687e-13,43,43,0,0,1,gene,C23H3.7,0,55304,0.161268,16370,71674,0,55304,0,0
II,-,46216,0.0,0.25,2,2,0,0,106,gene,F23F1.8,1,46181,3.631,6795,53011,35,46216,0,-35
II,-,43662,0.0051247,0.0,2927,2912,15,10,10,gene,F23F1.8,1,43659,3.631,9349,53011,3,43662,0,-3
II,-,41982,0.962527,0.0,934,35,899,703,1,gene,F23F1.10,2,41978,2.00442,221,42203,4,41978,4,0
II,-,39537,0.0,6.61744e-24,77,77,0,0,0,gene,F23F1.7,0,39487,0.531942,1933,41470,50,39487,50,0
II,-,37313,0.0,3.30872e-24,78,78,0,0,0,gene,F23F1.6,0,37302,0.12231,1247,38560,11,37313,0,-11
II,-,31582,0.00606061,0.0,660,656,4,3,3,gene,F23F1.5,0,31574,1.16033,3658,35240,8,31574,8,0
II,-,28280,0.0245098,0.0,204,199,5,4,21,gene,F23F1.4,0,28279,0.470076,1641,29921,1,28418,-138,-139
III,-,13771104,0.00402414,0.0,994,990,4,4,9,gene,K08E3.6,0,13771103,2.73399,0,0,1,13771104,0,-1
III,-,13767972,0.0230474,0.0,781,763,18,15,6,gene,K08E3.5,0,13767964,5.21781,453,13768425,8,13767973,-1,-9
III,-,13767667,0.0,0.015625,6,6,0,0,16,gene,K08E3.5,0,13767630,5.21781,758,13768425,37,13767798,-131,-168
III,-,13766043,0.00921659,0.0,217,215,2,2,9,gene,K08E3.5,0,13766033,5.21781,2382,13768425,10,13766043,0,-10
III,-,13766040,0.0,0.0,177,177,0,0,29,gene,K08E3.5,0,13766033,5.21781,2385,13768425,7,13766040,0,-7
III,-,13761949,0.13079,0.0,734,638,96,76,6,gene,K08E3.4,0,13761949,1.38072,1993,13763942,0,13761949,0,0
III,-,13731559,0.0,0.0,380,380,0,0,0,gene,W06F12.2,0,13731532,0.928886,15741,13747300,27,13731559,0,-27
III,-,13686400,0.0,0.00390625,8,8,0,0,26,gene,ZK520.3,0,13686325,0.0994959,40120,13726520,75,13686325,75,0
III,-,13678712,0.0,0.25,2,2,0,0,1,gene,ZK520.3,0,13678677,0.0994959,47808,13726520,35,13678712,0,-35
III,-,13678437,0.0,0.5,1,1,0,0,0,gene,ZK520.3,0,13678437,0.0994959,48083,13726520,0,13678437,0,0
III,-,13643450,0.0268336,0.0,559,544,15,14,33,gene,T12D8.2,1,13643418,3.31478,19832,13663282,32,13643450,0,-32
III,-,13642207,0.939877,0.0,1630,98,1532,1065,6,gene,T12D8.10,2,13642207,3.71764,93,13642300,0,13642207,0,0
III,-,13641568,0.956522,1.13926e-42,184,8,176,135,0,gene,T12D8.3,3,13641568,0.643786,105,13641673,0,13641568,0,0
III,-,13641535,0.0,0.5,1,1,0,0,81,gene,T12D8.3,3,13641522,0.643786,138,13641673,13,13641568,-33,-46
III,-,13630688,0.0075188,1.22141e-38,133,132,1,1,1,gene,T12D8.4,0,13630667,0.594927,9085,13639773,21,13630688,0,-21
III,-,13626532,0.0,0.0078125,7,7,0,0,9,gene,T12D8.5,0,13626506,2.20983,343,13626875,26,13626411,121,95
III,-,13626409,0.00251731,0.0,1589,1585,4,2,8,gene,T12D8.5,0,13626408,2.20983,466,13626875,1,13626411,-2,-3
III,-,13622106,0.00324977,0.0,4308,4294,14,10,107,gene,T12D8.8,0,13622103,4.29592,3741,13625847,3,13622106,0,-3
III,-,13605946,0.0034626,0.0,5776,5756,20,17,1,gene,T25C8.2,0,13605946,24.6854,8633,13614579,0,13605946,0,0
III,-,13570327,0.0,8.47033e-22,70,70,0,0,0,gene,T05D4.3,0,13570266,0.151126,31234,13601561,61,13570327,0,-61
III,-,13565277,0.0,0.5,1,1,0,0,0,gene,T05D4.1,0,13565268,7.26974,1480,13566757,9,13564870,407,398
III,-,13564817,0.007109,0.0,2110,2095,15,11,295,gene,T05D4.1,0,13564799,7.26974,1940,13566757,18,13564817,0,-18
III,-,13555214,0.00526316,0.0,190,189,1,0,0,gene,Y76A2B.6,1,13555166,0.544227,6390,13561604,48,13555214,0,-48
III,-,13548885,0.113117,0.0,4155,3685,470,364,21,gene,Y76A2B.5,2,13548884,3.87968,1615,13550500,1,13548885,0,-1
III,-,13546676,0.916667,1.64509e-05,24,2,22,12,2,gene,Y76A2B.4,3,13546637,0.690556,98,13546774,39,13546637,39,0
III,-,13546655,0.824242,3.58473e-18,165,29,136,94,44,gene,Y76A2B.4,3,13546637,0.690556,18,13546673,18,13546637,18,0
III,-,13543414,0.00398406,0.0,502,500,2,2,0,gene,Y76A2B.3,0,13543409,1.48643,1766,13545180,5,13543414,0,-5
III,-,13523997,0.0,4.93038e-32,104,104,0,0,1,gene,Y76A2B.1,1,13523973,3.94687,16022,13540019,24,13523973,24,0
III,-,13523990,0.00607533,0.0,823,818,5,5,55,gene,Y76A2B.1,1,13523973,3.94687,16029,13540019,17,13523973,17,0
III,-,13514450,0.840909,2.65104e-21,176,28,148,104,0,gene,T28A8.7,2,13514439,0.507431,371,13514821,11,13514450,0,-11
III,-,13489384,0.0,0.00390625,8,8,0,0,2,gene,T28A8.1,0,13489384,0.0508237,4546,13493930,0,13489059,325,325
III,-,13484035,0.0,2.32831e-10,32,32,0,0,0,gene,T27E9.9,0,13484014,0.153106,2407,13486442,21,13484035,0,-21
III,-,13466217,0.0,0.5,1,1,0,0,82,gene,T27E9.3,0,13466175,0.980104,9023,13475240,42,13466270,-53,-95
III,-,13462472,0.00329995,0.0,8788,8759,29,27,28,gene,T27E9.2,1,13462464,15.4058,2092,13464564,8,13462473,-1,-9
III,-,13462465,0.00309811,0.0,2905,2896,9,8,1093,gene,T27E9.2,1,13462464,15.4058,2099,13464564,1,13462473,-8,-9
III,-,13462118,0.00245027,0.0,6938,6921,17,13,1,gene,T27E9.7,2,13462087,9.72181,119,13462237,31,13462118,0,-31
III,-,13455187,0.393443,9.82917e-06,366,222,144,114,1,gene,Y76A2A.2,3,13455164,0.649944,2391,13457578,23,13455187,0,-23
III,-,13452493,0.0,2.27374e-13,42,42,0,0,0,gene,Y76A2A.2,3,13452479,0.649944,5085,13457578,14,13452493,0,-14
III,-,13439434,0.73913,0.0120338,23,6,17,12,6,gene,F45G2.10,4,13439405,1.15954,176,13439610,29,13439466,-32,-61
III,-,13439422,0.738162,4.78049e-39,718,188,530,412,281,gene,F45G2.10,4,13439405,1.15954,188,13439610,17,13439466,-44,-61
III,-,13436823,0.916667,6.35688e-25,132,11,121,84,10,gene,F45G2.9,5,13436810,0.227447,110,13436933,13,13436823,0,-13
III,-,13436793,1.0,0.125,3,0,3,2,97,gene,F45G2.9,5,13436792,0.227447,140,13436933,1,13436823,-30,-31
III,-,13435550,0.926537,0.0,1334,98,1236,789,2,gene,F45G2.8,6,13435543,0.845945,102,13435652,7,13435550,0,-7
III,-,13434384,0.775194,8.85804e-11,129,29,100,74,1,gene,F45G2.7,7,13434378,0.477743,355,13434739,6,13434378,6,0
III,-,13429597,0.0,9.53674e-07,20,20,0,0,85,gene,F45G2.5,0,13429593,0.184139,3732,13433329,4,13429593,4,0
III,-,13398318,0.0,0.25,2,2,0,0,0,gene,F11F1.8,0,13398317,0,2481,13400799,1,13398317,1,0
III,-,13376590,0.00547445,0.0,548,545,3,2,2,gene,T03F6.5,0,13376519,1.48663,1151,13377741,71,13376590,0,-71
III,-,13364661,0.0,0.5,1,1,0,0,0,gene,T03F6.8,0,13364641,0.0257957,642,13365303,20,13364641,20,0
III,-,13359234,0.0,2.98023e-08,25,25,0,0,0,gene,F53A2.9,0,13359164,0.191135,1864,13361098,70,13359157,77,7
III,-,13339646,0.0,1.11022e-16,53,53,0,0,2,gene,F53A2.3,0,13339640,0.262722,16128,13355774,6,13339640,6,0
III,-,13324462,0.0,3.55271e-15,48,48,0,0,5,gene,F53A2.1,0,13324451,0.0854422,12351,13336813,11,13324719,-257,-268
III,-,13292963,0.0188679,0.0,318,312,6,5,23,gene,Y43F4B.3,0,13292957,0.690747,444,13293407,6,13292957,6,0
III,-,13268763,0.00388601,0.0,772,769,3,2,2,gene,F56A8.6,0,13268755,1.89588,14946,13283709,8,13268763,0,-8
III,-,13169398,0.00588235,0.0,170,169,1,1,9,gene,Y39E4B.2,0,13169391,0.724905,70488,13239886,7,13169400,-2,-9
III,-,13139504,0.0,4.1359e-25,81,81,0,0,2,gene,Y39E4B.9,0,13139494,0.214271,3688,13143192,10,13139494,10,0
III,-,13137879,0.0,7.52316e-37,120,120,0,0,6,gene,Y39E4B.9,0,13137816,0.214271,5313,13143192,63,13137879,0,-63
III,-,13099335,0.0,0.0,1334,1334,0,0,0,gene,Y39E4B.3,0,13099335,4.11782,34468,13133803,0,13099335,0,0
III,-,13000391,0.0,9.09495e-13,40,40,0,0,1,gene,ZK1010.8,0,13000351,0.141047,27869,13028260,40,13000391,0,-40
III,-,12993587,0.000103734,0.0,9640,9639,1,1,1,gene,ZK1010.7,0,12993573,7.62659,2020,12995607,14,12993584,3,-11
III,-,12978403,0.00392533,0.0,102157,101756,401,371,61,gene,ZK1010.1,1,12978401,134.271,5983,12984386,2,12978403,0,-2
III,-,12977742,0.915254,0.0,354,30,324,255,5,gene,ZK1010.2,2,12977742,0.599834,10,12977752,0,12977742,0,0
III,-,12972378,0.0,0.0625,4,4,0,0,1,gene,Y39E4A.3,1,12972277,1.87928,2570,12974948,101,12972378,0,-101
III,-,12971700,0.0111111,7.27014e-26,90,89,1,1,6,gene,Y39E4A.3,1,12971700,1.87928,3248,12974948,0,12971700,0,0
III,-,12966875,0.232323,3.02075e-08,99,76,23,13,0,gene,Y39E4A.2,2,12966872,0.738493,945,12967820,3,12966875,0,-3
III,-,12956896,0.0,0.0,356,356,0,0,8,gene,Y39E4A.2,2,12956892,0.738493,7954,12964850,4,12956892,4,0
III,-,12931747,0.0102041,0.0,294,291,3,2,0,gene,Y37D8A.21,0,12931741,0.988093,21102,12952849,6,12931747,0,-6
III,-,12925889,0.0625,0.000244141,16,15,1,1,0,gene,Y37D8A.17,0,12925862,1.29928,2361,12928250,27,12925862,27,0
III,-,12925877,0.00184587,0.0,2167,2163,4,4,38,gene,Y37D8A.17,0,12925862,1.29928,2373,12928250,15,12925862,15,0
III,-,12918553,0.00167392,0.0,2987,2982,5,3,2,gene,Y37D8A.16,0,12918550,2.88096,2730,12921283,3,12918555,-2,-5
III,-,12891618,0.00756144,0.0,529,525,4,3,0,gene,Y37D8A.13,0,12891560,1.08672,23384,12915002,58,12891618,0,-58
III,-,12877457,0.0142232,0.0,914,901,13,9,2,gene,Y37D8A.11,0,12877457,0.670805,3462,12880919,0,12877457,0,0
III,-,12874534,0.00462535,0.0,1081,1076,5,5,0,gene,Y37D8A.9,0,12874534,3.08244,1087,12875621,0,12874534,0,0
III,-,12857791,0.00104275,0.0,1918,1916,2,2,2,gene,Y37D8A.6,0,12857776,2.53451,11302,12869093,15,12857776,15,0
III,-,12838837,0.00312891,0.0,1598,1593,5,5,4,gene,Y37D8A.4,0,12838833,1.30489,15098,12853935,4,12838833,4,0
III,-,12820130,0.00478469,0.0,418,416,2,1,102,gene,Y37D8A.25,0,12820112,0.863625,16942,12837072,18,12820112,18,0
III,-,12817980,0.021875,0.0,640,626,14,7,0,gene,Y37D8A.1,0,12817976,1.7231,556,12818536,4,12817982,-2,-6
III,-,12798037,0.0,0.0,292,292,0,0,3,gene,BE10.2,0,12798010,0.556825,8017,12806054,27,12798037,0,-27
III,-,12779606,0.008,2.93874e-36,125,124,1,0,0,gene,ZC482.1,0,12779605,0.0885835,7917,12787523,1,12779606,0,-1
III,-,12687796,0.00998424,0.0,1903,1884,19,15,2,gene,Y111B2A.18,0,12687786,11.3234,5585,12693381,10,12687796,0,-10
III,-,12673301,0.00554939,0.0,901,896,5,5,2,gene,Y111B2A.16,0,12673295,0.621308,12821,12686122,6,12673303,-2,-8
III,-,12662166,0.212698,5.14728e-26,315,248,67,53,5,gene,Y111B2A.15,0,12662144,1.08447,9080,12671246,22,12662149,17,-5
III,-,12608347,0.0,0.000244141,12,12,0,0,66,gene,Y111B2A.11,0,12608329,2.25567,7842,12616189,18,12608347,0,-18
III,-,12598562,0.4,0.205078,10,6,4,2,2,gene,Y111B2A.10,0,12598408,1.22198,763,12599325,154,12598408,154,0
III,-,12598045,0.019802,1.99187e-27,101,99,2,1,17,gene,Y111B2A.10,0,12598035,1.22198,1280,12599325,10,12598045,0,-10
III,-,12575256,0.0,0.0,259,259,0,0,143,gene,Y111B2A.9,0,12575246,0.526016,11755,12587011,10,12575246,10,0
III,-,12562979,0.0,1.2326e-32,106,106,0,0,2,gene,Y111B2A.9,0,12562958,0.526016,24032,12587011,21,12562958,21,0
III,-,12547961,0.00284091,0.0,352,351,1,1,0,gene,Y111B2A.8,0,12547943,0.972184,11619,12559580,18,12547961,0,-18
III,-,12495518,0.0,2.27374e-13,42,42,0,0,0,gene,Y111B2A.1,0,12495518,0.180967,43242,12538760,0,12495688,-170,-170
III,-,12456730,0.00440529,0.0,227,226,1,1,0,gene,Y49E10.20,0,12456726,1.16851,31827,12488557,4,12456730,0,-4
III,-,12453082,0.00268097,0.0,1119,1116,3,3,1,gene,Y49E10.19,0,12453064,2.06949,383,12453465,18,12453082,0,-18
III,-,12445938,0.333333,0.375,3,2,1,1,627,gene,Y49E10.18,0,12445864,1.23895,299,12446237,74,12445999,-61,-135
III,-,12429508,0.00460702,0.0,10853,10803,50,44,0,gene,Y49E10.15,0,12429494,15.3143,13002,12442510,14,12429508,0,-14
III,-,12421401,0.00468384,0.0,427,425,2,2,2,gene,Y49E10.11,0,12421386,1.00223,7774,12429175,15,12421385,16,1
III,-,12420602,0.0,0.000244141,12,12,0,0,3,gene,Y49E10.11,0,12420544,1.00223,8573,12429175,58,12420544,58,0
III,-,12383707,0.0,0.5,1,1,0,0,0,gene,Y49E10.5,0,12383624,None,7283,12390990,83,12383624,83,0
III,-,12380466,0.0,9.31323e-10,30,30,0,0,81,gene,Y49E10.4,0,12380442,0.488652,10524,12390990,24,12380492,-26,-50
III,-,12378641,0.0,0.125,3,3,0,0,1,gene,Y49E10.7,0,12378596,None,225,12378866,45,12378709,-68,-113
III,-,12377128,0.00273598,0.0,1462,1458,4,1,2,gene,Y49E10.3,1,12377128,0.841536,513,12377641,0,12377130,-2,-2
III,-,12373737,0.86044,0.0,910,127,783,520,2,gene,Y49E10.2,2,12373721,1.45848,316,12374053,16,12373737,0,-16
III,-,12368044,0.00287988,0.0,19098,19043,55,48,112,gene,Y49E10.6,0,12368037,26.2574,3928,12371972,7,12368044,0,-7
III,-,12358441,0.0,7.62939e-06,17,17,0,0,3,gene,Y75B8A.32,0,12358406,0.0486718,3296,12361737,35,12358441,0,-35
III,-,12351216,0.0056926,0.0,527,524,3,2,1,gene,Y75B8A.30,0,12351210,1.32004,3535,12354751,6,12351218,-2,-8
III,-,12274059,0.0,3.63798e-12,38,38,0,0,1,gene,Y75B8A.24,0,12274048,0.556767,9005,12283064,11,12273560,499,488
III,-,12250042,0.0153846,0.0,195,192,3,3,1,gene,Y75B8A.22,0,12250034,0.575692,1298,12251340,8,12250034,8,0
III,-,12226098,0.0,0.25,2,2,0,0,691,gene,Y75B8A.18,1,12226073,1.18876,6416,12232514,25,12226122,-24,-49
III,-,12226057,0.0,5.42101e-20,64,64,0,0,622,gene,Y75B8A.18,1,12226014,1.18876,6457,12232514,43,12226122,-65,-108
III,-,12225211,0.452667,1.00757e-07,2662,1457,1205,951,19,gene,Y75B8A.17,2,12225211,2.02275,307,12225518,0,12225211,0,0
III,-,12218514,0.00259403,0.0,771,769,2,2,1,gene,Y75B8A.14,1,12218508,0.903173,5852,12224366,6,12218514,0,-6
III,-,12215573,0.829545,1.02529e-10,88,15,73,44,1,gene,Y75B8A.13,2,12215566,0.422719,1084,12216657,7,12215566,7,0
III,-,12177125,0.0,3.55271e-15,48,48,0,0,0,gene,Y75B8A.9,0,12177123,0.218785,3543,12180668,2,12177125,0,-2
III,-,12130225,0.00456621,0.0,219,218,1,1,0,gene,Y75B8A.6,0,12130219,0.986938,19279,12149504,6,12130219,6,0
III,-,12118361,0.0,3.05176e-05,15,15,0,0,0,gene,Y75B8A.5,0,12118350,0.270745,5462,12123823,11,12118350,11,0
III,-,12084197,0.0,0.0,189,189,0,0,0,gene,Y75B8A.2,0,12084148,0.534345,17428,12101625,49,12084197,0,-49
III,-,12077437,0.0120563,0.0,1493,1475,18,10,15,gene,Y75B8A.1,0,12077383,0.716031,1,12077438,54,12077437,0,-54
III,-,12058339,0.00858369,0.0,466,462,4,4,35,gene,Y79H2A.6,1,12058336,2.11044,15655,12073994,3,12058339,0,-3
III,-,12052184,0.813131,4.72115e-20,198,37,161,124,1,gene,Y79H2A.3,2,12052174,0.629278,119,12052303,10,12052184,0,-10
III,-,12030515,0.0909091,0.00537109,11,10,1,1,2,gene,Y79H2A.2,0,12030440,0.273666,901,12031416,75,12030515,0,-75
III,-,12002831,0.0,1.38778e-17,56,56,0,0,0,gene,Y56A3A.33,0,12002821,0.287099,22525,12025356,10,12002831,0,-10
III,-,11978946,0.0,0.0,374,374,0,0,1,gene,Y56A3A.30,1,11978944,0.200354,20506,11999452,2,11978946,0,-2
III,-,11973971,0.00943396,0.0,530,525,5,5,1,gene,Y56A3A.29,2,11973970,1.06107,25,11973996,1,11973973,-2,-3
III,-,11971248,0.302326,6.60853e-08,172,120,52,40,0,gene,Y56A3A.28,3,11971239,0.409615,96,11971344,9,11971239,9,0
III,-,11960061,0.77381,1.99615e-13,168,38,130,104,0,gene,Y56A3A.27,4,11960049,0.230492,700,11960761,12,11960061,0,-12
III,-,11946898,0.00142248,0.0,703,702,1,0,0,gene,Y56A3A.7,1,11946890,1.06294,2890,11949788,8,11946898,0,-8
III,-,11933520,0.730612,1.00332e-13,245,66,179,128,2,gene,Y56A3A.36,2,11933519,0.240241,359,11933879,1,11933519,1,0
III,-,11920118,0.00613497,0.0,815,810,5,5,1,gene,Y56A3A.20,1,11920101,2.89417,9627,11929745,17,11920118,0,-17
III,-,11920112,0.011236,0.0,356,352,4,2,21,gene,Y56A3A.20,1,11920101,2.89417,9633,11929745,11,11920118,-6,-17
III,-,11918600,0.979391,0.0,2135,44,2091,785,31,gene,Y56A3A.18,2,11918594,5.10616,108,11918708,6,11918602,-2,-8
III,-,11915593,0.00306644,0.0,5870,5852,18,15,6,gene,Y56A3A.19,1,11915591,6.5904,2117,11917710,2,11915595,-2,-4
III,-,11914198,0.590571,5.23515e-05,403,165,238,174,1,gene,Y56A3A.16,2,11914195,0.387895,834,11915032,3,11914196,2,-1
III,-,11906790,0.73125,2.79126e-25,480,129,351,247,1,gene,Y56A3A.12,1,11906758,0.730598,2182,11908972,32,11906790,0,-32
III,-,11898150,0.976636,0.0,214,5,209,144,79,gene,Y56A3A.11,2,11898146,0.355362,1068,11899218,4,11898150,0,-4
III,-,11878684,0.0,6.31089e-30,97,97,0,0,58,gene,Y56A3A.6,0,11878684,0.530736,3752,11882436,0,11878684,0,0
III,-,11869162,0.00234742,0.0,426,425,1,1,4,gene,Y56A3A.4,1,11869155,1.53041,1971,11871133,7,11869155,7,0
III,-,11868736,0.00740741,3.09945e-39,135,134,1,0,3,gene,Y56A3A.4,1,11868733,1.53041,2397,11871133,3,11868736,0,-3
III,-,11862130,0.890411,0.0,292,32,260,160,1,gene,Y56A3A.2,2,11862112,1.21766,143,11862273,18,11862130,0,-18
III,-,11846346,0.0476489,0.0,1595,1519,76,66,3,gene,Y56A3A.1,0,11846342,2.62455,4003,11850349,4,11846349,-3,-7
III,-,11838001,0.0,0.0625,4,4,0,0,0,gene,Y56A3A.1,0,11838001,2.62455,12348,11850349,0,11838003,-2,-2
III,-,11833706,0.00234192,0.0,427,426,1,1,0,gene,Y56A3A.1,0,11833578,2.62455,16643,11850349,128,11833706,0,-128
III,-,11822407,0.0,1.13687e-13,43,43,0,0,4,gene,C18D11.2,0,11822349,0.44325,8432,11830839,58,11822396,11,-47
III,-,11785940,0.0,4.44089e-16,51,51,0,0,3,gene,C24H11.3,0,11785933,0.0645732,4456,11790396,7,11785933,7,0
III,-,11773562,0.00244499,0.0,409,408,1,1,0,gene,C24H11.7,0,11773542,1.14779,10402,11783964,20,11773564,-2,-22
III,-,11737508,0.000938967,0.0,3195,3192,3,2,2,gene,Y41C4A.13,0,11737494,3.99181,13625,11751133,14,11737508,0,-14
III,-,11726571,0.0,0.0,158,158,0,0,0,gene,Y41C4A.12,0,11726559,0.207619,6653,11733224,12,11726571,0,-12
III,-,11719331,0.00148662,0.0,4036,4030,6,6,4,gene,Y41C4A.10,1,11719321,2.98793,4588,11723919,10,11719331,0,-10
III,-,11718526,0.763514,3.10747e-11,148,35,113,80,2,gene,Y41C4A.9,2,11718518,0.414588,188,11718714,8,11718526,0,-8
III,-,11708701,0.0,0.0,555,555,0,0,0,gene,Y41C4A.8,0,11708701,0.582777,2027,11710728,0,11708701,0,0
III,-,11636721,0.00769231,9.55089e-38,130,129,1,1,0,gene,Y66A7A.8,0,11636706,0.154169,68815,11705536,15,11636721,0,-15
III,-,11581283,0.00796813,0.0,251,249,2,2,2,gene,Y66D12A.6,1,11581283,0.49963,29840,11611123,0,11581375,-92,-92
III,-,11580369,1.0,0.5,1,0,1,1,2,gene,Y66D12A.7,2,11580351,0.317294,161,11580530,18,11580691,-322,-340
III,-,11580359,0.470149,0.0302478,268,142,126,104,4,gene,Y66D12A.7,2,11580351,0.317294,171,11580530,8,11580691,-332,-340
III,-,11523640,0.0,0.0,594,594,0,0,13,gene,Y66D12A.17,0,11523639,0.348116,49277,11572917,1,11523640,0,-1
III,-,11505170,0.0227273,0.0,396,387,9,5,2,gene,Y66D12A.21,1,11505153,0.375612,7571,11512741,17,11505158,12,-5
III,-,11502731,0.920448,0.0,1697,135,1562,877,1,gene,Y66D12A.22,2,11502715,3.51551,550,11503281,16,11502731,0,-16
III,-,11487226,0.78626,9.28921e-42,524,112,412,292,1,gene,Y66A7A.2,2,11487206,0.865663,1010,11488236,20,11487206,20,0
III,-,11470687,0.00321543,0.0,622,620,2,2,22,gene,Y47D3B.9,0,11470686,1.17108,11780,11482467,1,11470686,1,0
III,-,11442447,0.00680272,8.23963e-43,147,146,1,0,0,gene,Y47D3B.7,0,11442446,0.403096,21098,11463545,1,11442447,0,-1
III,-,11393100,0.0,4.44089e-16,51,51,0,0,1411,gene,Y47D3B.2,0,11393065,1.95915,35150,11428250,35,11393065,35,0
III,-,11377861,0.00663717,0.0,452,449,3,3,0,gene,Y47D3B.10,0,11377860,2.74405,10644,11388505,1,11377861,0,-1
III,-,11371667,0.0,4.48416e-44,144,144,0,0,0,gene,T28D6.2,0,11371656,0.372087,1095,11372762,11,11371656,11,0
III,-,11342989,0.000677048,0.0,1477,1476,1,1,0,gene,T28D6.6,0,11342959,2.14712,1044,11344033,30,11342989,0,-30
III,-,11316937,0.00740741,3.09945e-39,135,134,1,1,2,gene,Y47D3A.27,1,11316930,0.402752,5970,11322907,7,11316937,0,-7
III,-,11311448,0.844898,0.0,490,76,414,264,1,gene,Y47D3A.25,2,11311428,1.18886,666,11312114,20,11311448,0,-20
III,-,11286001,0.00544465,0.0,551,548,3,1,0,gene,Y47D3A.23,2,11286000,0.467427,215,11286216,1,11286000,1,0
III,-,11278799,0.938614,0.0,1010,62,948,691,1,gene,Y47D3A.21,3,11278798,0.715515,116,11278915,1,11278798,1,0
III,-,11270715,0.0967742,2.09315e-06,31,28,3,2,23,gene,Y47D3A.17,0,11270629,0.838795,5459,11276174,86,11270741,-26,-112
III,-,11269903,0.0810811,5.65342e-08,37,34,3,3,1,gene,Y47D3A.17,0,11269885,0.838795,6271,11276174,18,11269903,0,-18
III,-,11267596,0.0,9.09495e-13,40,40,0,0,1,gene,Y47D3A.17,0,11267584,0.838795,8578,11276174,12,11267596,0,-12
III,-,11266228,0.0,0.5,1,1,0,0,0,gene,Y47D3A.17,0,11266185,0.838795,9946,11276174,43,11266230,-2,-45
III,-,11260950,0.0,5.42101e-20,64,64,0,0,0,gene,Y47D3A.17,0,11260949,0.838795,15224,11276174,1,11260950,0,-1
III,-,11236750,0.0212766,2.20679e-25,94,92,2,1,19,gene,Y47D3A.14,0,11236737,0.298298,20430,11257180,13,11236742,8,-5
III,-,11195082,0.0,1.19209e-07,23,23,0,0,0,gene,Y47D3A.6,0,11195079,0.733004,21192,11216274,3,11194942,140,137
III,-,11169959,1.0,0.25,2,0,2,2,0,gene,Y47D3A.5,0,11169947,0.0359297,812,11170771,12,11170443,-484,-496
III,-,11141526,0.0,4.76837e-07,21,21,0,0,5,gene,Y47D3A.1,0,11141517,0.190447,14965,11156491,9,11141707,-181,-190
III,-,11138943,0.571429,0.273438,7,3,4,3,11,gene,Y47D3A.2,0,11138881,0.0739219,179,11139122,62,11138776,167,105
III,-,11138780,0.047619,1.00136e-05,21,20,1,1,0,gene,Y47D3A.2,0,11138776,0.0739219,342,11139122,4,11138776,4,0
III,-,11119102,0.0104167,1.21169e-27,96,95,1,1,0,gene,Y48A6C.3,0,11119081,0,7643,11126745,21,11119081,21,0
III,-,11116117,0.857143,0.000634193,21,3,18,15,18,gene,Y48A6C.2,0,11116104,None,66,11116183,13,11116104,13,0
III,-,11099846,0.710938,6.08985e-07,128,37,91,74,7,gene,W09D6.6,2,11099833,0.573886,1034,11100880,13,11099833,13,0
III,-,11026448,0.00205128,0.0,975,973,2,2,3,gene,Y48A6B.7,0,11026423,2.06921,682,11027130,25,11026448,0,-25
III,-,11007526,0.0,7.34684e-40,130,130,0,0,1,gene,Y48A6B.4,0,11007484,20.3123,17594,11025120,42,11007502,24,-18
III,-,10995136,0.0,4.76837e-07,21,21,0,0,0,gene,Y48A6B.1,0,10995134,0.0758139,12161,11007297,2,10995119,17,15
III,-,10953397,0.0,0.25,2,2,0,0,1,gene,Y48A6A.1,0,10953387,0.879681,6532,10959929,10,10953387,10,0
III,-,10953388,0.00156006,0.0,641,640,1,1,1,gene,Y48A6A.1,0,10953387,0.879681,6541,10959929,1,10953387,1,0
III,-,10880065,0.0,0.0,614,614,0,0,0,gene,C44B9.3,0,10880046,0.834434,71042,10951107,19,10879977,88,69
III,-,10868585,0.00319635,0.0,13140,13098,42,37,2,gene,Y39A1C.3,0,10868501,15.0348,9466,10878051,84,10868585,0,-84
III,-,10868578,0.0,0.0625,4,4,0,0,1217,gene,Y39A1C.3,0,10868501,15.0348,9473,10878051,77,10868585,-7,-84
III,-,10844774,0.0,0.0625,4,4,0,0,47,gene,R17.2,0,10844608,0.36383,2708,10847482,166,10844817,-43,-209
III,-,10844763,0.0,7.45058e-09,27,27,0,0,35,gene,R17.2,0,10844608,0.36383,2719,10847482,155,10844817,-54,-209
III,-,10816726,0.00358038,0.0,2793,2783,10,9,1,gene,K11D9.2,0,10816692,19.3839,23036,10839762,34,10816726,0,-34
III,-,10816700,0.0,0.03125,5,5,0,0,7490,gene,K11D9.2,0,10816692,19.3839,23062,10839762,8,10816726,-26,-34
III,-,10815841,0.0,0.125,3,3,0,0,2,gene,K11D9.2,0,10815834,19.3839,23921,10839762,7,10815841,0,-7
III,-,10800981,0.00625,0.0,160,159,1,0,39,gene,K11D9.3,0,10800980,0.609917,10587,10811568,1,10800981,0,-1
III,-,10758918,0.0,0.25,2,2,0,0,2,gene,K01G5.10,1,10758900,0.304011,37664,10796582,18,10758400,518,500
III,-,10758404,0.0,0.0,228,228,0,0,5,gene,K01G5.10,1,10758400,0.304011,38178,10796582,4,10758400,4,0
III,-,10757522,0.0083682,0.0,239,237,2,1,4,gene,K01G5.1,2,10757519,0.748348,1,10757523,3,10757522,0,-3
III,-,10755403,0.940994,0.0,1288,76,1212,878,5,gene,K01G5.2,3,10755392,2.0385,109,10755512,11,10755392,11,0
III,-,10747610,0.00786959,0.0,8895,8825,70,61,73,gene,K01G5.4,0,10747608,21.429,4526,10752136,2,10747610,0,-2
III,-,10742314,0.00420354,0.0,9040,9002,38,31,54,gene,K01G5.7,1,10742307,17.2957,4148,10746462,7,10742314,0,-7
III,-,10740652,0.844917,0.0,2115,328,1787,1097,5,gene,K01G5.8,2,10740648,4.65131,90,10740742,4,10740648,4,0
III,-,10739683,0.0,0.5,1,1,0,0,5,gene,W09D10.1,3,10739660,1.44194,379,10740062,23,10739668,15,-8
III,-,10739674,0.650602,5.51518e-07,249,87,162,125,61,gene,W09D10.1,3,10739660,1.44194,388,10740062,14,10739674,0,-14
III,-,10739668,0.378788,0.00142062,132,82,50,37,181,gene,W09D10.1,3,10739660,1.44194,394,10740062,8,10739668,0,-8
III,-,10730169,0.0,0.0,322,322,0,0,1,gene,W09D10.2,0,10730150,0.613471,6621,10736790,19,10730056,113,94
III,-,10716073,0.00660066,0.0,303,301,2,1,1,gene,W09D10.4,0,10716049,0.91634,5956,10722029,24,10716073,0,-24
III,-,10711416,0.272727,0.0805664,11,8,3,2,1,gene,W09D10.5,0,10711287,0.23915,287,10711703,129,10711340,76,-53
III,-,10706904,0.0150943,0.0,265,261,4,4,2,gene,Y39A1A.21,1,10706884,0.822794,715,10707619,20,10706904,0,-20
III,-,10700442,0.956376,0.0,298,13,285,194,3,gene,Y39A1A.20,3,10700441,0.613264,47,10700489,1,10700441,1,0
III,-,10685572,1.0,0.5,1,0,1,1,0,gene,Y39A1A.25,0,10685536,None,1435,10687007,36,10685107,465,429
III,-,10633383,0.0,0.0,337,337,0,0,0,gene,Y39A1A.9,0,10633381,0.658243,7327,10640710,2,10633383,0,-2
III,-,10628319,0.0,1.61559e-27,89,89,0,0,420,gene,Y39A1A.8,0,10628308,0.230216,1631,10629950,11,10628308,11,0
III,-,10620092,0.00100604,0.0,1988,1986,2,1,9,gene,Y39A1A.7,0,10620090,2.56848,5724,10625816,2,10620092,0,-2
III,-,10600064,0.0258621,3.05091e-30,116,113,3,3,2,gene,Y39A1A.1,1,10600057,1.60492,1713,10601777,7,10600057,7,0
III,-,10599538,0.0,0.0,489,489,0,0,0,gene,Y39A1A.1,1,10599533,1.60492,2239,10601777,5,10599538,0,-5
III,-,10596369,0.875901,0.0,1249,155,1094,674,1,gene,Y39A1A.3,2,10596350,1.35622,124,10596493,19,10596373,-4,-23
III,-,10595048,0.933333,4.22956e-13,60,4,56,38,10,gene,Y45F3A.9,3,10595044,0.153578,105,10595153,4,10595044,4,0
III,-,10575302,0.00438596,0.0,228,227,1,1,2,gene,Y45F3A.4,0,10575252,0.452516,10426,10585728,50,10575302,0,-50
III,-,10539045,0.0212766,3.33955e-13,47,46,1,0,0,gene,T21C12.3,0,10539045,0.237892,11940,10550985,0,10539047,-2,-2
III,-,10505136,0.00694444,6.45718e-42,144,143,1,1,3,gene,F43D9.5,1,10505132,0.238123,789,10505925,4,10505111,25,21
III,-,10503739,0.88946,0.0,1556,172,1384,987,2,gene,F43D9.2,2,10503737,0.545057,103,10503842,2,10503737,2,0
III,-,10460437,0.00967742,0.0,310,307,3,2,22,gene,D2045.2,0,10460436,0.956473,7515,10467952,1,10460335,102,101
III,-,10442292,0.0131579,1.00585e-21,76,75,1,1,0,gene,H04D03.2,0,10442292,0.161848,3175,10445467,0,10442292,0,0
III,-,10435875,0.00266667,0.0,750,748,2,2,1,gene,M03C11.8,1,10435870,0.789849,2136,10438011,5,10435870,5,0
III,-,10427870,0.864041,0.0,787,107,680,470,1,gene,M03C11.7,2,10427870,0.947174,345,10428215,0,10427870,0,0
III,-,10423894,0.95,2.96811e-14,60,3,57,46,5,gene,M03C11.6,3,10423879,0.1714,84,10423978,15,10423879,15,0
III,-,10407132,0.0,2.38419e-07,22,22,0,0,168,gene,M03C11.4,1,10407131,1.8944,14536,10421668,1,10407565,-433,-434
III,-,10405130,0.629032,0.00113649,124,46,78,58,1,gene,M03C11.2,2,10405126,0.204878,6,10405136,4,10405127,3,-1
III,-,10405127,0.734043,2.06825e-06,94,25,69,59,0,gene,M03C11.2,2,10405126,0.204878,9,10405136,1,10405127,0,-1
III,-,10395972,0.0108696,1.85793e-26,92,91,1,0,6,gene,M03C11.1,0,10395964,0.298256,3138,10399110,8,10395964,8,0
III,-,10386464,0.0,0.0,452,452,0,0,0,gene,C38H2.3,0,10386462,0.439072,2056,10388520,2,10386462,2,0
III,-,10357539,0.00535714,0.0,560,557,3,2,97,gene,T07C4.1,1,10357534,1.3972,27892,10385431,5,10357539,0,-5
III,-,10355409,0.00307929,0.0,1299,1295,4,3,2645,gene,T07C4.4,2,10355408,5.25523,281,10355690,1,10355559,-150,-151
III,-,10341749,0.00793651,0.0,252,250,2,2,0,gene,T07C4.6,0,10341742,0.421513,13264,10355013,7,10341749,0,-7
III,-,10333909,0.0,0.0078125,7,7,0,0,11,gene,T07C4.11,1,10333909,0.256124,5966,10339875,0,10333960,-51,-51
III,-,10332369,0.0,0.0,474,474,0,0,1,gene,T07C4.12,2,10332369,0.87444,48,10332417,0,10332369,0,0
III,-,10330313,0.0122117,0.0,737,728,9,7,0,gene,T07C4.9,0,10330303,1.29623,1055,10331368,10,10330313,0,-10
III,-,10329683,0.0,0.0,171,171,0,0,17,gene,T07C4.9,0,10329602,1.29623,1685,10331368,81,10329683,0,-81
III,-,10318452,0.00244613,0.0,27799,27731,68,57,2,gene,T07A5.5,1,10318450,62.9392,6972,10325424,2,10318450,2,0
III,-,10318053,0.814614,0.0,739,137,602,384,40,gene,T07A5.2,2,10318026,1.68275,111,10318164,27,10318044,9,-18
III,-,10311005,0.4,0.120134,20,12,8,7,0,gene,T07A5.7,0,10310991,None,3389,10314394,14,10310991,14,0
III,-,10261674,0.0,0.5,1,1,0,0,0,gene,R01H10.6,1,10261611,0.157009,18,10261692,63,10261552,122,59
III,-,10258631,0.942857,1.73168e-08,35,2,33,21,2,gene,R01H10.5,2,10258630,0.203487,98,10258729,1,10258630,1,0
III,-,10218538,0.0056444,0.0,1063,1057,6,4,26,gene,T20G5.11,1,10218538,1.23191,9519,10228057,0,10218538,0,0
III,-,10216529,0.191711,0.0,12957,10473,2484,2022,46,gene,T20G5.2,2,10216511,18.8615,664,10217193,18,10216529,0,-18
III,-,10211838,0.354839,3.49236e-10,434,280,154,108,3,gene,T20G5.10,0,10211834,1.11739,2866,10214704,4,10211839,-1,-5
III,-,10201628,0.0,0.125,3,3,0,0,7,gene,T20G5.13,0,10201589,0.0127658,9020,10210648,39,10201220,408,369
III,-,10186154,0.03125,7.45058e-09,32,31,1,1,4,gene,T20G5.6,0,10186154,0.093923,9671,10195825,0,10186154,0,0
III,-,10146705,0.0,0.00390625,8,8,0,0,0,gene,K08E5.1,0,10146695,None,12216,10158921,10,10146695,10,0
III,-,10120041,0.00275989,0.0,1087,1084,3,1,0,gene,ZK1128.4,0,10120041,0.896315,21322,10141363,0,10120041,0,0
III,-,10114653,0.0,7.62939e-06,17,17,0,0,379,gene,ZK1128.1,1,10114648,0.463396,2057,10116710,5,10114653,0,-5
III,-,10114540,0.0,0.25,2,2,0,0,45,gene,ZK1128.1,1,10114486,0.463396,2170,10116710,54,10114653,-113,-167
III,-,10112939,0.929804,0.0,869,61,808,566,1,gene,ZK1128.8,2,10112905,2.35693,100,10113039,34,10112939,0,-34
III,-,10093027,0.0,0.0,420,420,0,0,0,gene,T16H12.5,1,10092971,1.91809,5336,10098363,56,10093027,0,-56
III,-,10090678,0.972881,0.0,295,8,287,221,249,gene,T16H12.4,2,10090672,0.856877,114,10090792,6,10090678,0,-6
III,-,10083569,1.0,0.5,1,0,1,0,4,gene,T16H12.3,0,10083455,0.449021,3547,10087116,114,10083179,390,276
III,-,10083179,0.646226,5.78285e-06,212,75,137,92,1,gene,T16H12.3,0,10083174,0.449021,3937,10087116,5,10083179,0,-5
III,-,10078138,0.0,0.5,1,1,0,0,0,gene,T16G12.9,0,10078108,0.00700111,3198,10081336,30,10078105,33,3
III,-,10016453,0.0,5.73972e-42,137,137,0,0,8,gene,C05B5.7,0,10016429,0.296173,13433,10029886,24,10016429,24,0
III,-,10010978,0.0,0.00012207,13,13,0,0,1,gene,C05B5.10,0,10010970,None,3109,10014087,8,10010960,18,10
III,-,10006679,0.00235571,0.0,849,847,2,1,34,gene,C05B5.8,0,10006671,1.05938,1187,10007866,8,10006679,0,-8
III,-,9973761,0.0714286,5.09717e-12,56,52,4,4,0,gene,R10E12.2,0,9973513,0.878455,13856,9987617,248,9973761,0,-248
III,-,9966589,0.0,4.03897e-28,91,91,0,0,1,gene,R10E12.2,0,9966588,0.878455,21028,9987617,1,9966589,0,-1
III,-,9956112,0.0151515,1.58802e-36,132,130,2,2,5,gene,K03H1.2,1,9956109,0.857575,6943,9963055,3,9956112,0,-3
III,-,9951861,0.916667,1.20529e-20,108,9,99,55,0,gene,K03H1.11,2,9951860,0.607867,93,9951954,1,9951860,1,0
III,-,9941295,0.0,0.5,1,1,0,0,0,gene,K03H1.9,0,9941187,0.0759948,1845,9943140,108,9941295,0,-108
III,-,9926514,0.047619,1.00136e-05,21,20,1,0,51,gene,K03H1.3,0,9926502,0.952616,14118,9940632,12,9926514,0,-12
III,-,9910554,0.00340136,0.0,294,293,1,1,6,gene,F40F12.5,0,9910553,1.36501,2719,9913273,1,9910554,0,-1
III,-,9877621,0.0,0.5,1,1,0,0,9,gene,ZK757.2,0,9877585,0.267382,9485,9887106,36,9877373,248,212
III,-,9877373,0.0,1.0842e-19,63,63,0,0,0,gene,ZK757.2,0,9877264,0.267382,9733,9887106,109,9877373,0,-109
III,-,9871033,0.0,0.00195312,9,9,0,0,0,gene,ZK757.1,0,9871021,0.0347772,3006,9874039,12,9871006,27,15
III,-,9867684,0.00320513,0.0,312,311,1,1,3,gene,ZK757.4,0,9867672,0.755051,778,9868462,12,9867684,0,-12
III,-,9859081,0.0705128,2.54603e-31,156,145,11,8,2,gene,K11H3.1,0,9859032,3.64229,4069,9863150,49,9859081,0,-49
III,-,9856975,0.146179,0.0,2107,1799,308,244,7,gene,K11H3.1,0,9856927,3.64229,6175,9863150,48,9856975,0,-48
III,-,9856970,0.0666667,0.000457764,15,14,1,0,272,gene,K11H3.1,0,9856927,3.64229,6180,9863150,43,9856975,-5,-48
III,-,9848013,0.0205761,0.0,972,952,20,15,7,gene,K11H3.6,0,9848009,3.99555,5921,9853934,4,9848009,4,0
III,-,9827354,0.0,0.015625,6,6,0,0,1,gene,ZK632.10,1,9827335,8.62733,20168,9847522,19,9827269,85,66
III,-,9827077,0.00241025,0.0,7883,7864,19,16,5,gene,ZK632.10,1,9827050,8.62733,20445,9847522,27,9827269,-192,-219
III,-,9825331,0.0558343,0.0,30895,29170,1725,1153,19,gene,ZK632.9,2,9825316,25.9081,694,9826025,15,9825344,-13,-28
III,-,9824661,1.0,0.015625,6,0,6,6,0,gene,ZK632.13,3,9824642,1.0136,111,9824772,19,9824649,12,-7
III,-,9824649,0.804527,4.34403e-44,486,95,391,302,11,gene,ZK632.13,3,9824642,1.0136,123,9824772,7,9824649,0,-7
III,-,9817036,0.0,0.0,1013,1013,0,0,0,gene,ZK632.6,0,9817030,3.56214,6943,9823979,6,9817036,0,-6
III,-,9807353,0.00742459,0.0,2155,2139,16,14,9,gene,ZK632.4,1,9807353,1.73243,6914,9814267,0,9807353,0,0
III,-,9804910,0.610063,1.93914e-05,318,124,194,152,12,gene,ZK632.3,2,9804870,1.18792,501,9805411,40,9804910,0,-40
III,-,9789557,0.0105263,2.39814e-27,95,94,1,0,0,gene,R10E11.5,0,9789541,0.181333,2927,9792484,16,9789541,16,0
III,-,9780248,0.0047619,0.0,210,209,1,1,20,gene,R10E11.4,0,9780213,0.388461,5588,9785836,35,9780219,29,-6
III,-,9762043,0.0,0.0,202,202,0,0,4,gene,T05G5.9,1,9762042,0.52707,16670,9778713,1,9762043,0,-1
III,-,9757414,0.940741,5.08521e-29,135,8,127,82,19,gene,T05G5.8,2,9757414,0.423759,19,9757433,0,9757414,0,0
III,-,9757194,1.0,0.5,1,0,1,1,96,gene,T05G5.8,2,9757188,0.423759,239,9757433,6,9757414,-220,-226
III,-,9752783,0.171714,0.0,3005,2489,516,352,128,gene,T05G5.6,3,9752775,8.08431,788,9753571,8,9752783,0,-8
III,-,9751332,0.944444,5.89659e-24,108,6,102,64,1,gene,T05G5.5,4,9751315,1.26383,3,9751335,17,9751320,12,-5
III,-,9751214,0.526316,0.122156,38,18,20,18,56,gene,T05G5.5,4,9751199,1.26383,121,9751335,15,9751320,-106,-121
III,-,9750868,0.0,0.25,2,2,0,0,3,gene,T05G5.5,4,9750820,1.26383,467,9751335,48,9751320,-452,-500
III,-,9743239,0.00612245,0.0,490,487,3,2,0,gene,T05G5.1,0,9743236,0.982922,2522,9745761,3,9743239,0,-3
III,-,9735950,0.0888889,4.23469e-09,45,41,4,1,1,gene,T05G5.12,0,9735928,4.40503,1421,9737371,22,9735928,22,0
III,-,9727363,0.0153846,1.76183e-18,65,64,1,0,0,gene,C07A9.12,0,9727359,0.261132,7802,9735165,4,9727440,-77,-81
III,-,9720192,0.0,4.33681e-19,61,61,0,0,2,gene,C07A9.11,0,9720188,0.178191,2949,9723141,4,9720192,0,-4
III,-,9713844,0.0,1.86265e-09,29,29,0,0,2,gene,C07A9.4,0,9713829,0.0784454,1943,9715787,15,9713829,15,0
III,-,9696418,0.0,0.03125,5,5,0,0,2,gene,C07A9.2,1,9696300,2.44388,13795,9710213,118,9696418,0,-118
III,-,9695251,0.0072324,0.0,2074,2059,15,11,52,gene,C07A9.2,1,9695245,2.44388,14962,9710213,6,9695251,0,-6
III,-,9694473,0.942857,1.19293e-37,175,10,165,120,1,gene,C07A9.7,2,9694472,0.483604,93,9694566,1,9694473,0,-1
III,-,9678918,0.0,0.000488281,11,11,0,0,28,gene,C07A9.6,3,9678904,0.225234,679,9679597,14,9678941,-23,-37
III,-,9667534,0.00283286,0.0,353,352,1,1,0,gene,C07A9.9,0,9667493,0.948621,709,9668243,41,9667430,104,63
III,-,9637017,0.0026738,0.0,374,373,1,1,0,gene,F58A4.11,0,9636998,1.57372,13302,9650319,19,9637017,0,-19
III,-,9631068,0.00597943,0.0,4181,4156,25,16,7,gene,F58A4.10,1,9631064,8.15949,840,9631908,4,9631068,0,-4
III,-,9629806,1.0,0.0625,4,0,4,3,1,gene,F58A4.9,2,9629780,1.73787,180,9629986,26,9629786,20,-6
III,-,9629786,0.544118,0.00116503,816,372,444,304,172,gene,F58A4.9,2,9629780,1.73787,200,9629986,6,9629786,0,-6
III,-,9629055,0.977778,0.0,315,7,308,245,0,gene,F58A4.8,3,9629055,1.2992,92,9629147,0,9629055,0,0
III,-,9616369,0.0,2.98023e-08,25,25,0,0,0,gene,F58A4.3,0,9616354,1.37967,9955,9626324,15,9616367,2,-13
III,-,9614198,0.0,0.5,1,1,0,0,1,gene,F58A4.4,0,9614180,0.501013,1009,9615207,18,9614182,16,-2
III,-,9614182,0.00657895,0.0,456,453,3,3,4,gene,F58A4.4,0,9614180,0.501013,1025,9615207,2,9614182,0,-2
III,-,9600646,0.0,0.0,378,378,0,0,0,gene,F58A4.2,0,9600645,0.92682,1455,9602101,1,9600646,0,-1
III,-,9595562,0.0,0.00195312,9,9,0,0,2,gene,C48B4.2,0,9595475,0.13562,4415,9599977,87,9595475,87,0
III,-,9592093,0.0,0.0,352,352,0,0,2,gene,C48B4.1,0,9592084,0.88208,930,9593023,9,9592093,0,-9
III,-,9582281,0.0,8.88178e-16,50,50,0,0,1,gene,C48B4.3,0,9582261,0.225411,4237,9586518,20,9582261,20,0
III,-,9579981,0.00961538,0.0,208,206,2,2,0,gene,C48B4.4,0,9579950,0.984617,1033,9581014,31,9579773,208,177
III,-,9579082,0.0,0.5,1,1,0,0,1,gene,C48B4.4,0,9579020,0.984617,1932,9581014,62,9579020,62,0
III,-,9565962,0.00782779,0.0,511,507,4,3,154,gene,C48B4.11,1,9565944,0.519932,4332,9570294,18,9565944,18,0
III,-,9564410,0.979167,0.0,240,5,235,200,2,gene,C48B4.10,2,9564401,0.832449,95,9564505,9,9564408,2,-7
III,-,9563228,0.895522,1.56918e-22,134,14,120,104,72,gene,C48B4.9,3,9563221,0.594175,108,9563336,7,9563221,7,0
III,-,9561114,0.630058,0.000168353,173,64,109,93,33,gene,C48B4.8,4,9561112,0.258264,1118,9562232,2,9561112,2,0
III,-,9559329,0.00735294,0.0,544,540,4,4,5,gene,C48B4.7,1,9559327,1.47245,400,9559729,2,9559327,2,0
III,-,9558461,0.87069,0.0,348,45,303,256,0,gene,C48B4.6,2,9558452,0.865539,106,9558567,9,9558453,8,-1
III,-,9542279,0.018797,0.0,266,261,5,5,0,gene,ZK1098.8,0,9542256,0.503613,15053,9557332,23,9542256,23,0
III,-,9538599,0.0714286,0.000854492,14,13,1,0,0,gene,ZK1098.3,0,9538599,0.105335,332,9538931,0,9538599,0,0
III,-,9523573,0.00423729,0.0,1888,1880,8,7,197,gene,ZK1098.7,0,9523567,1.86431,8201,9531774,6,9523609,-36,-42
III,-,9521361,0.0131579,0.0,456,450,6,6,1,gene,F55H2.6,1,9521361,1.67703,1653,9523014,0,9521361,0,0
III,-,9516149,0.877828,1.03482e-32,221,27,194,138,1,gene,F55H2.7,2,9516148,0.563544,382,9516531,1,9516149,0,-1
III,-,9500103,0.00540541,0.0,185,184,1,1,6,gene,F55H2.1,0,9500098,1.01734,12396,9512499,5,9500098,5,0
III,-,9491116,0.007,0.0,1000,993,7,6,13,gene,B0464.1,0,9491110,4.50637,5804,9496920,6,9491116,0,-6
III,-,9473177,0.00613497,0.0,326,324,2,1,3,gene,B0464.4,0,9473166,1.34868,15892,9489069,11,9473177,0,-11
III,-,9465378,0.00714678,0.0,1819,1806,13,12,17,gene,B0464.6,0,9465371,1.34241,4443,9469821,7,9465378,0,-7
III,-,9455931,0.00623053,0.0,321,319,2,2,5,gene,F54C8.5,1,9455910,0.688844,6958,9462889,21,9455915,16,-5
III,-,9453963,0.7,1.55838e-22,570,171,399,281,19,gene,F54C8.7,2,9453963,1.55745,100,9454063,0,9453963,0,0
III,-,9452873,0.333333,0.375,3,2,1,0,4,gene,F54C8.7,2,9452822,1.55745,1190,9454063,51,9452953,-80,-131
III,-,9448233,0.0,3.46945e-18,58,58,0,0,2,gene,F54C8.6,0,9448232,0.261405,3263,9451496,1,9448247,-14,-15
III,-,9446505,0.0,2.38419e-07,22,22,0,0,6,gene,F54C8.6,0,9446467,0.261405,4991,9451496,38,9446505,0,-38
III,-,9441359,0.992308,9.55089e-38,130,1,129,86,4,gene,F54C8.3,2,9441359,0.48325,99,9441458,0,9441361,-2,-2
III,-,9406542,0.0110294,0.0,272,269,3,0,2,gene,T26G10.1,0,9406541,1.10803,2528,9409070,1,9406542,0,-1
III,-,9400971,0.0,0.0,216,216,0,0,13,gene,C38C10.6,0,9400968,0.716625,3416,9404387,3,9400968,3,0
III,-,9393065,0.0,0.125,3,3,0,0,0,gene,C38C10.4,1,9393042,0.0835542,7367,9400432,23,9393065,0,-23
III,-,9390008,0.776236,0.0,1153,258,895,811,4,gene,C38C10.2,2,9389933,2.30823,1161,9391169,75,9390009,-1,-76
III,-,9355363,0.00191205,0.0,523,522,1,0,64,gene,K04H4.2,1,9355246,2.65214,28665,9384028,117,9355363,0,-117
III,-,9344349,0.0055814,0.0,1075,1069,6,4,1,gene,K04H4.1,2,9344300,3.99681,3321,9347670,49,9344349,0,-49
III,-,9334177,0.000892061,0.0,1121,1120,1,0,2,gene,C40H1.4,0,9334169,0.885158,2624,9336801,8,9334177,0,-8
III,-,9306591,0.0,0.015625,6,6,0,0,1,gene,K01B6.2,0,9306585,0.0784489,20617,9327208,6,9306600,-9,-15
III,-,9268969,0.0,2.58494e-26,85,85,0,0,29,gene,M01A8.2,0,9268949,0.577785,27609,9296578,20,9268969,0,-20
III,-,9236230,0.0133111,0.0,601,593,8,6,1,gene,T23G5.2,0,9236223,1.58138,23883,9260113,7,9236230,0,-7
III,-,9236227,0.0,0.03125,5,5,0,0,57,gene,T23G5.2,0,9236223,1.58138,23886,9260113,4,9236230,-3,-7
III,-,9228700,0.0,1.42109e-14,46,46,0,0,1,gene,T23G5.1,0,9228696,3.91718,403,9229103,4,9228694,6,2
III,-,9228158,0.00076599,0.0,2611,2609,2,2,6,gene,T23G5.1,0,9228156,3.91718,945,9229103,2,9228158,0,-2
III,-,9215369,0.0,5.68434e-14,44,44,0,0,0,gene,ZC84.4,0,9215344,0.0986902,9913,9225282,25,9215349,20,-5
III,-,9191019,0.00909091,8.47409e-32,110,109,1,1,0,gene,ZC84.3,0,9190992,0.512914,1872,9192891,27,9191019,0,-27
III,-,9172712,0.0,0.0,270,270,0,0,0,gene,F54G8.3,0,9172692,0.857024,13753,9186465,20,9172712,0,-20
III,-,9153706,0.0,0.5,1,1,0,0,32,gene,F54G8.4,0,9153695,0.377305,3445,9157151,11,9153800,-94,-105
III,-,9144705,0.0247934,0.0,242,236,6,1,2,gene,ZK512.2,0,9144697,0.901338,817,9145522,8,9144705,0,-8
III,-,9109183,0.00478927,0.0,1044,1039,5,5,0,gene,ZK507.6,0,9109113,1.19923,8117,9117300,70,9109183,0,-70
III,-,9089299,0.0,0.00195312,9,9,0,0,4,gene,F02A9.4,0,9089284,1.85764,10306,9099605,15,9089286,13,-2
III,-,9089286,0.00326371,0.0,1532,1527,5,5,12,gene,F02A9.4,0,9089284,1.85764,10319,9099605,2,9089286,0,-2
III,-,9081090,0.00579323,0.0,17952,17848,104,81,17,gene,F02A9.2,0,9081088,92.9726,3118,9084208,2,9081090,0,-2
III,-,9077713,0.0,1.38778e-17,56,56,0,0,0,gene,F02A9.1,1,9077710,0.246766,2564,9080277,3,9077710,3,0
III,-,9075548,0.675,0.0109442,40,13,27,2,0,gene,F02A9.7,2,9075535,0.0725611,118,9075666,13,9075535,13,0
III,-,9071381,0.0,3.30872e-24,78,78,0,0,0,gene,R107.8,0,9071374,0.17988,3355,9074736,7,9071671,-290,-297
III,-,9053696,0.00418871,0.0,4536,4517,19,11,3,gene,R107.5,1,9053694,2.62526,6437,9060133,2,9053696,0,-2
III,-,9053671,0.0,0.000976562,10,10,0,0,5333,gene,R107.5,1,9053588,2.62526,6462,9060133,83,9053695,-24,-107
III,-,9050603,0.655556,0.00105242,90,31,59,44,1,gene,R107.4,2,9050602,0.731068,912,9051515,1,9050603,0,-1
III,-,9045848,0.47451,0.0358783,255,134,121,70,2,gene,R107.2,3,9045842,0.562783,115,9045963,6,9045842,6,0
III,-,9041383,0.0,4.93038e-32,104,104,0,0,0,gene,R107.1,0,9041360,0.323372,2417,9043800,23,9041383,0,-23
III,-,9026954,0.0,4.33681e-19,61,61,0,0,0,gene,F59B2.13,0,9026954,0.152454,11735,9038689,0,9026954,0,0
III,-,9005866,0.00568182,0.0,352,350,2,2,0,gene,F59B2.7,0,9005860,1.56864,1979,9007845,6,9005866,0,-6
III,-,9005860,0.0,0.0,824,824,0,0,71,gene,F59B2.7,0,9005860,1.56864,1985,9007845,0,9005866,-6,-6
III,-,9001409,0.0254237,8.03221e-31,118,115,3,3,2,gene,F59B2.5,1,9001366,0.344497,593,9002002,43,9001409,0,-43
III,-,8999677,0.761905,1.32415e-05,63,15,48,41,225,gene,F59B2.3,2,8999677,0.939608,53,8999730,0,8999696,-19,-19
III,-,8999611,1.0,0.00195312,9,0,9,8,66,gene,F59B2.3,2,8999550,0.939608,119,8999730,61,8999696,-85,-146
III,-,8999588,0.875,0.03125,8,1,7,5,36,gene,F59B2.3,2,8999550,0.939608,142,8999730,38,8999696,-108,-146
III,-,8996697,0.95288,0.0,382,18,364,237,0,gene,F59B2.2,3,8996691,1.27963,102,8996799,6,8996697,0,-6
III,-,8981808,0.00543478,0.0,368,366,2,1,0,gene,R08D7.6,0,8981666,1.68757,12748,8994556,142,8981808,0,-142
III,-,8971488,0.0171821,0.0,582,572,10,9,1,gene,R08D7.3,0,8971486,3.45359,3437,8974925,2,8971488,0,-2
III,-,8967637,0.029703,6.57318e-26,101,98,3,3,3,gene,R08D7.1,0,8967625,0.831323,1902,8969539,12,8967637,0,-12
III,-,8956106,0.0059312,0.0,843,838,5,4,3,gene,ZK643.5,0,8956094,1.30273,1506,8957612,12,8956106,0,-12
III,-,8923199,0.00683995,0.0,731,726,5,4,3,gene,ZK637.13,0,8923193,4.11639,29597,8952796,6,8923199,0,-6
III,-,8917838,0.00233918,0.0,855,853,2,2,18,gene,ZK637.11,0,8917804,0.282563,4466,8922304,34,8917838,0,-34
III,-,8904038,0.00793651,0.0,252,250,2,1,19,gene,ZK637.7,1,8904032,0.755138,12240,8916278,6,8904038,0,-6
III,-,8899437,0.00719424,1.99455e-40,139,138,1,1,0,gene,ZK637.6,2,8899436,None,700,8900137,1,8899436,1,0
III,-,8898372,0.5,0.5,2,1,1,1,4,gene,ZK637.18,3,8898308,None,157,8898529,64,8898372,0,-64
III,-,8885390,0.0208333,1.7053e-13,48,47,1,1,0,gene,ZK637.1,0,8885381,0.26787,2711,8888101,9,8885390,0,-9
III,-,8877035,0.0,4.44089e-16,51,51,0,0,1,gene,K01F9.2,0,8876932,0.380897,5571,8882606,103,8876932,103,0
III,-,8877027,0.0,0.0625,4,4,0,0,61,gene,K01F9.2,0,8876932,0.380897,5579,8882606,95,8876932,95,0
III,-,8850439,0.00265957,0.0,1128,1125,3,2,0,gene,F44E2.9,1,8850438,1.18788,16494,8866933,1,8850439,0,-1
III,-,8850409,0.0,1.49012e-08,26,26,0,0,233,gene,F44E2.9,1,8850193,1.18788,16524,8866933,216,8850439,-30,-246
III,-,8849795,0.5,0.375,4,2,2,2,1,gene,F44E2.8,2,8849776,1.67757,109,8849904,19,8849776,19,0
III,-,8849784,0.740675,1.11619e-31,563,146,417,304,31,gene,F44E2.8,2,8849776,1.67757,120,8849904,8,8849776,8,0
III,-,8848393,0.934328,0.0,335,22,313,236,6,gene,F44E2.7,3,8848377,0.950331,92,8848485,16,8848393,0,-16
III,-,8847708,0.00985222,0.0,203,201,2,2,3,gene,F44E2.7,3,8847674,0.950331,777,8848485,34,8847710,-2,-36
III,-,8847316,0.0,0.25,2,2,0,0,2,gene,F44E2.7,3,8847296,0.950331,1169,8848485,20,8847316,0,-20
III,-,8845121,0.894928,1.26117e-44,276,29,247,157,4,gene,F44E2.6,4,8845082,1.21211,641,8845762,39,8845082,39,0
III,-,8845093,1.0,0.00195312,9,0,9,7,349,gene,F44E2.6,4,8845082,1.21211,669,8845762,11,8845082,11,0
III,-,8845062,0.8,1.60439e-13,140,28,112,72,451,gene,F44E2.6,4,8845061,1.21211,700,8845762,1,8845082,-20,-21
III,-,8838331,0.0,3.08149e-33,108,108,0,0,0,gene,F44E2.4,0,8838318,1.19361,6069,8844400,13,8838331,0,-13
III,-,8830968,0.00714286,0.0,700,695,5,5,2,gene,F44E2.10,1,8830968,0.541913,1418,8832386,0,8831016,-48,-48
III,-,8829205,0.264339,3.33038e-22,401,295,106,92,1,gene,F44E2.3,2,8829194,0.973679,193,8829398,11,8829194,11,0
III,-,8827135,0.928571,2.10146e-17,84,6,78,54,1,gene,F54F2.9,3,8827134,0.487895,108,8827243,1,8827134,1,0
III,-,8809202,0.00280899,0.0,1068,1065,3,3,62,gene,F54F2.8,1,8809196,2.14144,7417,8816619,6,8809202,0,-6
III,-,8807253,0.897436,4.61267e-20,117,12,105,75,0,gene,F54F2.7,2,8807253,0.390412,136,8807389,0,8807253,0,0
III,-,8792252,0.0104167,1.21169e-27,96,95,1,1,7,gene,F54F2.5,0,8792245,0.341381,8141,8800393,7,8792245,7,0
III,-,8779919,0.00628931,0.0,159,158,1,1,0,gene,K02D10.4,0,8779919,0.229422,7077,8786996,0,8779919,0,0
III,-,8767242,0.0,0.0,435,435,0,0,1,gene,PAR2.4,0,8767116,0.947043,3406,8770648,126,8767242,0,-126
III,-,8760997,0.0181818,4.61838e-30,110,108,2,2,0,gene,PAR2.3,0,8760994,0.381971,2448,8763445,3,8760997,0,-3
III,-,8754658,0.0851927,0.0,493,451,42,36,0,gene,ZK370.8,1,8754653,1.09032,2247,8756905,5,8754658,0,-5
III,-,8748609,0.566176,0.0208616,136,59,77,57,14,gene,ZK370.7,2,8748607,0.534498,3327,8751936,2,8748609,0,-2
III,-,8743748,0.0,1.77636e-15,49,49,0,0,0,gene,ZK370.6,0,8743747,0.0756879,2376,8746124,1,8743747,1,0
III,-,8741319,0.0143885,1.37624e-38,139,137,2,2,10,gene,ZK370.5,0,8741319,1.23205,524,8741843,0,8741319,0,0
III,-,8731311,0.00190114,0.0,526,525,1,1,0,gene,ZK370.4,0,8731294,1.03905,6279,8737590,17,8731280,31,14
III,-,8716091,0.0,0.0,190,190,0,0,0,gene,B0303.14,0,8716063,0.20012,9137,8725228,28,8716091,0,-28
III,-,8710323,0.0,0.5,1,1,0,0,0,gene,B0303.11,0,8709967,0.401683,3577,8713900,356,8710019,304,-52
III,-,8710019,0.0,0.0,193,193,0,0,0,gene,B0303.11,0,8709967,0.401683,3881,8713900,52,8710019,0,-52
III,-,8688073,0.00542495,0.0,553,550,3,3,0,gene,B0303.3,0,8688070,4.21544,11306,8699379,3,8688073,0,-3
III,-,8687914,0.0,0.5,1,1,0,0,24,gene,B0303.3,0,8687822,4.21544,11465,8699379,92,8688073,-159,-251
III,-,8683637,0.0,9.86076e-32,103,103,0,0,1,gene,B0523.5,1,8683621,0.555481,2385,8686022,16,8683600,37,21
III,-,8683630,0.0,0.0,152,152,0,0,9,gene,B0523.5,1,8683621,0.555481,2392,8686022,9,8683600,30,21
III,-,8675305,1.0,0.125,3,0,3,3,31,gene,B0523.3,2,8675301,0.306787,19,8675324,4,8674958,347,343
III,-,8675182,1.0,0.25,2,0,2,1,2,gene,B0523.3,2,8675173,0.306787,31,8675213,9,8674958,224,215
III,-,8674958,0.0189189,0.0,370,363,7,7,2,gene,B0523.3,2,8674954,0.306787,255,8675213,4,8674958,0,-4
III,-,8674926,0.0,0.0625,4,4,0,0,159,gene,B0523.3,2,8674920,0.306787,287,8675213,6,8674958,-32,-38
III,-,8667389,0.00909091,8.47409e-32,110,109,1,1,5,gene,F22B7.10,0,8667382,0.225032,3058,8670447,7,8667382,7,0
III,-,8653832,0.00275482,0.0,726,724,2,1,30,gene,F22B7.9,0,8653801,2.03959,5946,8659778,31,8653814,18,-13
III,-,8643647,0.0416667,1.43051e-06,24,23,1,0,1,gene,F22B7.7,0,8643647,0.247487,4018,8647665,0,8643647,0,0
III,-,8618347,0.00383142,0.0,261,260,1,1,9,gene,C13G5.2,0,8618346,0.708258,7821,8626168,1,8618347,0,-1
III,-,8616592,1.0,0.125,3,0,3,3,1,gene,C06E1.11,0,8616577,0.0373588,98,8616690,15,8616232,360,345
III,-,8616438,0.65,0.0739288,20,7,13,9,0,gene,C06E1.11,0,8616434,0.0373588,252,8616690,4,8616232,206,202
III,-,8614475,0.00671141,2.08793e-43,149,148,1,1,2,gene,C06E1.10,1,8614464,0.311711,193,8614668,11,8614464,11,0
III,-,8609691,0.989362,4.74579e-27,94,1,93,54,0,gene,C06E1.9,2,8609680,0.375435,99,8609790,11,8609691,0,-11
III,-,8597778,0.0,1.50463e-36,119,119,0,0,6,gene,C06E1.8,0,8597769,0.200799,8634,8606412,9,8597778,0,-9
III,-,8593010,0.0,0.000488281,11,11,0,0,0,gene,C06E1.7,0,8593000,0.0515378,2225,8595235,10,8593000,10,0
III,-,8545519,0.0,0.03125,5,5,0,0,0,gene,ZC21.6,0,8545500,0.0188078,38545,8584064,19,8545519,0,-19
III,-,8490260,0.00347222,0.0,288,287,1,1,3,gene,F42H10.7,0,8490250,0.780337,990,8491250,10,8490260,0,-10
III,-,8479370,0.00263158,0.0,380,379,1,1,0,gene,F42H10.6,0,8479353,0.668571,8884,8488254,17,8479370,0,-17
III,-,8446826,0.00484765,0.0,1444,1437,7,7,5,gene,C30C11.4,1,8446806,4.56665,31469,8478295,20,8446826,0,-20
III,-,8443729,0.666667,0.375,3,1,2,1,4,gene,ZK1236.7,2,8443710,1.57463,74,8443803,19,8443526,203,184
III,-,8443524,0.407317,3.35715e-05,410,243,167,138,3,gene,ZK1236.7,2,8443521,1.57463,279,8443803,3,8443521,3,0
III,-,8443493,0.444444,0.246094,9,5,4,4,310,gene,ZK1236.7,2,8443463,1.57463,310,8443803,30,8443521,-28,-58
III,-,8439329,0.649275,1.18463e-22,1035,363,672,461,6,gene,ZK1236.6,3,8439328,1.75419,86,8439415,1,8439329,0,-1
III,-,8433318,0.0,0.03125,5,5,0,0,0,gene,ZK1236.9,0,8433310,0.0317309,3198,8436516,8,8433310,8,0
III,-,8432131,0.0135922,0.0,515,508,7,7,0,gene,ZK1236.5,0,8432131,1.30303,251,8432382,0,8432131,0,0
III,-,8405341,0.0202247,0.0,445,436,9,8,0,gene,ZK353.8,1,8405340,1.68388,26180,8431521,1,8405341,0,-1
III,-,8405334,1.0,0.5,1,0,1,1,155,gene,ZK353.8,1,8405246,1.68388,26187,8431521,88,8405341,-7,-95
III,-,8403526,0.903581,0.0,363,35,328,227,0,gene,ZK353.7,2,8403526,0.985185,105,8403631,0,8403526,0,0
III,-,8403505,1.0,0.25,2,0,2,0,983,gene,ZK353.7,2,8403485,0.985185,126,8403631,20,8403526,-21,-41
III,-,8401847,0.559211,4.37685e-05,912,402,510,341,46,gene,ZK353.6,3,8401828,2.23391,121,8401968,19,8401847,0,-19
III,-,8390641,0.0,0.03125,5,5,0,0,6,gene,ZK353.10,0,8390590,0.316735,8447,8399088,51,8390590,51,0
III,-,8355093,0.000560538,0.0,1784,1783,1,0,12,gene,R05D3.7,1,8355014,3.80144,1711,8356804,79,8355093,0,-79
III,-,8350763,1.0,0.25,2,0,2,1,0,gene,R05D3.6,2,8350724,0,318,8351081,39,8350724,39,0
III,-,8350752,0.842105,1.00433e-05,38,6,32,22,0,gene,R05D3.6,2,8350724,0,329,8351081,28,8350724,28,0
III,-,8342557,0.882353,7.99781e-09,51,6,45,30,0,gene,ZC262.5,2,8342529,0,329,8342886,28,8342529,28,0
III,-,8334443,0.0,0.5,1,1,0,0,0,gene,ZC262.4,0,8334443,0.0226419,2978,8337421,0,8334152,291,291
III,-,8331809,0.00372301,0.0,2686,2676,10,10,136,gene,ZC262.8,1,8331809,2.43499,153,8331962,0,8331838,-29,-29
III,-,8330866,0.905077,0.0,453,43,410,241,2,gene,ZC262.3,2,8330855,1.33193,98,8330964,11,8330866,0,-11
III,-,8320200,0.0,6.61744e-24,77,77,0,0,1,gene,F10E9.10,0,8320199,0.0250237,6229,8326429,1,8320199,1,0
III,-,8319057,0.00561798,0.0,3026,3009,17,15,208,gene,F10E9.11,1,8319057,3.90568,395,8319452,0,8319064,-7,-7
III,-,8318507,0.94,5.81168e-32,150,9,141,101,1,gene,F10E9.8,2,8318500,0.493055,95,8318602,7,8318507,0,-7
III,-,8306275,0.00191571,0.0,522,521,1,1,0,gene,F10E9.7,0,8306222,0.988346,7993,8314268,53,8306275,0,-53
III,-,8275891,0.00826446,4.55151e-35,121,120,1,0,1,gene,F09G8.8,0,8275891,0.324242,29762,8305653,0,8275891,0,0
III,-,8268275,0.00414079,0.0,1449,1443,6,6,7,gene,F09G8.7,0,8268274,2.53945,2407,8270682,1,8268274,1,0
III,-,8249462,0.0,0.0078125,7,7,0,0,2,gene,C02F5.10,0,8249392,0.294609,12813,8262275,70,8249401,61,-9
III,-,8249401,0.0,0.000244141,12,12,0,0,592,gene,C02F5.10,0,8249392,0.294609,12874,8262275,9,8249401,0,-9
III,-,8244012,0.0146089,0.0,2122,2091,31,30,6,gene,C02F5.9,0,8244012,4.94105,4582,8248594,0,8244012,0,0
III,-,8239343,0.0,0.125,3,3,0,0,76,gene,C02F5.8,0,8239317,0.188888,1494,8240837,26,8239343,0,-26
III,-,8237799,0.90625,1.15484e-06,32,3,29,16,159,gene,C02F5.11,0,8237793,0.11099,113,8237912,6,8237813,-14,-20
III,-,8201127,0.0,3.72529e-09,28,28,0,0,0,gene,C50C3.9,0,8201065,0.41452,3915,8205042,62,8201127,0,-62
III,-,8194327,0.0,0.015625,6,6,0,0,0,gene,C50C3.9,0,8194323,0.41452,1777,8196104,4,8194327,0,-4
III,-,8163309,0.00184247,0.0,2171,2167,4,3,0,gene,C50C3.8,1,8163252,2.57645,30433,8193742,57,8163309,0,-57
III,-,8161264,0.884422,9.59274e-31,199,23,176,123,1,gene,C50C3.7,2,8161258,0.384048,109,8161373,6,8161264,0,-6
III,-,8158116,0.222642,1.04668e-20,265,206,59,42,55,gene,D2007.5,3,8158094,0.96995,967,8159083,22,8158116,0,-22
III,-,8144554,0.0,0.0,238,238,0,0,0,gene,C14B9.8,0,8144538,0.639784,11362,8155916,16,8144554,0,-16
III,-,8130153,0.00639087,0.0,38023,37780,243,204,9,gene,C14B9.7,0,8130145,110.959,9365,8139518,8,8130153,0,-8
III,-,8121158,0.0,1.26218e-29,96,96,0,0,1,gene,C14B9.6,0,8120986,0.601194,8275,8129433,172,8121158,0,-172
III,-,8085421,0.0,0.25,2,2,0,0,24,gene,K06H7.7,0,8085391,0.300932,11191,8096612,30,8085441,-20,-50
III,-,8080207,0.0188679,6.85939e-29,106,104,2,2,54,gene,K12H4.8,0,8080200,0.637253,3411,8083618,7,8080200,7,0
III,-,8033410,0.0,0.5,1,1,0,0,2,gene,F44B9.10,0,8033399,0.0516612,9093,8042503,11,8033655,-245,-256
III,-,8031069,0.0,0.5,1,1,0,0,0,gene,F44B9.9,0,8031047,0.0161868,320,8031389,22,8030991,78,56
III,-,8027971,0.879581,0.0,382,46,336,217,0,gene,F44B9.7,2,8027966,1.00256,92,8028063,5,8027971,0,-5
III,-,8020802,0.0018315,0.0,546,545,1,1,0,gene,F44B9.6,1,8020799,1.13196,4316,8025118,3,8020799,3,0
III,-,8016467,0.908046,6.92028e-31,174,16,158,101,0,gene,F44B9.5,2,8016466,0.769162,109,8016576,1,8016466,1,0
III,-,8009758,0.0,3.55271e-15,48,48,0,0,9,gene,F44B9.4,0,8009736,0.644202,3924,8013682,22,8009750,8,-14
III,-,8009750,0.0060241,0.0,166,165,1,1,104,gene,F44B9.4,0,8009736,0.644202,3932,8013682,14,8009750,0,-14
III,-,7996374,0.0,2.98023e-08,25,25,0,0,1,gene,C06G4.5,0,7996364,0.0918905,9433,8005807,10,7996377,-3,-13
III,-,7973239,0.0285714,1.01863e-09,35,34,1,1,123,gene,F54H12.6,0,7973199,37.0603,3906,7977145,40,7973315,-76,-116
III,-,7973230,0.0,0.00195312,9,9,0,0,1736,gene,F54H12.6,0,7973199,37.0603,3915,7977145,31,7973315,-85,-116
III,-,7958043,0.00990099,0.0,202,200,2,1,0,gene,C29E4.9,0,7958034,0.00572037,494,7958537,9,7958034,9,0
III,-,7951530,0.00626679,0.0,1117,1110,7,5,0,gene,C29E4.8,0,7951528,3.65135,4241,7955771,2,7951530,0,-2
III,-,7946947,0.0,0.0,537,537,0,0,3,gene,C29E4.7,0,7946947,0.832046,1808,7948755,0,7946947,0,0
III,-,7928390,0.00346021,0.0,289,288,1,1,4,gene,C29E4.13,0,7928390,0.443252,9663,7938053,0,7928390,0,0
III,-,7924844,0.655172,0.00640895,58,20,38,18,0,gene,C29E4.5,1,7924844,0.434428,2082,7926926,0,7924844,0,0
III,-,7917696,0.918443,0.0,1079,88,991,754,0,gene,ZK688.8,2,7917687,1.12964,230,7917926,9,7917696,0,-9
III,-,7911557,0.00813008,0.0,369,366,3,2,4,gene,ZK688.7,0,7911549,0.756,1075,7912632,8,7911549,8,0
III,-,7907293,0.00209205,0.0,478,477,1,1,1,gene,ZK688.6,0,7907293,1.10104,3398,7910691,0,7907293,0,0
III,-,7891544,0.0,0.0,475,475,0,0,0,gene,ZK688.5,1,7891489,0.799566,4141,7895685,55,7891544,0,-55
III,-,7884892,0.915625,0.0,320,27,293,165,25,gene,ZK688.11,2,7884883,1.2575,122,7885014,9,7884892,0,-9
III,-,7884271,0.0,0.5,1,1,0,0,2,gene,ZK688.9,3,7884261,1.02839,743,7885014,10,7884271,0,-10
III,-,7882930,0.0928962,0.0,366,332,34,26,5,gene,ZK688.9,3,7882918,1.02839,578,7883508,12,7882930,0,-12
III,-,7878829,0.0,1.69407e-21,69,69,0,0,0,gene,C02C2.5,0,7878787,0.140251,2212,7881041,42,7878767,62,20
III,-,7860909,0.0059633,0.0,2180,2167,13,11,184,gene,ZK652.11,0,7860865,5.79718,1600,7862509,44,7860930,-21,-65
III,-,7858383,0.0305882,0.0,425,412,13,8,1,gene,ZK652.9,1,7858382,1.03167,2001,7860384,1,7858385,-2,-3
III,-,7857146,0.960591,0.0,812,32,780,609,0,gene,ZK652.10,2,7857144,0.897915,94,7857240,2,7857168,-22,-24
III,-,7843603,0.0148515,0.0,202,199,3,2,0,gene,ZK652.8,0,7843563,0.40329,11972,7855575,40,7843563,40,0
III,-,7828553,0.00416667,0.0,1200,1195,5,5,1,gene,C27D11.1,0,7828515,3.13301,13509,7842062,38,7828553,0,-38
III,-,7795266,0.012987,5.09543e-22,77,76,1,1,15,gene,C08C3.4,0,7795266,1.305,29037,7824303,0,7795224,42,42
III,-,7795259,0.00864553,0.0,694,688,6,5,24,gene,C08C3.4,0,7795224,1.305,29044,7824303,35,7795224,35,0
III,-,7783383,0.00445434,0.0,449,447,2,1,0,gene,C08C3.3,0,7783316,0.326397,9991,7793374,67,7783382,1,-66
III,-,7775955,0.0174419,0.0,172,169,3,2,1,gene,C08C3.2,0,7775942,0.261548,880,7776835,13,7775955,0,-13
III,-,7769896,0.0110865,0.0,451,446,5,5,1,gene,ZK686.4,1,7769894,0.791701,1621,7771517,2,7769896,0,-2
III,-,7768991,0.94635,0.0,1808,97,1711,1095,1,gene,ZK686.3,2,7768991,6.4729,101,7769092,0,7768991,0,0
III,-,7765980,0.00323625,0.0,309,308,1,1,133,gene,ZK686.2,1,7765977,0.588244,338,7766318,3,7765980,0,-3
III,-,7763531,0.970253,0.0,1580,47,1533,1048,14,gene,ZC97.1,2,7763531,2.04041,115,7763646,0,7763531,0,0
III,-,7754391,0.0,1.90735e-06,19,19,0,0,0,gene,ZK112.7,0,7754387,0.146253,7514,7761905,4,7754376,15,11
III,-,7709417,0.00536673,0.0,559,556,3,3,1,gene,C03B8.4,0,7709400,1.35523,20220,7729637,17,7709400,17,0
III,-,7655960,0.00437637,0.0,457,455,2,2,1,gene,ZK783.4,0,7655952,0.406907,22922,7678882,8,7655960,0,-8
III,-,7643029,0.015625,0.0,384,378,6,5,5,gene,ZK783.2,0,7643019,2.33294,3073,7646102,10,7643029,0,-10
III,-,7588239,0.0,0.125,3,3,0,0,0,gene,R13A5.15,0,7588139,None,3260,7591499,100,7588120,119,19
III,-,7582906,0.0046729,0.0,428,426,2,2,0,gene,R13A5.10,0,7582902,0.71992,3794,7586700,4,7582970,-64,-68
III,-,7579334,0.0,5.96046e-08,24,24,0,0,0,gene,R13A5.9,0,7579332,0.380755,2621,7581955,2,7579334,0,-2
III,-,7572754,0.00278748,0.0,59552,59386,166,145,8,gene,R13A5.8,0,7572738,103.442,2443,7575197,16,7572754,0,-16
III,-,7570056,0.00917431,0.0,327,324,3,2,4,gene,R13A5.7,0,7570022,0.214189,1639,7571695,34,7570056,0,-34
III,-,7565268,0.00426743,0.0,703,700,3,2,34,gene,R13A5.6,0,7565268,1.24667,2101,7567369,0,7565268,0,0
III,-,7520659,0.0,0.00390625,8,8,0,0,158,gene,C07H6.8,1,7520621,0.601887,7937,7528596,38,7520729,-70,-108
III,-,7518448,0.962025,1.30825e-19,79,3,76,63,0,gene,C07H6.6,2,7518448,0.338724,103,7518551,0,7518448,0,0
III,-,7499289,0.0,0.0078125,7,7,0,0,0,gene,C07H6.9,0,7499262,0.0661641,15864,7515153,27,7499289,0,-27
III,-,7497756,0.00360306,0.0,6661,6637,24,22,1,gene,C07H6.5,0,7497718,11.1166,918,7498674,38,7497756,0,-38
III,-,7489000,0.0,0.0,197,197,0,0,10,gene,K07D8.1,0,7488987,1.97393,6189,7495189,13,7489000,0,-13
III,-,7395379,0.0,5.60519e-45,147,147,0,0,0,gene,T20B12.9,0,7395325,0.161615,63318,7458697,54,7395208,171,117
III,-,7395263,0.0,0.5,1,1,0,0,6,gene,T20B12.9,0,7395208,0.161615,63434,7458697,55,7395208,55,0
III,-,7381521,0.0026178,0.0,382,381,1,0,2,gene,T20B12.8,1,7381520,1.67076,1589,7383110,1,7381521,0,-1
III,-,7378970,0.907081,0.0,5155,479,4676,3066,2,gene,T20B12.7,2,7378970,6.27886,98,7379068,0,7378970,0,0
III,-,7378943,0.8,0.15625,5,1,4,1,2731,gene,T20B12.7,2,7378900,6.27886,125,7379068,43,7378970,-27,-70
III,-,7374656,0.0,1.65436e-24,79,79,0,0,0,gene,T20B12.6,0,7374650,0.83922,3106,7377762,6,7374650,6,0
III,-,7359018,0.0,0.0,250,250,0,0,40,gene,F08F8.4,1,7358990,0.445396,3526,7362544,28,7358996,22,-6
III,-,7357312,0.568182,0.0117421,176,76,100,76,81,gene,F08F8.10,2,7357312,0.692843,275,7357587,0,7357312,0,0
III,-,7353897,0.840142,0.0,563,90,473,295,122,gene,F08F8.9,3,7353879,1.42892,183,7354080,18,7353897,0,-18
III,-,7349100,0.950585,0.0,769,38,731,415,0,gene,F08F8.8,4,7349091,0.746258,115,7349215,9,7349091,9,0
III,-,7347076,0.544554,0.0532163,101,46,55,45,4,gene,F08F8.7,5,7347069,1.5691,90,7347166,7,7347069,7,0
III,-,7347069,0.417539,8.57453e-07,764,445,319,218,262,gene,F08F8.7,5,7347069,1.5691,97,7347166,0,7347069,0,0
III,-,7335047,0.0,9.53674e-07,20,20,0,0,101,gene,F56C9.10,1,7335044,2.54629,10741,7345788,3,7335044,3,0
III,-,7329534,0.916667,2.50653e-31,168,14,154,109,15,gene,F56C9.11,2,7329534,0.413392,12,7329546,0,7329534,0,0
III,-,7329473,1.0,0.5,1,0,1,1,39,gene,F56C9.11,2,7329422,0.413392,73,7329546,51,7329534,-61,-112
III,-,7319434,0.0,0.0,286,286,0,0,41,gene,F56C9.8,0,7319393,1.89415,5433,7324867,41,7319481,-47,-88
III,-,7315564,0.25,0.25,4,3,1,0,3,gene,F56C9.7,0,7315551,5.313,266,7315830,13,7315178,386,373
III,-,7314904,0.00546117,0.0,1648,1639,9,7,6,gene,F56C9.7,0,7314902,5.313,926,7315830,2,7314904,0,-2
III,-,7314778,0.0,0.0625,4,4,0,0,727,gene,F56C9.7,0,7314597,5.313,1052,7315830,181,7314904,-126,-307
III,-,7310682,0.00240096,0.0,833,831,2,2,52,gene,F56C9.6,0,7310643,1.45948,2386,7313068,39,7310697,-15,-54
III,-,7290489,0.0,0.0,215,215,0,0,0,gene,B0361.8,1,7290480,0.994254,7786,7298275,9,7290489,0,-9
III,-,7287530,0.337061,6.68387e-17,626,415,211,129,2,gene,B0361.10,2,7287525,1.78281,244,7287774,5,7287530,0,-5
III,-,7285810,0.902778,0.0,288,28,260,193,1,gene,B0361.7,3,7285799,0.544027,96,7285906,11,7285810,0,-11
III,-,7285805,0.921569,0.0,255,20,235,113,294,gene,B0361.7,3,7285799,0.544027,101,7285906,6,7285810,-5,-11
III,-,7277201,0.0149813,0.0,267,263,4,3,0,gene,B0361.6,1,7277198,0.641896,6643,7283844,3,7277201,0,-3
III,-,7275340,1.0,0.5,1,0,1,1,0,gene,B0361.5,2,7275307,1.47231,92,7275432,33,7275323,17,-16
III,-,7275323,0.919614,0.0,311,25,286,196,7,gene,B0361.5,2,7275307,1.47231,109,7275432,16,7275323,0,-16
III,-,7271071,0.0,5.73972e-42,137,137,0,0,4,gene,B0361.5,2,7271026,1.47231,4361,7275432,45,7271071,0,-45
III,-,7234131,0.00589722,0.0,2374,2360,14,13,3,gene,T20H4.5,1,7234110,4.7295,11502,7245633,21,7234131,0,-21
III,-,7232811,0.939394,0.0,297,18,279,209,1,gene,T20H4.4,2,7232811,1.25103,38,7232849,0,7232811,0,0
III,-,7230870,0.927632,3.03159e-30,152,11,141,98,0,gene,R151.10,3,7230860,1.23706,7,7230877,10,7230860,10,0
III,-,7230860,0.914557,0.0,316,27,289,196,423,gene,R151.10,3,7230860,1.23706,17,7230877,0,7230860,0,0
III,-,7229716,0.887949,0.0,473,53,420,294,3,gene,R151.8,4,7229714,0.45177,267,7229983,2,7229716,0,-2
III,-,7226636,0.952068,0.0,1064,51,1013,738,3,gene,R151.7,5,7226636,1.16501,95,7226731,0,7226636,0,0
III,-,7223058,0.940314,0.0,955,57,898,620,3,gene,R151.6,6,7223058,0.981623,104,7223162,0,7223058,0,0
III,-,7198813,0.0109329,0.0,1372,1357,15,13,0,gene,R151.9,1,7198812,4.04714,21459,7220272,1,7198813,0,-1
III,-,7198805,0.0,0.25,2,2,0,0,1975,gene,R151.9,1,7198703,4.04714,21467,7220272,102,7198813,-8,-110
III,-,7197995,0.937008,0.0,254,16,238,147,1,gene,F37C12.13,2,7197990,0.983167,85,7198080,5,7197995,0,-5
III,-,7192921,0.0,0.00195312,9,9,0,0,0,gene,F37C12.12,0,7192906,0.0158099,1103,7194024,15,7192921,0,-15
III,-,7189560,0.00824655,0.0,44746,44377,369,316,107,gene,F37C12.11,0,7189554,168.972,561,7190121,6,7189560,0,-6
III,-,7188313,0.0,1.16415e-10,33,33,0,0,105,gene,F37C12.10,0,7188281,0.186079,751,7189064,32,7188289,24,-8
III,-,7185477,0.0909091,0.00537109,11,10,1,0,0,gene,F37C12.14,0,7185452,0.0115791,2341,7187818,25,7185530,-53,-78
III,-,7179531,0.0,1.69407e-21,69,69,0,0,48,gene,F37C12.9,0,7179508,132.431,5416,7184947,23,7179533,-2,-25
III,-,7179517,0.0052872,0.0,31964,31795,169,143,440,gene,F37C12.9,0,7179508,132.431,5430,7184947,9,7179517,0,-9
III,-,7162044,0.00421941,0.0,1659,1652,7,6,1,gene,K04G7.11,1,7162044,2.40319,11956,7174000,0,7162044,0,0
III,-,7161084,0.00792752,0.0,883,876,7,7,12,gene,K04G7.10,2,7161079,1.68663,1,7161085,5,7161082,2,-3
III,-,7158738,0.890909,0.0,825,90,735,403,1,gene,K04G7.4,3,7158732,5.4554,101,7158839,6,7158738,0,-6
III,-,7153722,0.323009,1.08118e-14,452,306,146,128,1,gene,K04G7.3,0,7153711,2.35098,2322,7156044,11,7153699,23,12
III,-,7144999,0.0,0.25,2,2,0,0,0,gene,B0280.12,0,7144821,0.0429644,771,7145770,178,7144761,238,60
III,-,7133603,0.0031746,0.0,315,314,1,1,11,gene,B0280.10,0,7133594,0.336331,1329,7134932,9,7133607,-4,-13
III,-,7133595,0.0,9.86076e-32,103,103,0,0,305,gene,B0280.10,0,7133594,0.336331,1337,7134932,1,7133607,-12,-13
III,-,7133567,0.0,0.0625,4,4,0,0,140,gene,B0280.10,0,7133442,0.336331,1365,7134932,125,7133607,-40,-165
III,-,7122824,0.0143541,0.0,418,412,6,5,2,gene,B0280.9,0,7122820,1.19177,9240,7132064,4,7122824,0,-4
III,-,7115367,0.0,0.0,167,167,0,0,1,gene,B0280.8,0,7115363,0.790783,1048,7116415,4,7115367,0,-4
III,-,7103919,0.00529956,0.0,11133,11074,59,57,12,gene,B0280.5,0,7103915,11.9031,5753,7109672,4,7103920,-1,-5
III,-,7087670,0.0,0.0,218,218,0,0,0,gene,ZK418.9,0,7087618,2.63455,901,7088571,52,7087670,0,-52
III,-,7087510,0.00714286,1.00445e-40,140,139,1,0,0,gene,ZK418.9,0,7087497,2.63455,1061,7088571,13,7087510,0,-13
III,-,7087144,0.0,4.1359e-25,81,81,0,0,2,gene,ZK418.9,0,7087097,2.63455,1427,7088571,47,7087144,0,-47
III,-,7080680,0.0,9.31323e-10,30,30,0,0,1,gene,ZK418.7,1,7080648,0.1484,2931,7083611,32,7080718,-38,-70
III,-,7078767,0.868421,1.26331e-11,76,10,66,34,5,gene,ZK418.6,2,7078765,0.0898956,98,7078865,2,7078765,2,0
III,-,7078693,1.0,0.25,2,0,2,1,0,gene,ZK418.6,2,7078659,0.0898956,172,7078865,34,7078765,-72,-106
III,-,7073782,0.00625355,0.0,1759,1748,11,9,0,gene,ZK418.5,1,7073764,3.33808,397,7074179,18,7073776,6,-12
III,-,7072483,0.890511,0.0,822,90,732,540,0,gene,ZK418.4,2,7072483,1.07518,108,7072591,0,7072483,0,0
III,-,7072443,0.5,0.273438,8,4,4,4,234,gene,ZK418.4,2,7072428,1.07518,148,7072591,15,7072483,-40,-55
III,-,7068501,0.0879665,0.0,2626,2395,231,203,4,gene,R01H2.6,0,7068471,6.95579,2145,7070646,30,7068501,0,-30
III,-,7067374,0.00980392,0.0,204,202,2,1,1,gene,R01H2.5,0,7067371,1.20043,242,7067616,3,7067371,3,0
III,-,7060514,0.00502513,0.0,199,198,1,1,3,gene,R01H2.3,0,7060511,0.911956,498,7061012,3,7060528,-14,-17
III,-,7029137,0.0116959,0.0,171,169,2,1,2,gene,F11H8.4,0,7029130,0.544522,5949,7035086,7,7029130,7,0
III,-,7020535,0.000984575,0.0,3047,3044,3,1,5,gene,F11H8.3,0,7020534,6.01053,3046,7023581,1,7020535,0,-1
III,-,7005377,0.0,1.2326e-32,106,106,0,0,0,gene,C06E8.5,0,7005224,0.585779,14138,7019515,153,7005298,79,-74
III,-,6971648,0.00712492,0.0,51369,51003,366,338,1,gene,F31E3.5,0,6971616,246.255,12888,6984536,32,6971648,0,-32
III,-,6968065,0.00446429,0.0,448,446,2,2,9,gene,F31E3.4,0,6968012,0.669378,1892,6969957,53,6968050,15,-38
III,-,6962001,0.0,0.5,1,1,0,0,12,gene,F57B9.10,0,6961995,3.11192,1554,6963555,6,6961962,39,33
III,-,6961525,0.0,0.03125,5,5,0,0,1,gene,F57B9.10,0,6961215,3.11192,2030,6963555,310,6960877,648,338
III,-,6960875,0.00378072,0.0,3703,3689,14,12,0,gene,F57B9.10,0,6960867,3.11192,2680,6963555,8,6960875,0,-8
III,-,6928751,0.0,0.0,234,234,0,0,2,gene,F57B9.7,0,6928746,0.797594,4111,6932862,5,6928746,5,0
III,-,6912168,0.00458716,0.0,218,217,1,1,2608,gene,T07E3.6,0,6912136,4.95114,11866,6924034,32,6912418,-250,-282
III,-,6903043,0.00819672,2.29456e-35,122,121,1,1,3,gene,T07E3.5,0,6903014,0.312255,6326,6909369,29,6903043,0,-29
III,-,6889441,0.0,3.38813e-21,68,68,0,0,158,gene,K04C2.4,0,6889432,0.351677,1487,6890928,9,6889441,0,-9
III,-,6869369,0.0,0.00390625,8,8,0,0,16,gene,R13F6.10,0,6869320,1.00788,15771,6885140,49,6869361,8,-41
III,-,6869347,0.0,0.0,246,246,0,0,256,gene,R13F6.10,0,6869320,1.00788,15793,6885140,27,6869361,-14,-41
III,-,6863906,0.0,5.55112e-17,54,54,0,0,2,gene,R13F6.9,0,6863901,0.312796,1239,6865145,5,6863907,-1,-6
III,-,6856745,0.0,5.42101e-20,64,64,0,0,0,gene,R13F6.6,0,6856742,0.14261,1936,6858681,3,6856720,25,22
III,-,6819309,0.00223714,0.0,447,446,1,0,0,gene,F28F5.6,0,6819305,0.881328,27943,6847252,4,6819311,-2,-6
III,-,6816852,0.0,0.25,2,2,0,0,9,gene,F28F5.4,0,6816807,0.192678,397,6817249,45,6816948,-96,-141
III,-,6722196,0.0056101,0.0,713,709,4,4,26,gene,F37A4.9,0,6722195,1.15246,5879,6728075,1,6722196,0,-1
III,-,6709943,0.00305111,0.0,1311,1307,4,4,26,gene,F37A4.8,0,6709940,1.25119,10410,6720353,3,6709995,-52,-55
III,-,6650965,0.037037,2.01166e-07,27,26,1,1,0,gene,C13B9.4,0,6650911,0.314118,52984,6703949,54,6650965,0,-54
III,-,6638786,0.0,2.40741e-35,115,115,0,0,0,gene,C13B9.4,0,6638764,0.314118,65163,6703949,22,6638786,0,-22
III,-,6624912,0.0121457,0.0,494,488,6,3,3,gene,C13B9.3,0,6624901,2.55637,7870,6632782,11,6624912,0,-11
III,-,6608046,0.00124816,0.0,8813,8802,11,8,0,gene,F20H11.3,0,6608043,13.2271,14545,6622591,3,6608046,0,-3
III,-,6608030,0.0,1.19209e-07,23,23,0,0,22476,gene,F20H11.3,0,6607766,13.2271,14561,6622591,264,6608046,-16,-280
III,-,6601111,0.214286,0.0,700,550,150,117,2,gene,F20H11.6,1,6601027,0.834262,5081,6606192,84,6601083,28,-56
III,-,6592115,0.730263,3.8948e-09,152,41,111,77,1,gene,F20H11.1,3,6592115,0.4753,355,6592470,0,6592115,0,0
III,-,6578539,0.0,0.000244141,12,12,0,0,0,gene,F27B3.6,0,6578524,0.0640121,10694,6589233,15,6578701,-162,-177
III,-,6563606,0.0,3.46945e-18,58,58,0,0,1,gene,F27B3.7,0,6563599,0.147696,14159,6577765,7,6563684,-78,-85
III,-,6562630,1.0,0.5,1,0,1,1,0,gene,F27B3.5,1,6562628,0.0982938,332,6562962,2,6562630,0,-2
III,-,6558521,0.701493,0.000392778,67,20,47,40,2,gene,C09E7.8,2,6558515,0.15474,488,6559009,6,6558515,6,0
III,-,6551176,0.0382166,1.03364e-37,157,151,6,6,5,gene,C09E7.7,1,6551169,0.412516,2340,6553516,7,6551169,7,0
III,-,6546365,0.842105,1.00433e-05,38,6,32,18,1,gene,C09E7.6,2,6546359,0.105478,297,6546662,6,6546344,21,15
III,-,6536935,0.00423729,0.0,236,235,1,1,0,gene,C09E7.4,0,6536929,0.290785,1094,6538029,6,6536935,0,-6
III,-,6525598,0.0,0.0,181,181,0,0,0,gene,C09E7.3,0,6525590,0.263585,8264,6533862,8,6525562,36,28
III,-,6519989,0.0,9.53674e-07,20,20,0,0,0,gene,C09E7.10,0,6519977,0.0467562,4002,6523991,12,6519989,0,-12
III,-,6514706,0.0416667,1.43051e-06,24,23,1,0,0,gene,K03F8.2,0,6514705,0.0503671,3947,6518653,1,6514705,1,0
III,-,6463721,0.00215433,0.0,38527,38444,83,74,1,gene,T26A5.9,1,6463706,20.8722,45667,6509388,15,6463721,0,-15
III,-,6462795,0.886644,0.0,891,101,790,607,4,gene,T26A5.8,2,6462789,1.72923,51,6462846,6,6462789,6,0
III,-,6452314,0.00617284,0.0,1134,1127,7,6,1,gene,T26A5.7,1,6452298,2.61185,9843,6462157,16,6452314,0,-16
III,-,6450638,0.929078,0.0,282,20,262,197,1,gene,T26A5.6,2,6450627,0.413407,94,6450732,11,6450638,0,-11
III,-,6450633,0.975,3.63798e-11,40,1,39,27,1,gene,T26A5.6,2,6450627,0.413407,99,6450732,6,6450638,-5,-11
III,-,6446849,0.378448,2.2185e-17,1160,721,439,345,17,gene,C05D11.12,3,6446848,2.4021,483,6447332,1,6446849,0,-1
III,-,6443914,0.05,7.09406e-10,40,38,2,2,3,gene,C05D11.13,0,6443913,0.35089,720,6444634,1,6443913,1,0
III,-,6442764,0.0340314,0.0,764,738,26,12,42,gene,C05D11.11,0,6442757,7.64076,134,6442898,7,6442764,0,-7
III,-,6441809,0.00434783,0.0,3910,3893,17,16,8,gene,C05D11.11,0,6441803,7.64076,1089,6442898,6,6441809,0,-6
III,-,6431734,0.0194175,0.0,515,505,10,8,2,gene,C05D11.10,1,6431734,2.07505,8353,6440087,0,6431734,0,0
III,-,6430876,0.883621,2.03528e-35,232,27,205,153,1,gene,C05D11.9,2,6430876,0.437917,103,6430979,0,6430876,0,0
III,-,6427375,0.936,2.76517e-26,125,8,117,78,0,gene,C05D11.8,3,6427364,0.338006,95,6427470,11,6427246,129,118
III,-,6419398,0.0128205,0.0,1248,1232,16,13,1,gene,C05D11.7,0,6419395,1.52835,2778,6422176,3,6419398,0,-3
III,-,6415037,0.0588235,0.0001297,17,16,1,1,0,gene,C05D11.6,0,6414961,0.138021,678,6415715,76,6414934,103,27
III,-,6411874,0.0,0.25,2,2,0,0,3,gene,C05D11.5,0,6411851,0.274208,301,6412175,23,6411501,373,350
III,-,6395877,0.00400458,0.0,1748,1741,7,3,304,gene,C16A3.10,0,6395876,4.3441,14083,6409960,1,6395877,0,-1
III,-,6374939,0.00568429,0.0,50666,50378,288,263,4,gene,C16A3.9,0,6374923,52.2495,19237,6394176,16,6374939,0,-16
III,-,6343324,0.0,0.03125,5,5,0,0,0,gene,C56G2.9,1,6343232,0.118986,23200,6366524,92,6343232,92,0
III,-,6343270,0.0,1.05879e-22,73,73,0,0,6,gene,C56G2.9,1,6343232,0.118986,23254,6366524,38,6343232,38,0
III,-,6341870,0.0094162,0.0,531,526,5,4,0,gene,C56G2.7,2,6341868,4.20801,465,6342335,2,6341870,0,-2
III,-,6339777,0.338694,1.23747e-26,1057,699,358,273,8,gene,C56G2.6,3,6339772,7.69467,78,6339855,5,6339777,0,-5
III,-,6324185,0.0,3.46945e-18,58,58,0,0,1,gene,C56G2.5,0,6324179,0.170923,14271,6338456,6,6324179,6,0
III,-,6302453,0.0129683,0.0,694,685,9,7,301,gene,F47D12.9,0,6302442,1.85671,18666,6321119,11,6302453,0,-11
III,-,6301495,0.0,1.81899e-12,39,39,0,0,1,gene,F47D12.9,0,6301479,1.85671,19624,6321119,16,6301495,0,-16
III,-,6287236,0.00145985,0.0,685,684,1,1,4,gene,F47D12.6,0,6287202,1.79036,5154,6292390,34,6287260,-24,-58
III,-,6278295,0.00888099,0.0,563,558,5,4,6,gene,C18F10.7,0,6278290,0.988655,4094,6282389,5,6278295,0,-5
III,-,6248102,0.0096463,0.0,311,308,3,3,255,gene,T12A2.8,1,6248102,1.18556,5393,6253495,0,6248102,0,0
III,-,6245802,1.0,0.5,1,0,1,1,3,gene,T12A2.7,2,6245763,1.24265,61,6245863,39,6245772,30,-9
III,-,6245772,0.96371,0.0,1240,45,1195,900,59,gene,T12A2.7,2,6245763,1.24265,91,6245863,9,6245772,0,-9
III,-,6229346,0.0,1.13687e-13,43,43,0,0,0,gene,T12A2.15,0,6229326,0.45394,4175,6233521,20,6229347,-1,-21
III,-,6215455,0.0,3.8147e-06,18,18,0,0,277,gene,C23G10.11,0,6215408,1.16058,8915,6224370,47,6215486,-31,-78
III,-,6206155,0.011811,0.0,254,251,3,3,1,gene,C23G10.8,0,6206147,1.32624,6899,6213054,8,6206147,8,0
III,-,6198358,0.00892857,0.0,224,222,2,2,0,gene,C23G10.7,0,6198351,0.900661,4202,6202560,7,6198358,0,-7
III,-,6194807,0.0,0.5,1,1,0,0,3,gene,C23G10.6,0,6194781,0.306119,1118,6195925,26,6194504,303,277
III,-,6183066,0.3,0.117188,10,7,3,1,5,gene,F42A10.8,0,6182938,0.0863852,8997,6192063,128,6183163,-97,-225
III,-,6178631,0.0030303,0.0,990,987,3,2,10,gene,F42A10.7,0,6178622,4.06141,2281,6180912,9,6178631,0,-9
III,-,6178611,0.0,0.5,1,1,0,0,2738,gene,F42A10.7,0,6178525,4.06141,2301,6180912,86,6178631,-20,-106
III,-,6176806,0.00243161,0.0,1645,1641,4,2,6,gene,F42A10.6,0,6176806,2.35038,1052,6177858,0,6176808,-2,-2
III,-,6172745,0.0152905,0.0,654,644,10,5,2,gene,F42A10.5,0,6172716,2.37959,3326,6176071,29,6172745,0,-29
III,-,6168492,0.494145,0.037479,427,216,211,163,9,gene,F42A10.4,0,6168475,1.51139,2595,6171087,17,6168492,0,-17
III,-,6157703,0.00440529,0.0,454,452,2,0,0,gene,F42A10.3,0,6157673,0.487585,3028,6160731,30,6157703,0,-30
III,-,6149535,0.0,0.0,155,155,0,0,2,gene,Y42G9A.6,0,6149530,0.378525,5250,6154785,5,6149535,0,-5
III,-,6144296,0.0217391,6.53699e-13,46,45,1,1,0,gene,Y42G9A.6,0,6144292,0.378525,10489,6154785,4,6144296,0,-4
III,-,6136221,0.0057377,0.0,1220,1213,7,5,1,gene,Y42G9A.4,0,6136084,2.58153,5724,6141945,137,6136221,0,-137
III,-,6133049,0.0,7.52316e-37,120,120,0,0,2,gene,Y42G9A.4,0,6133047,2.58153,8896,6141945,2,6133049,0,-2
III,-,6131692,0.0,2.58494e-26,85,85,0,0,0,gene,Y42G9A.4,0,6131627,2.58153,10253,6141945,65,6131692,0,-65
III,-,6116276,0.00502008,0.0,1992,1982,10,9,1,gene,T17E9.2,0,6116260,3.32753,7758,6124034,16,6116276,0,-16
III,-,6102807,0.019802,1.99187e-27,101,99,2,1,0,gene,C05D10.4,0,6102686,0.700096,11671,6114478,121,6102686,121,0
III,-,6087667,0.0,2.29589e-41,135,135,0,0,1,gene,C05D10.3,0,6087650,0.129935,963,6088630,17,6087401,266,249
III,-,6046699,0.0,0.015625,6,6,0,0,48,gene,F40H6.4,0,6046690,0.369777,2190,6048889,9,6046852,-153,-162
III,-,6030530,0.0,5.42101e-20,64,64,0,0,0,gene,ZK328.6,0,6030461,0.128248,2212,6032742,69,6030530,0,-69
III,-,6028324,0.0,0.5,1,1,0,0,0,gene,ZK328.8,0,6028318,0.0321981,418,6028742,6,6028324,0,-6
III,-,6026667,0.0,0.5,1,1,0,0,4,gene,ZK328.8,0,6026637,0.0321981,2075,6028742,30,6026783,-116,-146
III,-,5982072,0.0,0.0,171,171,0,0,1,gene,T04C9.6,0,5981860,1.26964,24220,6006292,212,5982073,-1,-213
III,-,5980275,0.0,9.31323e-10,30,30,0,0,19,gene,T04C9.6,0,5980249,1.26964,26017,6006292,26,5980275,0,-26
III,-,5973610,0.00238501,0.0,2935,2928,7,4,5,gene,T04C9.4,0,5973609,4.32297,3117,5976727,1,5973609,1,0
III,-,5958191,0.00414938,0.0,1446,1440,6,5,5,gene,F25B5.7,0,5958162,1.89322,13283,5971474,29,5958162,29,0
III,-,5948092,0.00763359,0.0,262,260,2,2,120,gene,F25B5.6,1,5948040,1.38556,5381,5953473,52,5948092,0,-52
III,-,5948063,0.0,0.0625,4,4,0,0,340,gene,F25B5.6,1,5948040,1.38556,5410,5953473,23,5948092,-29,-52
III,-,5946073,0.967391,1.4013e-45,184,6,178,136,0,gene,F25B5.5,2,5946069,3.24272,91,5946164,4,5946074,-1,-5
III,-,5932862,0.0,0.00195312,9,9,0,0,1,gene,EGAP1.3,0,5932862,0.0857192,2782,5935644,0,5932904,-42,-42
III,-,5925705,0.00280112,0.0,714,712,2,1,0,gene,C28H8.12,0,5925682,1.57607,1105,5926810,23,5925705,0,-23
III,-,5919906,0.00359712,0.0,1390,1385,5,4,21,gene,C28H8.11,0,5919902,3.97427,4436,5924342,4,5919906,0,-4
III,-,5918986,0.0,0.5,1,1,0,0,1,gene,C28H8.11,0,5918964,3.97427,5356,5924342,22,5918986,0,-22
III,-,5918550,0.0,4.76837e-07,21,21,0,0,25,gene,C28H8.11,0,5918489,3.97427,5792,5924342,61,5918550,0,-61
III,-,5918250,0.0,0.03125,5,5,0,0,8,gene,C28H8.11,0,5918232,3.97427,6092,5924342,18,5918250,0,-18
III,-,5906069,0.00460526,0.0,1520,1513,7,1,38,gene,C28H8.9,0,5906066,2.16432,11508,5917577,3,5906066,3,0
III,-,5895962,0.0,0.0,232,232,0,0,0,gene,C28H8.6,0,5895957,2.1866,7571,5903533,5,5895957,5,0
III,-,5876421,0.0,0.0,302,302,0,0,4,gene,F01F1.12,0,5876272,32.0786,477,5876898,149,5876421,0,-149
III,-,5872022,0.0,0.25,2,2,0,0,1,gene,F01F1.11,1,5872007,0.672958,2604,5874626,15,5872348,-326,-341
III,-,5869481,0.805195,5.66212e-22,231,45,186,128,109,gene,F01F1.15,2,5869480,1.17351,155,5869636,1,5869481,0,-1
III,-,5868451,0.958716,0.0,218,9,209,131,0,gene,F01F1.10,3,5868451,0.461172,51,5868502,0,5868451,0,0
III,-,5863498,0.00182927,0.0,1640,1637,3,3,1,gene,F01F1.9,0,5863498,2.14324,2953,5866451,0,5863498,0,0
III,-,5855639,0.0132353,0.0,1360,1342,18,15,2,gene,F01F1.8,1,5855634,5.89669,6164,5861803,5,5855639,0,-5
III,-,5855635,0.0,1.90735e-06,19,19,0,0,65,gene,F01F1.8,1,5855634,5.89669,6168,5861803,1,5855635,0,-1
III,-,5853219,0.587234,2.81719e-05,470,194,276,219,0,gene,F01F1.7,2,5853215,0.949151,265,5853484,4,5853216,3,-1
III,-,5833697,0.0272727,0.0,220,214,6,5,1,gene,R12B2.5,0,5833601,3.39979,246,5833943,96,5833697,0,-96
III,-,5803024,0.0,5.96046e-08,24,24,0,0,117,gene,W03A3.2,0,5803003,0.214923,25484,5828508,21,5802993,31,10
III,-,5803004,0.0,1.77636e-15,49,49,0,0,129,gene,W03A3.2,0,5803003,0.214923,25504,5828508,1,5802993,11,10
III,-,5785273,0.0232558,5.1355e-34,129,126,3,2,2,gene,Y37B11A.3,0,5785261,0.181029,5899,5791172,12,5785085,188,176
III,-,5709275,0.0,5.82077e-11,34,34,0,0,1,gene,B0336.11,0,5709274,0.469359,18026,5727301,1,5709274,1,0
III,-,5706078,0.0134066,0.0,12009,11848,161,134,0,gene,B0336.10,1,5706073,71.9881,591,5706669,5,5706078,0,-5
III,-,5705415,0.902326,1.29735e-36,215,21,194,135,2,gene,B0336.9,2,5705412,0.56395,44,5705459,3,5705412,3,0
III,-,5697963,0.0017585,0.0,1706,1703,3,2,24,gene,B0336.8,1,5697960,2.15162,4201,5702164,3,5697960,3,0
III,-,5697316,0.98419,0.0,253,4,249,191,0,gene,B0336.7,2,5697298,0.353255,113,5697429,18,5697316,0,-18
III,-,5692691,0.0,0.0625,4,4,0,0,1,gene,B0336.6,0,5692681,1.49701,1995,5694686,10,5692681,10,0
III,-,5692681,0.00589722,0.0,1187,1180,7,5,18,gene,B0336.6,0,5692681,1.49701,2005,5694686,0,5692681,0,0
III,-,5684049,0.01,0.0,200,198,2,2,1,gene,F54E7.7,0,5683980,1.18233,6007,5690056,69,5684049,0,-69
III,-,5678956,0.0123457,0.0,324,320,4,4,102,gene,F54E7.8,1,5678939,0.893018,3300,5682256,17,5678984,-28,-45
III,-,5677841,0.99537,0.0,432,2,430,232,322,gene,F54E7.9,2,5677839,0.979143,72,5677913,2,5677843,-2,-4
III,-,5610300,0.00490196,0.0,204,203,1,1,1,gene,C05D2.8,0,5610298,0.912616,44636,5654936,2,5610300,0,-2
III,-,5603405,0.0,0.0,266,266,0,0,17,gene,C05D2.6,1,5603384,0.67808,4058,5607463,21,5603384,21,0
III,-,5600012,0.891544,0.0,544,59,485,316,2,gene,C05D2.10,2,5600005,1.54854,328,5600340,7,5600012,0,-7
III,-,5591673,0.00245459,0.0,2037,2032,5,5,2,gene,F56D2.6,0,5591661,2.34554,6229,5597902,12,5591673,0,-12
III,-,5554890,0.00100536,0.0,2984,2981,3,3,1,gene,F09F7.7,0,5554872,2.00465,6679,5561569,18,5554890,0,-18
III,-,5552085,0.00628571,0.0,1750,1739,11,8,5,gene,F09F7.6,0,5552071,5.75972,1359,5553444,14,5552071,14,0
III,-,5543133,0.0,1.49012e-08,26,26,0,0,39,gene,D1044.6,0,5543091,0.636418,4359,5547492,42,5543124,9,-33
III,-,5517487,0.0,0.0625,4,4,0,0,2,gene,D1044.8,0,5517485,0.0237066,4189,5521676,2,5517480,7,5
III,-,5495226,0.0,9.09495e-13,40,40,0,0,30,gene,R02F2.8,0,5495211,0.293307,11780,5507006,15,5495226,0,-15
III,-,5483731,0.0116279,0.0,172,170,2,2,0,gene,R02F2.7,0,5483731,0.368653,9154,5492885,0,5483731,0,0
III,-,5449823,0.0,5.96046e-08,24,24,0,0,3,gene,F48E8.8,0,5449808,0.105456,28817,5478640,15,5449584,239,224
III,-,5442719,0.0127737,0.0,548,541,7,5,1,gene,T24G10.2,1,5442687,2.04802,3749,5446468,32,5442719,0,-32
III,-,5440592,0.94686,2.8026e-45,207,11,196,142,0,gene,W03A5.6,2,5440590,0.387059,121,5440713,2,5440590,2,0
III,-,5434207,0.0,0.0,218,218,0,0,6,gene,W03A5.4,0,5434146,0.967408,6506,5440713,61,5434207,0,-61
III,-,5419796,0.0,0.125,3,3,0,0,1,gene,W03A5.7,0,5419691,1.64796,11542,5431338,105,5419523,273,168
III,-,5419523,0.0,0.0,251,251,0,0,3,gene,W03A5.7,0,5419523,1.64796,11815,5431338,0,5419523,0,0
III,-,5413967,0.0,2.22045e-16,52,52,0,0,0,gene,W03A5.3,0,5413951,0.259607,1574,5415541,16,5413951,16,0
III,-,5413952,0.0,1.50463e-36,119,119,0,0,78,gene,W03A5.3,0,5413951,0.259607,1589,5415541,1,5413951,1,0
III,-,5404943,0.0,2.40741e-35,115,115,0,0,0,gene,Y32H12A.8,1,5404940,0.284982,8238,5413181,3,5404943,0,-3
III,-,5385365,0.955128,4.2606e-36,156,7,149,106,0,gene,Y32H12A.7,2,5385361,0.506946,106,5385471,4,5385365,0,-4
III,-,5385326,0.75,0.25,4,1,3,2,78,gene,Y32H12A.7,2,5385265,0.506946,145,5385471,61,5385365,-39,-100
III,-,5382131,0.95082,1.56082e-14,61,3,58,42,0,gene,Y32H12A.6,3,5382131,0.212921,114,5382245,0,5381959,172,172
III,-,5381960,0.840909,2.17827e-06,44,7,37,18,1,gene,Y32H12A.6,3,5381948,0.212921,285,5382245,12,5381959,1,-11
III,-,5380208,0.2,0.15625,5,4,1,1,1,gene,Y32H12A.5,0,5380155,0.894127,655,5380863,53,5379888,320,267
III,-,5379887,0.00966184,0.0,207,205,2,2,1,gene,Y32H12A.5,0,5379877,0.894127,976,5380863,10,5379887,0,-10
III,-,5371232,0.128085,0.0,851,742,109,87,0,gene,Y32H12A.4,0,5371229,2.41079,4423,5375655,3,5371232,0,-3
III,-,5368011,0.205128,0.000111911,39,31,8,5,1,gene,Y32H12A.3,0,5367998,1.49732,911,5368922,13,5368003,8,-5
III,-,5368003,0.0424328,0.0,707,677,30,26,38,gene,Y32H12A.3,0,5367998,1.49732,919,5368922,5,5368003,0,-5
III,-,5349325,0.0,0.0,155,155,0,0,34,gene,Y32H12A.2,1,5349318,0.563691,3304,5352629,7,5349325,0,-7
III,-,5346075,0.882253,0.0,586,69,517,347,8,gene,ZK121.1,2,5346060,1.39263,7,5346082,15,5346075,0,-15
III,-,5345803,0.809524,0.00285387,21,4,17,16,1,gene,ZK121.1,2,5345782,1.39263,89,5345892,21,5345803,0,-21
III,-,5274724,0.00366649,0.0,14728,14674,54,50,20,gene,ZC395.10,1,5274715,9.30788,11319,5286043,9,5274724,0,-9
III,-,5273747,1.0,0.5,1,0,1,1,2,gene,ZC395.8,2,5273686,0.694164,10,5273757,61,5273430,317,256
III,-,5273430,0.925339,0.0,442,33,409,341,1,gene,ZC395.8,2,5273428,0.694164,218,5273648,2,5273430,0,-2
III,-,5254149,0.00847458,0.0,354,351,3,3,0,gene,C34E10.8,0,5254145,0.679285,8238,5262387,4,5254150,-1,-5
III,-,5227843,0.0104987,0.0,762,754,8,6,0,gene,C34E10.10,0,5227840,0.665486,12710,5240553,3,5227648,195,192
III,-,5217563,0.0,1.19209e-07,23,23,0,0,0,gene,ZC155.5,1,5217539,0.110092,2775,5220338,24,5217563,0,-24
III,-,5215173,0.0,0.0625,4,4,0,0,7,gene,ZC155.4,2,5215112,0.972968,744,5215917,61,5214964,209,148
III,-,5214964,0.00652529,0.0,613,609,4,4,3,gene,ZC155.4,2,5214963,0.972968,953,5215917,1,5214964,0,-1
III,-,5206870,0.183673,3.42453e-34,343,280,63,37,0,gene,ZC155.3,2,5206856,0.736513,655,5207525,14,5206870,0,-14
III,-,5199636,0.209091,2.8026e-45,550,435,115,96,1,gene,K10D2.6,0,5199619,2.45237,4008,5203644,17,5199636,0,-17
III,-,5172004,0.0126716,0.0,947,935,12,12,4,gene,T10F2.4,1,5172001,2.57324,24659,5196663,3,5172004,0,-3
III,-,5169758,0.88764,3.60947e-28,178,20,158,126,1,gene,T10F2.3,2,5169698,0.730465,131,5169889,60,5169758,0,-60
III,-,5165270,0.833837,6.03658e-37,331,55,276,194,3,gene,T10F2.2,3,5165250,1.17242,348,5165618,20,5165250,20,0
III,-,5163586,0.949153,1.99484e-39,177,9,168,128,17,gene,T10F2.1,4,5163583,2.21274,79,5163665,3,5163586,0,-3
III,-,5162451,0.0,0.125,3,3,0,0,1,gene,T10F2.1,4,5162367,2.21274,1214,5163665,84,5162236,215,131
III,-,5162236,0.0190694,0.0,1311,1286,25,22,3,gene,T10F2.1,4,5162128,2.21274,74,5162310,108,5162236,0,-108
III,-,5162192,0.5,0.5,2,1,1,1,428,gene,T10F2.1,4,5162128,2.21274,118,5162310,64,5162236,-44,-108
III,-,5159564,0.93617,0.0,470,30,440,332,0,gene,T10F2.5,5,5159563,0.867468,120,5159684,1,5159563,1,0
III,-,5158733,0.988095,4.3427e-24,84,1,83,47,1,gene,Y54H5A.4,6,5158726,0.328147,98,5158831,7,5158733,0,-7
III,-,5153121,0.0,7.88861e-31,100,100,0,0,3,gene,Y54H5A.3,1,5153086,1.26417,2268,5155389,35,5153113,8,-27
III,-,5153109,0.00489297,0.0,1635,1627,8,6,175,gene,Y54H5A.3,1,5153086,1.26417,2280,5155389,23,5153113,-4,-27
III,-,5149537,0.883002,0.0,453,53,400,297,0,gene,Y54H5A.2,2,5149537,1.14823,2330,5151867,0,5149537,0,0
III,-,5085583,0.0,0.000488281,11,11,0,0,4,gene,F54D8.4,0,5085391,0.150292,45298,5130881,192,5085250,333,141
III,-,5071563,0.0,0.0,221,221,0,0,0,gene,C45G9.12,0,5071558,0.399298,11359,5082922,5,5071558,5,0
III,-,5053301,0.00649351,7.00649e-45,154,153,1,0,3,gene,C45G9.8,0,5053282,0.0674762,1262,5054563,19,5053282,19,0
III,-,5047124,0.00436681,0.0,229,228,1,1,0,gene,C45G9.7,0,5047105,0.489111,2938,5050062,19,5047105,19,0
III,-,5017860,0.0,0.125,3,3,0,0,0,gene,R144.7,1,5017810,4.2138,28273,5046133,50,5017613,247,197
III,-,5017660,0.00364299,0.0,1647,1641,6,5,0,gene,R144.7,1,5017613,4.2138,28473,5046133,47,5017613,47,0
III,-,5008794,0.855422,1.00142e-11,83,12,71,45,4,gene,R144.11,2,5008794,0.381685,95,5008889,0,5008794,0,0
III,-,5006945,0.900585,3.77272e-29,171,17,154,101,0,gene,R144.12,3,5006928,0.669436,107,5007052,17,5006945,0,-17
III,-,5006935,0.901099,5.12971e-31,182,18,164,78,445,gene,R144.12,3,5006928,0.669436,117,5007052,7,5006945,-10,-17
III,-,5004685,0.97619,3.82623e-33,126,3,123,70,17,gene,R144.6,4,5004684,0.418531,99,5004784,1,5004685,0,-1
III,-,5002295,0.00175747,0.0,569,568,1,1,0,gene,R144.10,0,5002274,0.415554,866,5003161,21,5002274,21,0
III,-,4998125,0.02,0.0,450,441,9,8,2,gene,C27F2.8,0,4998105,1.29282,3177,5001302,20,4998125,0,-20
III,-,4986862,0.0110497,0.0,181,179,2,2,71,gene,C27F2.10,0,4986837,0.697379,4539,4991401,25,4986895,-33,-58
III,-,4986856,0.0,2.32831e-10,32,32,0,0,133,gene,C27F2.10,0,4986837,0.697379,4545,4991401,19,4986895,-39,-58
III,-,4984456,0.00775194,1.89548e-37,129,128,1,1,1,gene,C27F2.7,0,4984438,0.17471,527,4984983,18,4984438,18,0
III,-,4962890,0.0,0.00195312,9,9,0,0,2,gene,C27F2.5,2,4962889,1.3065,16867,4979757,1,4962889,1,0
III,-,4961676,0.926332,0.0,638,47,591,294,22,gene,C27F2.5,2,4961675,1.3065,102,4961778,1,4961676,0,-1
III,-,4960262,0.962744,0.0,1691,63,1628,1120,14,gene,C27F2.4,3,4960257,1.10591,89,4960351,5,4960263,-1,-6
III,-,4932134,0.0,0.0,169,169,0,0,17,gene,C26E6.12,0,4932122,0.47639,26338,4958472,12,4932394,-260,-272
III,-,4930167,0.0,0.0,257,257,0,0,6,gene,C26E6.9,1,4930149,0.707323,397,4930564,18,4930167,0,-18
III,-,4921710,0.737892,5.16108e-20,351,92,259,189,2,gene,C26E6.11,2,4921710,1.15232,688,4922398,0,4921710,0,0
III,-,4920305,0.0,0.5,1,1,0,0,2,gene,C26E6.8,3,4920279,0.747761,103,4920408,26,4920282,23,-3
III,-,4920282,0.821705,1.03922e-39,387,69,318,210,1,gene,C26E6.8,3,4920279,0.747761,126,4920408,3,4920282,0,-3
III,-,4917971,0.0063322,0.0,2053,2040,13,12,12,gene,F26F4.11,4,4917968,3.00096,273,4918244,3,4917973,-2,-5
III,-,4917146,0.0,0.5,1,1,0,0,0,gene,F26F4.10,5,4917070,1.69738,13,4917159,76,4917080,66,-10
III,-,4917092,1.0,2.06795e-25,82,0,82,63,0,gene,F26F4.10,5,4917070,1.69738,67,4917159,22,4917092,0,-22
III,-,4917080,0.976852,0.0,1080,25,1055,678,144,gene,F26F4.10,5,4917070,1.69738,79,4917159,10,4917080,0,-10
III,-,4910001,0.839015,0.0,528,85,443,310,4,gene,F26F4.12,2,4910001,0.71358,433,4910434,0,4910001,0,0
III,-,4903847,0.965021,0.0,486,17,469,354,15,gene,F26F4.13,2,4903833,0.937756,114,4903961,14,4903669,178,164
III,-,4899042,0.00687285,0.0,291,289,2,2,0,gene,F26F4.7,1,4898920,1.33671,4098,4903140,122,4899048,-6,-128
III,-,4893372,0.693141,3.18016e-11,277,85,192,116,1,gene,F26F4.6,2,4893356,0.909005,260,4893632,16,4893372,0,-16
III,-,4890914,0.284,1.88246e-12,250,179,71,61,4,gene,F26F4.5,3,4890913,0.448566,657,4891571,1,4890914,0,-1
III,-,4878274,0.00722767,0.0,1937,1923,14,12,1,gene,C35D10.13,0,4878273,3.98704,3598,4881872,1,4878273,1,0
III,-,4878236,0.0,0.03125,5,5,0,0,971,gene,C35D10.13,0,4878155,3.98704,3636,4881872,81,4878273,-37,-118
III,-,4874728,0.0714286,0.000854492,14,13,1,0,1,gene,C35D10.12,0,4874728,0.10451,2759,4877487,0,4874714,14,14
III,-,4861757,0.0020284,0.0,1479,1476,3,3,2,gene,C35D10.10,0,4861749,1.28444,6620,4868377,8,4861757,0,-8
III,-,4849826,0.0,0.0,182,182,0,0,43,gene,F26A1.14,0,4849813,0.4233,10748,4860574,13,4849813,13,0
III,-,4819910,0.333333,0.375,3,2,1,1,0,gene,F26A1.7,0,4819906,0.00865337,771,4820681,4,4819906,4,0
III,-,4814791,0.0,2.98023e-08,25,25,0,0,0,gene,C38D4.8,0,4814777,0.0843482,1210,4816001,14,4814777,14,0
III,-,4811114,0.0,1.19209e-07,23,23,0,0,4,gene,C38D4.7,0,4811113,0.0936372,2035,4813149,1,4811125,-11,-12
III,-,4808673,0.0151771,0.0,593,584,9,9,0,gene,C38D4.6,0,4808672,1.56765,1337,4810010,1,4808673,0,-1
III,-,4781951,0.0,0.0,419,419,0,0,0,gene,B0393.6,0,4781945,1.03795,1206,4783157,6,4781945,6,0
III,-,4780116,0.0,0.0625,4,4,0,0,1,gene,B0393.9,0,4779973,0.548552,7,4780123,143,4780013,103,-40
III,-,4779880,0.0,3.72529e-09,28,28,0,0,82,gene,B0393.9,0,4779880,0.548552,243,4780123,0,4779880,0,0
III,-,4754015,0.00646057,0.0,16562,16455,107,93,8,gene,B0393.1,0,4754010,114.594,5689,4759704,5,4754015,0,-5
III,-,4752405,0.0625,6.14477e-11,48,45,3,2,0,gene,B0393.8,0,4752380,0,554,4752959,25,4752334,71,46
III,-,4740039,0.0,0.0,505,505,0,0,0,gene,F17C8.4,0,4740029,1.86902,4751,4744790,10,4740039,0,-10
III,-,4740032,0.0,0.0,244,244,0,0,67,gene,F17C8.4,0,4740029,1.86902,4758,4744790,3,4740032,0,-3
III,-,4720767,0.0,0.5,1,1,0,0,0,gene,T04A8.14,1,4720678,1.84886,16783,4737550,89,4720629,138,49
III,-,4720632,0.00603318,0.0,663,659,4,4,0,gene,T04A8.14,1,4720629,1.84886,16918,4737550,3,4720629,3,0
III,-,4715152,0.897059,8.33541e-34,204,21,183,148,15,gene,T04A8.15,2,4715141,0.386878,103,4715255,11,4715152,0,-11
III,-,4703983,0.015873,6.83047e-18,63,62,1,1,41,gene,T04A8.16,1,4703980,0.406492,8544,4712527,3,4704018,-35,-38
III,-,4700188,0.908367,0.0,502,46,456,334,7,gene,T04A8.10,2,4700188,0.724363,101,4700289,0,4700188,0,0
III,-,4693265,0.00402414,0.0,497,495,2,2,0,gene,T04A8.6,0,4693253,1.36334,6106,4699371,12,4693263,2,-10
III,-,4693258,0.0,1.86265e-09,29,29,0,0,436,gene,T04A8.6,0,4693253,1.36334,6113,4699371,5,4693263,-5,-10
III,-,4687166,0.0,1.19209e-07,23,23,0,0,31,gene,T04A8.4,0,4687160,0.667939,4893,4692059,6,4687160,6,0
III,-,4665331,0.0,0.0,157,157,0,0,1,gene,T23F11.4,0,4665324,0.400272,4549,4669880,7,4665324,7,0
III,-,4647815,0.0,0.5,1,1,0,0,20,gene,T23F11.6,0,4647801,0.176495,6453,4654268,14,4647861,-46,-60
III,-,4643268,0.0,6.93889e-18,57,57,0,0,5,gene,F10F2.2,0,4643247,0.377864,627,4643895,21,4643247,21,0
III,-,4612313,0.0,8.96831e-44,143,143,0,0,47,gene,F10F2.1,1,4612302,0.997846,6525,4618838,11,4612302,11,0
III,-,4595788,0.139556,0.0,2250,1936,314,230,3,gene,F35G12.10,2,4595788,3.3422,313,4596101,0,4595788,0,0
III,-,4594391,0.774086,1.13505e-43,602,136,466,326,12,gene,F35G12.9,3,4594389,1.96463,117,4594508,2,4594389,2,0
III,-,4578404,0.0,0.0,216,216,0,0,0,gene,F35G12.3,0,4578394,0.652167,8079,4586483,10,4578404,0,-10
III,-,4568097,0.0,0.0,177,177,0,0,1,gene,F35G12.1,0,4568093,0.604375,3634,4571731,4,4568097,0,-4
III,-,4542419,0.0166667,0.0,180,177,3,1,27,gene,M88.2,0,4542413,0.990208,1120,4543539,6,4542419,0,-6
III,-,4540590,0.0,3.72529e-09,28,28,0,0,9,gene,M88.1,0,4540588,0.88439,787,4541377,2,4540590,0,-2
III,-,4508081,0.0102244,0.0,4010,3969,41,39,1,gene,C07G2.3,1,4508051,10.799,29162,4537243,30,4508081,0,-30
III,-,4501477,0.0128205,2.5808e-22,78,77,1,0,1,gene,C07G2.3,1,4501405,10.799,35766,4537243,72,4501477,0,-72
III,-,4499011,0.743638,0.0,1061,272,789,516,1,gene,C07G2.2,2,4498970,3.49119,145,4499156,41,4499011,0,-41
III,-,4494418,0.0,0.0,212,212,0,0,17,gene,C07G2.2,2,4494388,3.49119,4738,4499156,30,4494418,0,-30
III,-,4477540,0.00273973,0.0,365,364,1,0,0,gene,F56F3.6,0,4477489,1.18058,14055,4491595,51,4477551,-11,-62
III,-,4475118,0.00323363,0.0,1237,1233,4,3,9,gene,F56F3.1,0,4475111,4.71536,1663,4476781,7,4475111,7,0
III,-,4467345,0.0031348,0.0,319,318,1,1,4,gene,F56F3.2,0,4467343,0.582555,4034,4471379,2,4467345,0,-2
III,-,4449911,0.00806452,0.0,620,615,5,4,0,gene,C28A5.4,0,4449911,1.37763,12861,4462772,0,4449911,0,0
III,-,4434360,0.0136986,1.18662e-40,146,144,2,2,0,gene,C28A5.1,0,4434335,0.21936,362,4434722,25,4434315,45,20
III,-,4429471,1.0,0.5,1,0,1,1,0,gene,C28A5.6,0,4429470,0.120248,118,4429589,1,4429470,1,0
III,-,4419138,0.0022242,0.0,2248,2243,5,4,1,gene,R07E5.7,1,4419137,2.8973,4542,4423680,1,4419138,0,-1
III,-,4418027,0.748762,0.0,808,203,605,367,6,gene,R07E5.10,2,4418023,1.65328,286,4418313,4,4418027,0,-4
III,-,4417783,0.772388,1.31736e-38,536,122,414,251,3,gene,R07E5.10,2,4417632,1.65328,12,4417795,151,4417783,0,-151
III,-,4415386,1.0,0.5,1,0,1,0,0,gene,R07E5.11,3,4415361,0.923053,100,4415486,25,4415197,189,164
III,-,4415206,0.852632,0.0,475,70,405,316,2,gene,R07E5.11,3,4415197,0.923053,280,4415486,9,4415197,9,0
III,-,4327959,0.00400802,0.0,499,497,2,2,0,gene,H38K22.5,0,4327959,1.32804,13995,4341954,0,4327959,0,0
III,-,4313100,0.0,7.17465e-43,140,140,0,0,8,gene,H38K22.1,1,4313096,0.568917,11168,4324268,4,4313096,4,0
III,-,4302365,0.201183,4.78362e-30,338,270,68,45,2,gene,R10E4.9,2,4302353,1.2042,701,4303066,12,4302367,-2,-14
III,-,4301011,0.0,0.0,162,162,0,0,1,gene,R10E4.11,0,4300996,0.452099,514,4301525,15,4301011,0,-15
III,-,4293371,0.905325,1.35906e-29,169,16,153,123,3,gene,R10E4.5,0,4293370,0.251004,3116,4296487,1,4293385,-14,-15
III,-,4291238,0.00435019,0.0,1839,1831,8,8,0,gene,R10E4.4,0,4291220,2.23587,319,4291557,18,4291238,0,-18
III,-,4280486,0.0,0.25,2,2,0,0,2,gene,R10E4.2,0,4280421,11.536,5317,4285803,65,4280191,295,230
III,-,4280189,0.00326749,0.0,6733,6711,22,15,1,gene,R10E4.2,0,4280087,11.536,5614,4285803,102,4280189,0,-102
III,-,4279234,1.0,0.0,495,0,495,495,116,gene,R10E4.2,0,4279230,11.536,6569,4285803,4,4279230,4,0
III,-,4279231,0.015625,0.0,192,189,3,2,117,gene,R10E4.2,0,4279230,11.536,6572,4285803,1,4279230,1,0
III,-,4269242,0.0130548,0.0,383,378,5,4,1,gene,T08A11.2,1,4269238,1.434,6929,4276171,4,4269242,0,-4
III,-,4263114,0.808594,1.05065e-24,256,49,207,149,1,gene,T08A11.1,2,4263020,0.348688,643,4263757,94,4263020,94,0
III,-,4247643,0.829268,2.32534e-14,123,21,102,65,0,gene,Y44F5A.1,3,4247643,0.363502,480,4248123,0,4247643,0,0
III,-,4244357,0.88125,0.0,480,57,423,321,0,gene,F43C1.3,4,4244357,0.295255,473,4244830,0,4244357,0,0
III,-,4243533,0.873321,0.0,521,66,455,323,3,gene,F43C1.6,5,4243533,0.816562,112,4243645,0,4243533,0,0
III,-,4233191,0.0102564,0.0,195,193,2,2,1,gene,F43C1.4,0,4233174,0.307566,8169,4241360,17,4233191,0,-17
III,-,4228080,0.00338491,0.0,2068,2061,7,7,0,gene,F43C1.2,0,4228069,1.75105,2290,4230370,11,4228066,14,3
III,-,4219615,0.00229358,0.0,436,435,1,1,2,gene,F43C1.2,0,4219615,1.75105,10755,4230370,0,4219615,0,0
III,-,4186774,0.00255754,0.0,782,780,2,2,2,gene,R74.1,1,4186757,2.21916,2560,4189334,17,4186774,0,-17
III,-,4181411,0.898026,0.0,304,31,273,216,0,gene,C16C10.1,2,4181405,0.400146,104,4181515,6,4181411,0,-6
III,-,4181405,1.0,0.015625,6,0,6,5,423,gene,C16C10.1,2,4181405,0.400146,110,4181515,0,4181411,-6,-6
III,-,4178637,0.939328,0.0,923,56,867,635,2,gene,C16C10.2,3,4178631,0.737408,119,4178756,6,4178637,0,-6
III,-,4176132,0.00544465,0.0,1102,1096,6,6,0,gene,C16C10.3,0,4176126,1.96225,1378,4177510,6,4176132,0,-6
III,-,4170920,0.0412371,0.0,873,837,36,27,1,gene,C16C10.5,1,4170912,1.14693,1390,4172310,8,4171134,-214,-222
III,-,4168738,0.938053,0.0,339,21,318,201,58,gene,C16C10.6,2,4168738,0.940407,116,4168854,0,4168738,0,0
III,-,4166818,0.985112,0.0,403,6,397,261,16,gene,C16C10.7,3,4166806,1.43029,101,4166919,12,4166808,10,-2
III,-,4164160,1.0,0.5,1,0,1,1,1,gene,C16C10.8,4,4164144,0.997042,84,4164244,16,4164144,16,0
III,-,4164144,0.973684,0.0,760,20,740,417,16,gene,C16C10.8,4,4164144,0.997042,100,4164244,0,4164144,0,0
III,-,4157365,0.0,3.05176e-05,15,15,0,0,6,gene,C16C10.9,0,4157353,0.0154375,4562,4161927,12,4157353,12,0
III,-,4098120,0.00299401,0.0,334,333,1,1,77,gene,C03C10.4,0,4098101,2.11567,49277,4147397,19,4098101,19,0
III,-,4094894,0.00934783,0.0,4600,4557,43,39,5,gene,C03C10.3,0,4094861,7.99017,1975,4096869,33,4094894,0,-33
III,-,4090539,0.0,0.00195312,9,9,0,0,3,gene,C03C10.5,0,4090531,0.641636,2734,4093273,8,4090531,8,0
III,-,4086610,0.005997,0.0,2001,1989,12,11,4,gene,C03C10.1,0,4086491,9.28817,2980,4089590,119,4086610,0,-119
III,-,4057926,0.0180723,8.40779e-45,166,163,3,2,1,gene,E03A3.2,0,4057924,0.397072,406,4058332,2,4057948,-22,-24
III,-,4036813,0.0,7.34684e-40,130,130,0,0,0,gene,T02C12.1,0,4036806,1.16478,4402,4041215,7,4036813,0,-7
III,-,4036807,0.00191205,0.0,523,522,1,1,5,gene,T02C12.1,0,4036806,1.16478,4408,4041215,1,4036813,-6,-7
III,-,4017603,0.00622969,0.0,11076,11007,69,59,10,gene,C36E8.5,0,4017598,37.0592,8885,4026488,5,4017603,0,-5
III,-,4004119,0.0,7.27596e-12,37,37,0,0,1,gene,C36E8.1,0,4004075,2.20729,11614,4015733,44,4004120,-1,-45
III,-,4004091,0.00661626,0.0,1058,1051,7,6,17,gene,C36E8.1,0,4004075,2.20729,11642,4015733,16,4004091,0,-16
III,-,3992161,0.00813008,1.15669e-35,123,122,1,1,0,gene,C36E8.2,0,3992140,0.502317,7104,3999265,21,3992152,9,-12
III,-,3976368,0.00298507,0.0,335,334,1,1,10,gene,R10E9.1,0,3976267,1.7491,9174,3985542,101,3976368,0,-101
III,-,3972896,0.0,6.16298e-33,107,107,0,0,0,gene,R10E9.1,0,3972692,1.7491,12646,3985542,204,3972896,0,-204
III,-,3935885,0.0,0.0,805,805,0,0,1,gene,F37A8.4,0,3935842,0.855323,26814,3962699,43,3935885,0,-43
III,-,3921688,0.0,0.0,262,262,0,0,10,gene,ZK1058.5,0,3921683,0.291024,2081,3923769,5,3921683,5,0
III,-,3914126,0.00212014,0.0,1415,1412,3,3,0,gene,ZK1058.2,1,3914106,2.66175,6477,3920603,20,3914115,11,-9
III,-,3907664,0.132647,0.0,1651,1432,219,163,37,gene,ZK1058.1,2,3907636,2.06075,1251,3908915,28,3907664,0,-28
III,-,3891431,0.0,5.96046e-08,24,24,0,0,0,gene,F13B10.1,0,3891375,1.53531,11598,3903029,56,3891431,0,-56
III,-,3882702,0.0,1.49012e-08,26,26,0,0,0,gene,F13B10.1,0,3882607,1.53531,20327,3903029,95,3882702,0,-95
III,-,3882525,0.0,0.125,3,3,0,0,1,gene,F13B10.1,0,3882496,1.53531,20504,3903029,29,3882525,0,-29
III,-,3871612,0.0,7.45058e-09,27,27,0,0,0,gene,F13B10.1,0,3871475,1.53531,31417,3903029,137,3871612,0,-137
III,-,3862937,0.00961538,5.1276e-30,104,103,1,1,0,gene,C36A4.8,1,3862937,0.258002,6631,3869568,0,3862937,0,0
III,-,3852053,0.153846,5.93468e-06,39,33,6,5,0,gene,C36A4.6,2,3852050,0.0858568,1038,3853091,3,3852050,3,0
III,-,3843593,0.00234742,0.0,426,425,1,0,5,gene,C36A4.4,0,3843589,0.92793,1541,3845134,4,3843593,0,-4
III,-,3839456,0.0,1.19209e-07,23,23,0,0,0,gene,C36A4.3,0,3839456,0.127084,1785,3841241,0,3839456,0,0
III,-,3832125,0.0,0.03125,5,5,0,0,0,gene,C36A4.14,0,3832108,None,5393,3837518,17,3832218,-93,-110
III,-,3819658,0.0101523,0.0,197,195,2,2,0,gene,R13G10.1,0,3819656,0.971404,1086,3820744,2,3819658,0,-2
III,-,3809009,0.00378788,0.0,264,263,1,0,1,gene,T24A11.3,0,3808993,0.772581,4601,3813610,16,3809009,0,-16
III,-,3800444,0.0103397,0.0,677,670,7,6,22,gene,T24A11.1,0,3800317,2.49523,2062,3802506,127,3800444,0,-127
III,-,3800033,0.0,0.25,2,2,0,0,1,gene,T24A11.1,0,3800016,2.49523,2473,3802506,17,3800033,0,-17
III,-,3773305,0.011976,0.0,167,165,2,2,254,gene,C44F1.3,0,3773239,2.34408,1563,3774868,66,3773312,-7,-73
III,-,3765533,0.0105263,2.39814e-27,95,94,1,1,0,gene,C44F1.1,0,3765526,0.247087,5868,3771401,7,3765526,7,0
III,-,3759366,0.0,0.5,1,1,0,0,1,gene,F34D10.6,0,3759338,0.0589137,992,3760358,28,3759391,-25,-53
III,-,3752404,0.1,0.00976562,10,9,1,0,9,gene,F34D10.6,0,3752395,0.0589137,553,3752957,9,3752404,0,-9
III,-,3735018,0.00865801,0.0,231,229,2,1,2,gene,F34D10.2,0,3735018,0.453369,12488,3747506,0,3735018,0,0
III,-,3726479,0.0138889,0.0,432,426,6,6,3,gene,C14B1.9,2,3726477,0.799144,183,3726662,2,3726479,0,-2
III,-,3724957,0.974212,0.0,349,9,340,280,1,gene,C14B1.12,3,3724953,None,96,3725053,4,3724953,4,0
III,-,3723582,0.112821,0.0,390,346,44,34,1,gene,C14B1.7,4,3723576,None,618,3724200,6,3723576,6,0
III,-,3719879,0.0,0.5,1,1,0,0,0,gene,C14B1.8,5,3719740,0.840505,10,3719889,139,3719652,227,88
III,-,3719659,0.657258,2.03339e-07,248,85,163,128,91,gene,C14B1.8,5,3719652,0.840505,230,3719889,7,3719652,7,0
III,-,3701440,0.0147905,0.0,1217,1199,18,16,10,gene,C14B1.1,1,3701434,10.2867,16791,3718231,6,3701440,0,-6
III,-,3699619,0.953947,5.66292e-35,152,7,145,126,1,gene,T27D1.1,2,3699612,0.425111,99,3699718,7,3699612,7,0
III,-,3685787,0.0,0.015625,6,6,0,0,0,gene,T27D1.3,0,3685771,0.0951403,12012,3697799,16,3685787,0,-16
III,-,3670415,0.0240964,3.51862e-22,83,81,2,1,1,gene,C46F11.6,0,3670306,1.28553,12817,3683232,109,3670415,0,-109
III,-,3664283,0.00746269,6.15298e-39,134,133,1,1,1,gene,C46F11.4,1,3664277,0.481172,2728,3667011,6,3664473,-190,-196
III,-,3657581,0.945946,8.72155e-25,111,6,105,53,0,gene,C46F11.5,2,3657555,0.955464,114,3657695,26,3657581,0,-26
III,-,3650791,0.0,0.0625,4,4,0,0,32,gene,C46F11.3,0,3650726,0.320144,2055,3652846,65,3650811,-20,-85
III,-,3630346,0.0182482,0.0,274,269,5,5,1,gene,C32A3.2,1,3630346,0.489507,18437,3648783,0,3630346,0,0
III,-,3627122,0.930233,8.54792e-43,215,15,200,170,7,gene,C32A3.1,2,3627108,1.31388,948,3628070,14,3627122,0,-14
III,-,3618512,0.00505051,0.0,198,197,1,1,0,gene,C32A3.1,2,3618502,1.31388,9558,3628070,10,3618512,0,-10
III,-,3549832,0.0021692,0.0,461,460,1,1,16,gene,C54C6.5,0,3549822,0.38831,28949,3578781,10,3549822,10,0
III,-,3546401,0.0,6.77626e-21,67,67,0,0,0,gene,C54C6.7,0,3546399,0.168184,3060,3549461,2,3546399,2,0
III,-,3541610,0.0,0.0,279,279,0,0,2,gene,C54C6.2,1,3541577,1.33632,3955,3545565,33,3541592,18,-15
III,-,3537565,0.75,0.25,4,1,3,2,1,gene,C54C6.6,2,3537453,0.505438,61,3537626,112,3537453,112,0
III,-,3537478,0.722488,3.02032e-11,209,58,151,106,7,gene,C54C6.6,2,3537453,0.505438,148,3537626,25,3537453,25,0
III,-,3529776,0.016129,1.34441e-17,62,61,1,1,6,gene,M01F1.7,0,3529767,0.528086,4869,3534645,9,3529711,65,56
III,-,3516746,0.0,2.01948e-28,92,92,0,0,0,gene,M01F1.5,0,3516601,0.599578,4371,3521117,145,3516746,0,-145
III,-,3509827,0.00552486,0.0,181,180,1,1,1,gene,M01F1.4,1,3509827,0.670735,1114,3510941,0,3509827,0,0
III,-,3505085,0.0,6.10352e-05,14,14,0,0,12,gene,M01F1.3,2,3505020,29.0839,544,3505629,65,3505085,0,-65
III,-,3505079,0.0,0.0625,4,4,0,0,17,gene,M01F1.3,2,3505020,29.0839,550,3505629,59,3505021,58,-1
III,-,3505021,0.362725,1.97799e-10,499,318,181,100,26,gene,M01F1.3,2,3505020,29.0839,608,3505629,1,3505021,0,-1
III,-,3503600,0.533333,0.196381,15,7,8,3,2,gene,M01F1.2,3,3503580,83.4684,94,3503694,20,3503594,6,-14
III,-,3503588,0.119457,0.0,23205,20433,2772,1545,41,gene,M01F1.2,3,3503580,83.4684,106,3503694,8,3503588,0,-8
III,-,3502529,0.8125,1.72639e-10,96,18,78,54,1,gene,M01F1.8,4,3502520,0.429772,252,3502781,9,3502520,9,0
III,-,3499041,0.871658,0.0,561,72,489,390,2,gene,M01F1.9,5,3499040,0.775624,312,3499353,1,3499041,0,-1
III,-,3493216,0.0,6.10352e-05,14,14,0,0,1,gene,M01F1.1,0,3493208,0.0290512,446,3493662,8,3493216,0,-8
III,-,3475490,0.0,1.14794e-41,136,136,0,0,8,gene,C34C12.9,0,3475434,0.148546,9355,3484845,56,3475434,56,0
III,-,3469731,0.00840336,0.0,476,472,4,4,250,gene,C34C12.4,0,3469728,2.75158,3972,3473703,3,3469731,0,-3
III,-,3431469,0.00217391,0.0,460,459,1,1,1,gene,K01A11.1,0,3431434,0.360447,7529,3438998,35,3431338,131,96
III,-,3404262,0.00447427,0.0,2235,2225,10,8,32,gene,F59A2.1,0,3404249,4.44425,23794,3428056,13,3404262,0,-13
III,-,3393773,0.00256739,0.0,4674,4662,12,11,7,gene,C56G7.1,0,3393767,7.67873,6855,3400628,6,3393773,0,-6
III,-,3384176,0.0,0.03125,5,5,0,0,2,gene,F45H7.6,0,3384175,0.0876439,2883,3387059,1,3384176,0,-1
III,-,3370198,0.0,0.0625,4,4,0,0,0,gene,F45H7.4,0,3369971,0.453341,7210,3377408,227,3370198,0,-227
III,-,3366797,0.0,6.16298e-33,107,107,0,0,0,gene,F45H7.4,0,3366729,0.453341,10611,3377408,68,3366797,0,-68
III,-,3321234,0.0021925,0.0,4561,4551,10,9,4,gene,Y53G8AR.9,0,3321234,0.82615,42423,3363657,0,3321234,0,0
III,-,3294319,0.0114068,0.0,263,260,3,1,4,gene,Y53G8AR.8,0,3294318,0.334762,23444,3317763,1,3294319,0,-1
III,-,3278699,0.0,1.17549e-38,126,126,0,0,0,gene,Y53G8AM.8,0,3278693,0.431836,844,3279543,6,3278687,12,6
III,-,3258385,0.0,0.00195312,9,9,0,0,0,gene,Y53G8AM.5,0,3258384,0.0253319,802,3259187,1,3258384,1,0
III,-,3249833,0.0,1.69407e-21,69,69,0,0,1,gene,Y53G8AL.4,0,3249699,None,1615,3251448,134,3249833,0,-134
III,-,3249541,0.0,5.82077e-11,34,34,0,0,0,gene,Y53G8AL.4,0,3249500,None,1907,3251448,41,3249541,0,-41
III,-,3248564,0.0123762,0.0,404,399,5,4,0,gene,Y53G8AL.2,0,3248562,3.16519,769,3249333,2,3248564,0,-2
III,-,3219139,0.0,2.11758e-22,72,72,0,0,0,gene,H09G03.2,0,3219132,0.330071,22566,3241705,7,3219139,0,-7
III,-,3208885,0.0,5.82077e-11,34,34,0,0,0,gene,H09G03.2,0,3208878,0.330071,32820,3241705,7,3208885,0,-7
III,-,3199505,0.00266934,0.0,2997,2989,8,6,2,gene,R148.6,0,3199504,7.88578,1284,3200789,1,3199505,0,-1
III,-,3143747,0.00150376,0.0,665,664,1,0,7,gene,C44B11.4,0,3143725,1.01334,51802,3195549,22,3143749,-2,-24
III,-,3127107,0.0,0.0,260,260,0,0,0,gene,Y53G8B.4,0,3127086,1.02929,4457,3131564,21,3127086,21,0
III,-,3116996,0.0108696,1.85793e-26,92,91,1,0,2,gene,Y53G8B.4,0,3116995,1.02929,14568,3131564,1,3116996,0,-1
III,-,3110657,0.0,0.5,1,1,0,0,1,gene,Y53G8B.3,0,3110592,0.0140453,1762,3112419,65,3110741,-84,-149
III,-,3110174,0.0,0.5,1,1,0,0,0,gene,Y53G8B.3,0,3110058,0.0140453,2245,3112419,116,3110174,0,-116
III,-,3103945,0.00346021,0.0,289,288,1,1,1,gene,Y53G8B.2,0,3103928,0.456346,1711,3105656,17,3103945,0,-17
III,-,3064331,0.0,0.0,344,344,0,0,2,gene,H06I04.6,0,3064312,0.487798,36893,3101224,19,3064318,13,-6
III,-,3059931,0.0,1.61559e-27,89,89,0,0,5,gene,H06I04.7,0,3059927,0.0757384,604,3060535,4,3059910,21,17
III,-,3047124,0.0,2.38419e-07,22,22,0,0,0,gene,Y55D5A.6,0,3047115,0.0786727,12464,3059588,9,3047004,120,111
III,-,3028790,0.00358423,0.0,558,556,2,2,7,gene,Y55D5A.5,0,3028706,0.846536,13791,3042581,84,3028790,0,-84
III,-,2990047,0.0,1.29247e-26,86,86,0,0,0,gene,Y55D5A.4,0,2990046,0.192493,5705,2995752,1,2990046,1,0
III,-,2975777,0.0,6.31089e-30,97,97,0,0,1,gene,Y55D5A.3,0,2975775,0.12551,12294,2988071,2,2975775,2,0
III,-,2965624,0.00258398,0.0,774,772,2,2,0,gene,H05C05.2,0,2965618,1.08648,1412,2967036,6,2965624,0,-6
III,-,2964451,0.0,0.0078125,7,7,0,0,2,gene,H05C05.2,0,2964396,1.08648,2585,2967036,55,2964451,0,-55
III,-,2945084,0.0,1.16415e-10,33,33,0,0,0,gene,H05C05.4,0,2945027,None,17107,2962191,57,2945054,30,-27
III,-,2943980,1.0,0.25,2,0,2,1,4,gene,R10F2.6,0,2943793,0.0994404,712,2944692,187,2944034,-54,-241
III,-,2924752,0.0,1.90735e-06,19,19,0,0,0,gene,R10F2.5,0,2924748,0.0441868,12283,2937035,4,2924748,4,0
III,-,2855411,0.111111,0.0175781,9,8,1,1,14,gene,F56F11.5,0,2855409,0.0599745,43950,2899361,2,2855409,2,0
III,-,2814959,0.00740741,0.0,1080,1072,8,8,0,gene,Y71H2AM.23,0,2814926,4.2449,24144,2839103,33,2814959,0,-33
III,-,2794800,0.0,0.000976562,10,10,0,0,0,gene,Y71H2AM.22,0,2794732,0.00896126,4162,2798962,68,2794732,68,0
III,-,2785938,0.0138122,0.0,362,357,5,5,17,gene,Y71H2AM.20,0,2785934,1.11342,7375,2793313,4,2785938,0,-4
III,-,2779043,0.0109489,0.0,822,813,9,8,2,gene,Y71H2AM.19,0,2779008,1.64514,3688,2782731,35,2779043,0,-35
III,-,2768663,0.00911458,0.0,768,761,7,6,9,gene,Y71H2AM.17,0,2768655,0.951281,706,2769369,8,2768655,8,0
III,-,2746012,0.0,0.000488281,11,11,0,0,2,gene,Y71H2AM.14,0,2745927,0.0600646,1102,2747114,85,2746012,0,-85
III,-,2739521,0.00393701,0.0,254,253,1,1,4,gene,Y71H2AM.13,0,2739520,0.866517,4304,2743825,1,2739521,0,-1
III,-,2725082,0.00787402,0.0,254,252,2,2,2,gene,Y71H2AM.11,0,2725054,1.03048,6249,2731331,28,2725082,0,-28
III,-,2698807,0.00431034,0.0,232,231,1,0,3,gene,Y71H2AM.9,0,2698800,0.429834,8913,2707720,7,2698807,0,-7
III,-,2686451,0.00409836,0.0,1464,1458,6,4,7,gene,Y71H2AL.1,0,2686450,1.50008,3661,2690112,1,2686450,1,0
III,-,2597023,0.0211864,0.0,236,231,5,5,2,gene,Y71H2B.10,0,2597011,1.80018,3350,2600373,12,2597011,12,0
III,-,2575705,0.0,0.0,391,391,0,0,76,gene,Y54F10AR.1,1,2575674,0.789697,8255,2583960,31,2575229,476,445
III,-,2575245,0.0,0.5,1,1,0,0,2,gene,Y54F10AR.1,1,2575229,0.789697,8715,2583960,16,2575229,16,0
III,-,2571536,0.932076,0.0,265,18,247,143,4,gene,Y54F10AR.2,2,2571536,0.615475,521,2572057,0,2571536,0,0
III,-,2563972,0.0,0.0,216,216,0,0,0,gene,Y54F10AM.11,0,2563947,0.227209,3421,2567393,25,2563978,-6,-31
III,-,2528677,0.0425532,7.68097e-12,47,45,2,2,9,gene,Y54F10AM.10,0,2528667,0.514699,34233,2562910,10,2528616,61,51
III,-,2507960,0.00976139,0.0,922,913,9,8,69,gene,Y54F10AM.8,0,2507958,3.33745,3672,2511632,2,2507960,0,-2
III,-,2454793,0.0,5.16988e-26,84,84,0,0,1,gene,E02H9.8,0,2454772,0.150719,12477,2467270,21,2454793,0,-21
III,-,2418191,0.0,2.52435e-29,95,95,0,0,0,gene,W04B5.5,1,2418179,0.38553,16395,2434586,12,2418193,-2,-14
III,-,2410963,0.884021,0.0,776,90,686,383,32,gene,W04B5.4,2,2410951,0.948512,107,2411070,12,2410963,0,-12
III,-,2401203,0.00389105,0.0,257,256,1,1,47,gene,H14E04.5,0,2401196,0.452409,5097,2406300,7,2401296,-93,-100
III,-,2386569,0.00719424,1.99455e-40,139,138,1,0,0,gene,H14E04.3,0,2386567,0.142273,7741,2394310,2,2386567,2,0
III,-,2331118,0.0,0.25,2,2,0,0,0,gene,Y54F10BM.13,0,2331024,0.146801,35700,2366818,94,2331171,-53,-147
III,-,2329968,0.0,8.67362e-19,60,60,0,0,1,gene,Y54F10BM.12,0,2329952,0.135827,36850,2366818,16,2329968,0,-16
III,-,2308047,0.0,0.5,1,1,0,0,16,gene,Y54F10BM.10,0,2307995,0.0186403,1862,2309909,52,2308073,-26,-78
III,-,2307988,0.0,0.000976562,10,10,0,0,5,gene,Y54F10BM.10,0,2307870,0.0186403,1921,2309909,118,2308073,-85,-203
III,-,2272174,0.0,0.000976562,10,10,0,0,0,gene,Y54F10BM.7,0,2272160,0.0164751,23157,2295331,14,2272162,12,-2
III,-,2272162,0.0,1.52588e-05,16,16,0,0,24,gene,Y54F10BM.7,0,2272160,0.0164751,23169,2295331,2,2272162,0,-2
III,-,2261430,0.0,0.015625,6,6,0,0,6,gene,Y54F10BL.1,0,2261417,0.0366901,3143,2264573,13,2261417,13,0
III,-,2251466,0.0,0.00012207,13,13,0,0,17,gene,T20H9.1,0,2251436,0.0278843,6073,2257539,30,2251436,30,0
III,-,2116885,0.0344828,5.40167e-08,29,28,1,1,1,gene,Y48G9A.11,0,2116871,0.118022,100218,2217103,14,2116885,0,-14
III,-,2076581,0.0333333,2.79397e-08,30,29,1,0,0,gene,Y39A3A.4,0,2076539,0.0272371,35823,2112404,42,2076508,73,31
III,-,2068260,0.0,0.25,2,2,0,0,1,gene,Y39A3A.3,0,2068208,0.0108393,4734,2072994,52,2068401,-141,-193
III,-,2021577,0.0,2.84217e-14,45,45,0,0,0,gene,Y39A3B.5,0,2021567,0.155658,13290,2034867,10,2021577,0,-10
III,-,2016020,0.0,0.5,1,1,0,0,0,gene,Y39A3B.5,0,2016007,0.155658,18847,2034867,13,2016020,0,-13
III,-,1982646,0.0,0.5,1,1,0,0,0,gene,Y39A3B.4,0,1982635,0.00194611,1085,1983731,11,1982635,11,0
III,-,1961933,0.00198719,0.0,4529,4520,9,9,0,gene,R155.1,0,1961905,2.79499,1610,1963543,28,1961933,0,-28
III,-,1960116,0.0,0.0625,4,4,0,0,0,gene,R155.1,0,1960025,2.79499,3427,1963543,91,1960116,0,-91
III,-,1957848,0.0,0.5,1,1,0,0,4,gene,R155.1,0,1957832,2.79499,5695,1963543,16,1957848,0,-16
III,-,1950257,0.0114943,0.0,174,172,2,2,1,gene,F53A3.2,0,1950246,0.426721,1708,1951965,11,1950246,11,0
III,-,1905629,0.0,0.0,370,370,0,0,1,gene,B0524.6,0,1905624,0.664985,33906,1939535,5,1905629,0,-5
III,-,1818312,0.00806452,0.0,248,246,2,0,2,gene,Y39A3CL.5,0,1818308,0.699541,2826,1821138,4,1818312,0,-4
III,-,1770111,0.0,0.000976562,10,10,0,0,2,gene,Y46E12A.4,0,1770080,0.200594,2390,1772501,31,1770080,31,0
III,-,1733090,0.0169492,1.02349e-16,59,58,1,0,0,gene,Y22D7AR.13,0,1733090,0.137979,19049,1752139,0,1733090,0,0
III,-,1705591,0.0,0.0625,4,4,0,0,0,gene,Y22D7AR.11,0,1705542,0.0795436,10891,1716482,49,1705475,116,67
III,-,1676474,0.0,2.46519e-32,105,105,0,0,0,gene,Y22D7AR.6,0,1676469,0.195971,6745,1683219,5,1676474,0,-5
III,-,1668621,0.0,1.81899e-12,39,39,0,0,0,gene,Y22D7AR.5,0,1668614,0.0752417,4120,1672741,7,1668608,13,6
III,-,1659850,0.00197628,0.0,1012,1010,2,1,0,gene,Y22D7AL.15,0,1659841,1.52659,2242,1662092,9,1659852,-2,-11
III,-,1644556,0.0,0.5,1,1,0,0,1,gene,Y22D7AL.12,0,1644552,0,4054,1648610,4,1644552,4,0
III,-,1618918,0.00253807,0.0,9062,9039,23,19,120,gene,Y22D7AL.10,0,1618911,7.33154,11853,1630771,7,1618918,0,-7
III,-,1614022,0.0,1.65436e-24,79,79,0,0,1,gene,Y22D7AL.9,0,1614015,0.116271,3116,1617138,7,1614022,0,-7
III,-,1589434,0.0,0.03125,5,5,0,0,1,gene,Y22D7AL.8,0,1589392,0.411808,9818,1599252,42,1589392,42,0
III,-,1558547,0.0,0.25,2,2,0,0,2,gene,Y67D2.7,1,1558512,0.763259,24598,1583145,35,1558519,28,-7
III,-,1558519,0.0104712,0.0,382,378,4,2,3,gene,Y67D2.7,1,1558512,0.763259,24626,1583145,7,1558519,0,-7
III,-,1554437,0.817568,8.12858e-16,148,27,121,89,0,gene,Y67D2.6,2,1554431,0.276361,922,1555359,6,1554431,6,0
III,-,1540192,0.00245098,0.0,408,407,1,1,11,gene,Y67D2.5,0,1540189,0.371144,4749,1544941,3,1540189,3,0
III,-,1532817,0.0,0.0,166,166,0,0,1,gene,M01G5.5,1,1532758,0.446878,5647,1538464,59,1532758,59,0
III,-,1517983,0.564171,6.10399e-05,748,326,422,287,0,gene,M01G5.3,2,1517983,0.8904030000000001,1945,1519928,0,1517983,0,0
III,-,1495965,0.0,0.0,178,178,0,0,32,gene,M01G5.6,1,1495915,0.729372,13286,1509251,50,1496017,-52,-102
III,-,1495320,0.963542,0.0,192,7,185,141,4,gene,Y82E9BR.19,2,1495320,0.238434,109,1495429,0,1495320,0,0
III,-,1483497,0.835294,5.90098e-20,170,28,142,103,7,gene,Y82E9BR.18,3,1483467,0.349392,115,1483612,30,1483497,0,-30
III,-,1483485,0.852941,1.61966e-05,34,5,29,15,369,gene,Y82E9BR.18,3,1483467,0.349392,127,1483612,18,1483497,-12,-30
III,-,1455758,0.00384615,0.0,260,259,1,0,0,gene,Y82E9BR.17,0,1455747,0.570508,12108,1467866,11,1455746,12,1
III,-,1454572,0.0,0.03125,5,5,0,0,0,gene,Y82E9BR.17,0,1454526,0.570508,13294,1467866,46,1454572,0,-46
III,-,1452038,0.0,0.5,1,1,0,0,0,gene,Y82E9BR.17,0,1452027,0.570508,15828,1467866,11,1452038,0,-11
III,-,1450919,0.0,4.65661e-10,31,31,0,0,0,gene,Y82E9BR.17,0,1450768,0.570508,16947,1467866,151,1450919,0,-151
III,-,1427216,0.00120192,0.0,832,831,1,1,1,gene,Y82E9BR.16,0,1427205,6.7166,20270,1447486,11,1427216,0,-11
III,-,1417178,0.00033557,0.0,2980,2979,1,1,0,gene,Y82E9BR.15,1,1417177,3.90834,2484,1419662,1,1417177,1,0
III,-,1414106,0.517066,0.00964338,1377,665,712,472,3,gene,Y82E9BR.14,2,1414106,1.9774,13,1414119,0,1414106,0,0
III,-,1409229,0.948129,0.0,1176,61,1115,624,1,gene,Y82E9BR.22,3,1409228,2.85845,68,1409297,1,1409228,1,0
III,-,1391840,0.0,4.70198e-38,124,124,0,0,1,gene,Y82E9BR.13,0,1391824,0.243843,14607,1406447,16,1391842,-2,-18
III,-,1388312,0.0,0.0625,4,4,0,0,3,gene,Y82E9BR.25,0,1388298,None,2127,1390439,14,1388487,-175,-189
III,-,1383400,0.0,0.00390625,8,8,0,0,1,gene,Y82E9BR.12,0,1383386,0.0119451,3816,1387216,14,1383695,-295,-309
III,-,1345669,0.0,0.25,2,2,0,0,1,gene,Y82E9BL.6,0,1345592,0.0119233,626,1346295,77,1345784,-115,-192
III,-,1342505,0.0,0.000488281,11,11,0,0,8,gene,Y82E9BL.7,0,1342484,0.0567225,2189,1344694,21,1342484,21,0
III,-,1308277,0.0263158,3.77194e-20,76,74,2,1,4,gene,Y82E9BL.13,0,1308266,0.163566,2933,1311210,11,1308284,-7,-18
III,-,1308206,0.0,0.5,1,1,0,0,2,gene,Y82E9BL.13,0,1308203,0.163566,3004,1311210,3,1308284,-78,-81
III,-,1293219,0.0,0.000244141,12,12,0,0,0,gene,Y119D3A.4,0,1293205,0.0118182,12534,1305753,14,1293205,14,0
III,-,1288525,0.0,0.0078125,7,7,0,0,1,gene,ZC47.13,0,1288513,0.0171697,3514,1292039,12,1288513,12,0
III,-,1284148,0.0,2.38419e-07,22,22,0,0,2,gene,ZC47.10,0,1284134,None,1234,1285382,14,1284134,14,0
III,-,1275592,0.1,0.00976562,10,9,1,0,0,gene,ZC47.4,0,1275578,0.0260767,1502,1277094,14,1275578,14,0
III,-,1273680,0.0,1.52588e-05,16,16,0,0,13,gene,ZC47.3,0,1273666,0.105827,822,1274502,14,1273666,14,0
III,-,1271418,0.0,2.84217e-14,45,45,0,0,7,gene,ZC47.5,0,1271375,0.157116,819,1272237,43,1271418,0,-43
III,-,1271412,0.0,0.03125,5,5,0,0,9,gene,ZC47.5,0,1271375,0.157116,825,1272237,37,1271418,-6,-43
III,-,1269246,0.0,0.00195312,9,9,0,0,0,gene,ZC47.6,0,1269234,0.0600432,299,1269545,12,1269522,-276,-288
III,-,1258413,0.0,2.98023e-08,25,25,0,0,0,gene,Y119D3B.19,0,1258404,0,3748,1262161,9,1258404,9,0
III,-,1254377,0.0,4.54747e-13,41,41,0,0,0,gene,Y119D3B.18,0,1254373,0,2811,1257188,4,1254391,-14,-18
III,-,1249144,0.00854701,7.04168e-34,117,116,1,1,4,gene,Y119D3B.22,0,1249143,0.11838,4527,1253671,1,1249143,1,0
III,-,1222062,0.00182983,0.0,1093,1091,2,1,1,gene,Y119D3B.17,0,1222062,0.779752,25546,1247608,0,1222062,0,0
III,-,1201998,0.00970874,0.0,515,510,5,5,1,gene,Y119D3B.16,1,1201989,0.587319,13970,1215968,9,1201998,0,-9
III,-,1196282,0.938909,0.0,2750,168,2582,1870,8,gene,Y119D3B.15,2,1196266,5.40714,939,1197221,16,1196282,0,-16
III,-,1196271,0.878788,1.20512e-43,297,36,261,158,3900,gene,Y119D3B.15,2,1196266,5.40714,950,1197221,5,1196282,-11,-16
III,-,1193802,0.862069,1.1462e-12,87,12,75,61,0,gene,Y119D3B.14,3,1193780,0.247955,542,1194344,22,1193802,0,-22
III,-,1136013,0.0,1.49012e-08,26,26,0,0,5,gene,Y71D11A.5,0,1135963,0.0983567,39081,1175094,50,1136013,0,-50
III,-,1080469,0.00355366,0.0,1407,1402,5,2,13,gene,Y92C3B.3,1,1080469,1.21914,31794,1112263,0,1080469,0,0
III,-,1076543,0.427746,7.14733e-08,1211,693,518,354,2,gene,Y92C3B.2,2,1076543,2.98137,1583,1078126,0,1076543,0,0
III,-,1067940,0.0,0.5,1,1,0,0,24,gene,Y92C3B.2,2,1067780,2.98137,10186,1078126,160,1067940,0,-160
III,-,1037200,0.0,0.0,216,216,0,0,0,gene,BE0003N10.2,0,1037198,0.487874,9048,1046248,2,1037200,0,-2
III,-,1031185,1.0,0.25,2,0,2,1,0,gene,E_BE45912.2,0,1031143,0.144048,125,1031310,42,1031143,42,0
III,-,1031076,0.808511,9.6822e-06,47,9,38,32,12,gene,E_BE45912.2,0,1031014,0.144048,234,1031310,62,1031143,-67,-129
III,-,1024548,0.0,0.5,1,1,0,0,2,gene,Y34F4.4,0,1024531,0.104648,709,1025257,17,1024548,0,-17
III,-,1024461,0.0,0.0625,4,4,0,0,9,gene,Y34F4.4,0,1024443,0.104648,796,1025257,18,1024548,-87,-105
III,-,979528,0.0,0.25,2,2,0,0,0,gene,R06B10.2,0,979497,0.0332669,21752,1001280,31,979528,0,-31
III,-,961303,0.0,1.90735e-06,19,19,0,0,1,gene,T12B5.12,0,961292,None,3568,964871,11,961334,-31,-42
III,-,950521,0.0,3.8147e-06,18,18,0,0,63,gene,T12B5.11,0,950485,0.237246,3754,954275,36,950598,-77,-113
III,-,946285,0.0,0.25,2,2,0,0,1,gene,T12B5.10,0,946265,0.522874,1503,947788,20,946265,20,0
III,-,946277,0.0,0.0,171,171,0,0,71,gene,T12B5.10,0,946265,0.522874,1511,947788,12,946265,12,0
III,-,946249,0.0,2.98023e-08,25,25,0,0,173,gene,T12B5.10,0,946091,0.522874,1539,947788,158,946265,-16,-174
III,-,946237,0.0,4.65661e-10,31,31,0,0,75,gene,T12B5.10,0,946091,0.522874,1551,947788,146,946265,-28,-174
III,-,943457,0.0,1.50463e-36,119,119,0,0,4,gene,T12B5.8,0,943445,0.308096,1307,944764,12,943445,12,0
III,-,938066,0.0,0.125,3,3,0,0,0,gene,T12B5.7,0,938048,0.000414474,1923,939989,18,938048,18,0
III,-,936074,0.0,0.125,3,3,0,0,0,gene,T12B5.6,0,936054,0.19242,1406,937480,20,936054,20,0
III,-,936066,0.0,1.0842e-19,63,63,0,0,26,gene,T12B5.6,0,936054,0.19242,1414,937480,12,936054,12,0
III,-,926301,0.0,1.0842e-19,63,63,0,0,0,gene,F23H11.8,0,926234,0.178219,7111,933412,67,926301,0,-67
III,-,925562,0.0,0.0625,4,4,0,0,3,gene,F23H11.8,0,925345,0.178219,7850,933412,217,925562,0,-217
III,-,925131,0.0,0.015625,6,6,0,0,1,gene,F23H11.8,0,925103,0.178219,8281,933412,28,925131,0,-28
III,-,924042,0.0,0.25,2,2,0,0,0,gene,F23H11.8,0,924038,0.178219,9370,933412,4,924042,0,-4
III,-,919553,1.0,0.5,1,0,1,0,3,gene,F23H11.7,0,919518,0.149896,52,919605,35,919401,152,117
III,-,910569,0.00306923,0.0,17594,17540,54,50,1,gene,F23H11.5,1,910568,31.4964,2620,913189,1,910569,0,-1
III,-,909889,0.931903,0.0,1072,73,999,686,22,gene,F23H11.9,2,909876,1.73028,73,909962,13,909889,0,-13
III,-,909831,0.5,0.5,2,1,1,1,252,gene,F23H11.9,2,909782,1.73028,131,909962,49,909831,0,-49
III,-,909762,1.0,0.5,1,0,1,1,292,gene,F23H11.9,2,909682,1.73028,200,909962,80,909831,-69,-149
III,-,907526,0.545045,0.0217897,222,101,121,88,3,gene,F23H11.4,3,907516,0.580248,782,908308,10,907526,0,-10
III,-,901399,0.100033,0.0,2999,2699,300,242,66,gene,F23H11.3,4,901386,2.73958,845,902244,13,901399,0,-13
III,-,901393,0.0740741,2.61515e-06,27,25,2,2,539,gene,F23H11.3,4,901386,2.73958,851,902244,7,901399,-6,-13
III,-,886776,0.0,0.0,327,327,0,0,0,gene,T24C4.6,0,886753,2.04275,3043,889819,23,886776,0,-23
III,-,879563,0.0,3.9443e-31,101,101,0,0,1,gene,T24C4.5,0,879561,0.190626,1847,881410,2,879561,2,0
III,-,872377,0.0,0.015625,6,6,0,0,6,gene,T24C4.3,0,872372,0.0346715,232,872609,5,872372,5,0
III,-,869855,0.0235294,9.22823e-23,85,83,2,2,0,gene,T24C4.2,0,869848,0.792234,1854,871709,7,869848,7,0
III,-,869814,0.0,0.125,3,3,0,0,78,gene,T24C4.2,0,869769,0.792234,1895,871709,45,869848,-34,-79
III,-,853897,0.0117493,0.0,766,757,9,9,5,gene,K02F3.11,1,853896,3.16921,12873,866770,1,853897,0,-1
III,-,852384,0.75969,0.0,1677,403,1274,786,0,gene,K02F3.10,2,852384,3.49093,405,852789,0,852384,0,0
III,-,841404,0.0,0.25,2,2,0,0,0,gene,K02F3.9,0,841382,1.61628,9906,851310,22,841357,47,25
III,-,841260,0.0,0.0625,4,4,0,0,67,gene,K02F3.9,0,841244,1.61628,10050,851310,16,841357,-97,-113
III,-,783298,0.0130719,1.01874e-42,153,151,2,1,9,gene,F42G9.6,1,783295,0.836662,2770,786068,3,783298,0,-3
III,-,778149,0.0,1.61559e-27,89,89,0,0,8,gene,F42G9.5,2,778129,0.596414,79,778228,20,778149,0,-20
III,-,777000,0.419355,0.0248059,93,54,39,21,19,gene,F42G9.5,2,776994,0.596414,1228,778228,6,777000,0,-6
III,-,758072,0.0,0.0,1217,1217,0,0,3,gene,T17H7.7,0,758069,0.768482,16240,774312,3,758069,3,0
III,-,752420,0.047619,1.00136e-05,21,20,1,1,1,gene,T17H7.4,0,752394,2.03491,2838,755258,26,752420,0,-26
III,-,746685,0.0,0.0,512,512,0,0,1,gene,T17H7.4,0,746532,2.03491,8573,755258,153,746685,0,-153
III,-,743337,0.0,5.55112e-17,54,54,0,0,0,gene,T17H7.4,0,743308,2.03491,11921,755258,29,743337,0,-29
III,-,743311,0.0,2.98023e-08,25,25,0,0,73,gene,T17H7.4,0,743308,2.03491,11947,755258,3,743311,0,-3
III,-,743176,0.0,0.25,2,2,0,0,0,gene,T17H7.4,0,743139,2.03491,12082,755258,37,743176,0,-37
III,-,731920,0.0,0.25,2,2,0,0,1,gene,T17H7.4,0,731919,2.03491,3,731923,1,731920,0,-1
III,-,730431,0.0,0.5,1,1,0,0,6,gene,T17H7.4,0,730364,2.03491,1492,731923,67,730431,0,-67
III,-,683324,0.0,1.19209e-07,23,23,0,0,5,gene,W02B3.4,0,683323,0.06196,2905,686229,1,683323,1,0
III,-,640223,0.0,0.0,309,309,0,0,1,gene,W06E11.5,1,640207,0.611917,22502,662725,16,640210,13,-3
III,-,638416,0.920415,0.0,289,23,266,170,2,gene,W06E11.4,2,638406,0.966891,108,638524,10,638416,0,-10
III,-,636105,0.5,0.5,2,1,1,1,0,gene,T19C3.7,0,636007,0.00925795,371,636476,98,636164,-59,-157
III,-,634623,0.003861,0.0,259,258,1,1,0,gene,T19C3.8,0,634569,0.827066,265,634888,54,634623,0,-54
III,-,631512,0.0,0.015625,6,6,0,0,1,gene,T19C3.6,0,631449,0.0159838,504,632016,63,631022,490,427
III,-,620251,0.00174825,0.0,572,571,1,0,2,gene,T19C3.4,0,620209,1.81617,4351,624602,42,620209,42,0
III,-,617446,0.0,0.5,1,1,0,0,203,gene,T19C3.2,0,617404,1.45287,793,618239,42,617444,2,-40
III,-,614544,0.000818331,0.0,1222,1221,1,0,2,gene,T19C3.3,0,614523,1.65688,875,615419,21,614546,-2,-23
III,-,600363,0.00307285,0.0,21153,21088,65,54,39,gene,Y55B1AR.1,2,600355,20.1151,2340,602703,8,600355,8,0
III,-,600192,0.0,0.000976562,10,10,0,0,3152,gene,Y55B1AR.1,2,600159,20.1151,2511,602703,33,600355,-163,-196
III,-,598114,0.0,0.0,525,525,0,0,6,gene,Y55B1AR.2,3,598102,0.719468,1390,599504,12,598114,0,-12
III,-,587102,0.963235,4.13183e-33,136,5,131,95,1,gene,Y55B1AL.3,4,587094,0.253136,108,587210,8,587102,0,-8
III,-,577564,0.911042,0.0,2563,228,2335,1637,0,gene,Y55B1AL.2,5,577558,3.94465,112,577676,6,577564,0,-6
III,-,526922,0.0125786,1.68156e-44,159,157,2,0,1,gene,T22F7.4,0,526913,0.430668,50028,576950,9,526913,9,0
III,-,524011,0.0,7.62939e-06,17,17,0,0,0,gene,T22F7.3,0,523977,0.0604194,1086,525097,34,524018,-7,-41
III,-,471701,0.0,0.0,272,272,0,0,0,gene,Y55B1BR.4,0,471694,0.235811,14404,486105,7,471694,7,0
III,-,459689,0.142857,0.0546875,7,6,1,1,3,gene,Y55B1BR.5,0,459632,0.58746,5019,464708,57,459634,55,-2
III,-,455140,0.0,0.0625,4,4,0,0,1,gene,Y55B1BR.5,0,455135,0.58746,9568,464708,5,455140,0,-5
III,-,418737,0.0104712,0.0,191,189,2,2,0,gene,Y55B1BM.1,0,418727,0.764409,34835,453572,10,418737,0,-10
III,-,399429,0.0,0.125,3,3,0,0,0,gene,K10F12.6,0,399391,0.0116382,8697,408126,38,399391,38,0
III,-,381376,0.0,0.5,1,1,0,0,2,gene,K10F12.4,0,381341,0.44433,804,382180,35,381297,79,44
III,-,381297,0.000924214,0.0,1082,1081,1,1,2,gene,K10F12.4,0,381297,0.44433,883,382180,0,381297,0,0
III,-,348426,0.00737463,0.0,678,673,5,5,0,gene,W07B3.2,1,348399,6.44547,886,349312,27,348426,0,-27
III,-,343240,0.5,0.0452803,310,155,155,93,2,gene,Y50D7A.8,2,343226,0.75518,1065,344305,14,343240,0,-14
III,-,298555,0.0,0.0,1723,1723,0,0,35,gene,Y50D7A.7,0,298530,2.70684,35045,333600,25,298555,0,-25
III,-,207120,0.0243902,1.86446e-11,41,40,1,1,0,gene,W10C4.1,0,207118,0.123794,63326,270446,2,207091,29,27
III,-,188130,0.00473934,0.0,844,840,4,3,0,gene,F40G9.11,0,188123,1.27505,13054,201184,7,188130,0,-7
III,-,145719,0.666667,0.164062,9,3,6,4,20,gene,T17A3.12,0,145667,0.122902,1249,146968,52,145298,421,369
III,-,107966,0.0,0.0625,4,4,0,0,0,gene,C29F9.10,0,107920,0.0438725,1353,109319,46,107452,514,468
III,-,107940,0.0,0.5,1,1,0,0,4,gene,C29F9.10,0,107920,0.0438725,1379,109319,20,107452,488,468
III,-,107932,0.0,9.53674e-07,20,20,0,0,1,gene,C29F9.10,0,107920,0.0438725,1387,109319,12,107452,480,468
III,-,94808,0.00263852,0.0,1137,1134,3,1,0,gene,C29F9.7,0,94802,1.13788,11241,106049,6,94808,0,-6
III,-,87268,0.0,1.19209e-07,23,23,0,0,228,gene,F54C4.4,0,87258,0.468547,2182,89450,10,87335,-67,-77
III,-,86383,0.0122699,1.4013e-45,163,161,2,1,26,gene,F54C4.3,1,86376,0.435595,291,86674,7,86383,0,-7
III,-,69749,0.901606,0.0,996,98,898,713,11,gene,F54C4.2,2,69737,2.60053,691,70440,12,69816,-67,-79
III,-,69741,0.953846,1.18395e-15,65,3,62,48,4284,gene,F54C4.2,2,69737,2.60053,699,70440,4,69816,-75,-79
III,-,66259,0.000691563,0.0,2892,2890,2,2,3,gene,W05G11.6,0,66255,5.13897,2812,69071,4,66259,0,-4
III,-,64226,0.0,0.25,2,2,0,0,0,gene,W05G11.6,0,64223,5.13897,4845,69071,3,64226,0,-3
III,-,61163,0.0,0.0078125,7,7,0,0,0,gene,W05G11.5,0,61144,0.00120968,1722,62885,19,61144,19,0
III,-,23962,0.0,1.54074e-33,109,109,0,0,0,gene,H10E21.5,0,23945,0.480505,11490,35452,17,23962,0,-17
III,-,14978,0.0,0.125,3,3,0,0,0,gene,H10E21.3,0,14922,0.27258,2346,17324,56,14801,177,121
IV,-,17483285,0.0,7.45058e-09,27,27,0,0,0,gene,4R79.2,0,17483285,0.0509636,3581,17486866,0,17483285,0,0
IV,-,17471874,0.00309215,0.0,3234,3224,10,9,4,gene,F11E6.3,0,17471868,4.26628,2318,17474192,6,17471874,0,-6
IV,-,17467362,0.00115307,0.0,3469,3465,4,2,27,gene,F11E6.5,0,17467353,4.6233,1948,17469310,9,17467362,0,-9
IV,-,17465882,0.0416667,4.00746e-12,48,46,2,1,4,gene,F11E6.6,0,17465881,0.164046,132,17466014,1,17465881,1,0
IV,-,17463112,0.0,7.45058e-09,27,27,0,0,0,gene,F11E6.10,0,17463067,0.0296518,1338,17464450,45,17463112,0,-45
IV,-,17461226,0.00135685,0.0,737,736,1,1,1,gene,F11E6.7,0,17461224,1.15145,640,17461866,2,17461233,-7,-9
IV,-,17450497,0.00660066,0.0,303,301,2,0,1,gene,F11E6.8,0,17450454,0.45756,7295,17457792,43,17450497,0,-43
IV,-,17450456,0.0,0.000488281,11,11,0,0,32,gene,F11E6.8,0,17450454,0.45756,7336,17457792,2,17450497,-41,-43
IV,-,17447395,0.0208333,1.7053e-13,48,47,1,1,2,gene,F11E6.8,0,17447383,0.45756,10397,17457792,12,17447368,27,15
IV,-,17439916,0.0,0.125,3,3,0,0,1,gene,C06A12.4,0,17439905,0.008794,994,17440910,11,17439905,11,0
IV,-,17439907,0.0,0.125,3,3,0,0,8,gene,C06A12.4,0,17439905,0.008794,1003,17440910,2,17439905,2,0
IV,-,17413301,0.0,0.000488281,11,11,0,0,13,gene,T02D1.6,0,17413294,0.127647,16156,17429457,7,17413467,-166,-173
IV,-,17405584,0.0,0.0,227,227,0,0,2,gene,T02D1.5,0,17405577,0.40378,1271,17406855,7,17405584,0,-7
IV,-,17387446,0.00374532,0.0,1068,1064,4,3,1,gene,T02D1.8,0,17387403,2.29997,14969,17402415,43,17387453,-7,-50
IV,-,17380124,0.0130719,0.0,306,302,4,3,17,gene,C30H6.9,0,17380123,0.6095,6621,17386745,1,17380124,0,-1
IV,-,17366435,0.0,1.49012e-08,26,26,0,0,0,gene,C30H6.2,0,17366411,0.117573,12890,17379325,24,17366437,-2,-26
IV,-,17338931,0.0,0.0,330,330,0,0,0,gene,C49C3.10,0,17338916,0.264538,698,17339629,15,17338938,-7,-22
IV,-,17291687,0.0113636,2.84343e-25,88,87,1,1,1,gene,T28F3.4,0,17291675,0.25448,9080,17300767,12,17291687,0,-12
IV,-,17287408,0.00267023,0.0,749,747,2,2,9,gene,T28F3.3,0,17287406,0.916982,718,17288126,2,17287406,2,0
IV,-,17284153,0.00423131,0.0,709,706,3,2,3,gene,T28F3.1,0,17284141,0.93796,1534,17285687,12,17284153,0,-12
IV,-,17273606,0.00302343,0.0,1323,1319,4,4,1,gene,F26D10.10,0,17273587,1.46746,7807,17281413,19,17273606,0,-19
IV,-,17262439,0.000974659,0.0,1026,1025,1,1,10,gene,ZK550.6,0,17262430,2.28676,1747,17264186,9,17262439,0,-9
IV,-,17231010,0.0,0.00195312,9,9,0,0,0,gene,Y116A8B.5,0,17231010,0.0234175,26448,17257458,0,17231010,0,0
IV,-,17206800,0.0,0.0,253,253,0,0,1,gene,C52D10.12,0,17206760,0.471176,19125,17225925,40,17206800,0,-40
IV,-,17191846,0.0017783,0.0,1687,1684,3,1,0,gene,C52D10.11,0,17191846,1.23291,6017,17197863,0,17191846,0,0
IV,-,17183695,0.000700158,0.0,5713,5709,4,4,164,gene,C52D10.13,0,17183684,4.75085,6464,17190159,11,17183695,0,-11
IV,-,17118507,0.00323625,0.0,1236,1232,4,4,1,gene,Y116A8C.35,1,17118498,2.8207,11501,17130008,9,17118498,9,0
IV,-,17116621,0.928571,4.06115e-36,182,13,169,109,4,gene,Y116A8C.34,2,17116612,1.6412,59,17116680,9,17116612,9,0
IV,-,17116612,0.894081,0.0,321,34,287,178,551,gene,Y116A8C.34,2,17116612,1.6412,68,17116680,0,17116612,0,0
IV,-,17110937,0.897287,0.0,516,53,463,297,9,gene,Y116A8C.32,3,17110937,1.38791,101,17111038,0,17110937,0,0
IV,-,17103670,0.873874,0.0,444,56,388,257,8,gene,Y116A8C.30,4,17103669,1.67889,109,17103779,1,17103669,1,0
IV,-,17100202,0.163636,0.0,660,552,108,70,10,gene,Y116A8C.28,5,17100197,1.13855,1,17100203,5,17100202,0,-5
IV,-,17096240,1.0,1.86265e-09,29,0,29,23,3,gene,Y116A8C.27,6,17096217,1.10424,103,17096343,23,17096242,-2,-25
IV,-,17096224,0.935185,0.0,324,21,303,202,121,gene,Y116A8C.27,6,17096217,1.10424,119,17096343,7,17096224,0,-7
IV,-,17087289,0.0,0.00195312,9,9,0,0,373,gene,Y116A8C.26,1,17087285,0.372002,3310,17090599,4,17087285,4,0
IV,-,17078713,1.0,0.5,1,0,1,0,0,gene,Y116A8C.25,2,17078701,0.0666364,991,17079704,12,17078701,12,0
IV,-,17078705,0.958333,1.43051e-06,24,1,23,7,1,gene,Y116A8C.25,2,17078701,0.0666364,999,17079704,4,17078701,4,0
IV,-,17048313,0.0126582,1.30695e-22,79,78,1,1,1,gene,Y116A8C.22,0,17048309,0.109962,9555,17057868,4,17048315,-2,-6
IV,-,17039623,0.0,0.0,284,284,0,0,1,gene,Y116A8C.19,0,17039601,0.157016,5070,17044693,22,17039609,14,-8
IV,-,17025088,0.0,3.23117e-27,88,88,0,0,2,gene,Y116A8C.17,0,17025073,0.171993,3918,17029006,15,17025085,3,-12
IV,-,16946804,0.0,1.86265e-09,29,29,0,0,55,gene,Y116A8C.9,1,16946786,0.40578,18434,16965238,18,16946812,-8,-26
IV,-,16946796,0.0,0.25,2,2,0,0,128,gene,Y116A8C.9,1,16946786,0.40578,18442,16965238,10,16946812,-16,-26
IV,-,16939086,1.0,0.25,2,0,2,2,7,gene,Y116A8C.10,2,16939058,0.491812,1101,16940187,28,16939068,18,-10
IV,-,16939068,0.915493,1.56073e-26,142,12,130,77,7,gene,Y116A8C.10,2,16939058,0.491812,1119,16940187,10,16939068,0,-10
IV,-,16938916,0.833333,6.13416e-06,42,7,35,19,3,gene,Y116A8C.10,2,16938826,0.491812,1271,16940187,90,16938916,0,-90
IV,-,16938094,1.0,0.0625,4,0,4,2,1,gene,Y116A8C.10,2,16937806,0.491812,2093,16940187,288,16938094,0,-288
IV,-,16936438,0.0,1.38778e-17,56,56,0,0,1,gene,Y116A8C.10,2,16936328,0.491812,3749,16940187,110,16936438,0,-110
IV,-,16863401,0.0037037,0.0,540,538,2,2,0,gene,T06A10.1,1,16863396,0.691954,5320,16868721,5,16863401,0,-5
IV,-,16854901,0.5,0.5,2,1,1,1,1,gene,Y116A8A.9,2,16854840,2.59506,105,16855006,61,16854901,0,-61
IV,-,16854879,0.951567,0.0,702,34,668,482,4,gene,Y116A8A.9,2,16854840,2.59506,127,16855006,39,16854879,0,-39
IV,-,16847415,0.0666667,0.000457764,15,14,1,1,2,gene,Y116A8A.10,0,16847301,None,746,16848161,114,16847415,0,-114
IV,-,16806349,0.0,0.5,1,1,0,0,5,gene,Y116A8A.3,0,16806295,0.00480253,6975,16813324,54,16806418,-69,-123
IV,-,16602734,0.0,2.1684e-19,62,62,0,0,0,gene,Y51H4A.9,0,16602734,0.211227,20549,16623283,0,16602734,0,0
IV,-,16542282,0.0,0.0,374,374,0,0,0,gene,Y51H4A.7,0,16542281,0.70183,32774,16575056,1,16542282,0,-1
IV,-,16505639,0.0,8.47033e-22,70,70,0,0,0,gene,Y51H4A.4,0,16505628,0.34276,916,16506555,11,16505641,-2,-13
IV,-,16505628,0.0,7.70372e-34,110,110,0,0,70,gene,Y51H4A.4,0,16505628,0.34276,927,16506555,0,16505641,-13,-13
IV,-,16488980,0.00248859,0.0,2411,2405,6,4,0,gene,Y51H4A.3,0,16488925,9.5878,14220,16503200,55,16488980,0,-55
IV,-,16382172,0.0,0.5,1,1,0,0,64,gene,Y7A9D.1,0,16382137,1.38651,16630,16398802,35,16382171,1,-34
IV,-,16277372,0.0,0.0,174,174,0,0,2,gene,F38C2.7,0,16277351,0.0881148,9241,16286613,21,16277372,0,-21
IV,-,16277338,0.0,0.5,1,1,0,0,20,gene,F38C2.7,0,16277298,0.0881148,9275,16286613,40,16277372,-34,-74
IV,-,16026807,0.1,0.000181198,20,18,2,1,0,gene,Y105C5B.21,0,16026807,0.654961,40458,16067265,0,16026807,0,0
IV,-,16018921,0.0,3.58732e-43,141,141,0,0,0,gene,Y105C5B.21,0,16018820,0.654961,48344,16067265,101,16018921,0,-101
IV,-,16017450,0.0,0.25,2,2,0,0,1,gene,Y105C5B.21,0,16017449,0.654961,49815,16067265,1,16017450,0,-1
IV,-,16014501,0.0,7.10543e-15,47,47,0,0,0,gene,Y105C5B.21,0,16014363,0.654961,52764,16067265,138,16014501,0,-138
IV,-,15994565,0.0106383,4.74579e-27,94,93,1,1,0,gene,Y105C5B.20,0,15994562,0.0507095,3061,15997626,3,15994403,162,159
IV,-,15983930,0.0106383,4.74579e-27,94,93,1,1,2,gene,Y105C5B.19,0,15983930,0.303464,9484,15993414,0,15983930,0,0
IV,-,15950843,0.0,0.015625,6,6,0,0,1,gene,Y105C5B.14,0,15950822,0.017998,5687,15956530,21,15950822,21,0
IV,-,15944422,0.0,1.0842e-19,63,63,0,0,1,gene,Y105C5B.12,0,15944391,0.0609223,5262,15949684,31,15944391,31,0
IV,-,15926805,0.0,0.015625,6,6,0,0,0,gene,Y105C5B.8,0,15926800,0.00510874,4978,15931783,5,15926800,5,0
IV,-,15846612,0.0,2.84217e-14,45,45,0,0,9,gene,Y105C5A.1270,0,15846612,None,13455,15860067,0,15846657,-45,-45
IV,-,15738218,0.0,0.000976562,10,10,0,0,0,gene,Y105C5A.19,0,15738208,None,107694,15845912,10,15738208,10,0
IV,-,15641755,0.00816326,0.0,245,243,2,2,0,gene,Y105C5A.12,0,15641750,0,4240,15645995,5,15641750,5,0
IV,-,15617046,0.00066313,0.0,1508,1507,1,0,0,gene,Y105C5A.8,0,15617032,0.914807,20188,15637234,14,15617032,14,0
IV,-,15554682,0.0,0.0,190,190,0,0,4,gene,Y105C5A.1,0,15554670,0.204062,58051,15612733,12,15554681,1,-11
IV,-,15539821,0.0,0.25,2,2,0,0,4,gene,Y73F8A.35,0,15539782,0.0340683,10990,15550811,39,15539900,-79,-118
IV,-,15528490,0.00519211,0.0,963,958,5,4,63,gene,Y73F8A.34,0,15528489,1.81309,4638,15533128,1,15528490,0,-1
IV,-,15525186,0.0,0.5,1,1,0,0,0,gene,Y73F8A.34,0,15525096,1.81309,7942,15533128,90,15524902,284,194
IV,-,15524797,0.0102506,0.0,878,869,9,9,3,gene,Y73F8A.34,0,15524712,1.81309,8331,15533128,85,15524797,0,-85
IV,-,15471449,0.0138122,0.0,362,357,5,5,8,gene,Y73F8A.25,1,15471443,0.764692,43067,15514516,6,15471443,6,0
IV,-,15453148,0.780303,2.34573e-11,132,29,103,86,2,gene,Y73F8A.24,2,15453148,0.472835,1950,15455098,0,15453148,0,0
IV,-,15328155,0.0,0.000488281,11,11,0,0,0,gene,Y73F8A.17,0,15328147,0.00493263,110994,15439149,8,15328147,8,0
IV,-,15234947,0.0,0.5,1,1,0,0,0,gene,Y73F8A.1,0,15234934,0.0403788,35172,15270119,13,15234934,13,0
IV,-,15220312,0.0,6.01853e-36,117,117,0,0,0,gene,Y40H7A.11,0,15220307,0.124688,7472,15227784,5,15220307,5,0
IV,-,15147176,0.0,0.0625,4,4,0,0,0,gene,Y40H7A.1,0,15147165,0.00343026,13940,15161116,11,15147165,11,0
IV,-,15133995,0.0,5.82077e-11,34,34,0,0,0,gene,M199.8,0,15133960,0.0726651,5065,15139060,35,15133960,35,0
IV,-,15028937,0.0,0.000976562,10,10,0,0,469,gene,Y41E3.8,0,15028906,1.65817,20433,15049370,31,15029097,-160,-191
IV,-,15013144,0.0,0.0,738,738,0,0,0,gene,Y41E3.4,0,15013137,1.65977,15171,15028315,7,15013144,0,-7
IV,-,14958996,0.0,2.22045e-16,52,52,0,0,4,gene,Y41E3.1,0,14958861,1.04029,26501,14985497,135,14958875,121,-14
IV,-,14958875,0.012,0.0,250,247,3,2,0,gene,Y41E3.1,0,14958861,1.04029,17,14958892,14,14958875,0,-14
IV,-,14829075,0.00917431,1.67941e-31,109,108,1,0,0,gene,Y57G11C.17,0,14829074,0.14046,26173,14855248,1,14829076,-1,-2
IV,-,14816347,0.0,1.52588e-05,16,16,0,0,0,gene,Y57G11C.46,0,14816347,0.0514082,6151,14822498,0,14816347,0,0
IV,-,14797425,0.0,2.71051e-20,65,65,0,0,1934,gene,Y57G11C.12,1,14797411,8.7477,15633,14813058,14,14797425,0,-14
IV,-,14797417,0.0,0.03125,5,5,0,0,7801,gene,Y57G11C.12,1,14797411,8.7477,15641,14813058,6,14797425,-8,-14
IV,-,14797146,0.0,0.5,1,1,0,0,2,gene,Y57G11C.12,1,14796922,8.7477,15912,14813058,224,14797146,0,-224
IV,-,14797143,0.0,0.125,3,3,0,0,8,gene,Y57G11C.12,1,14796922,8.7477,15915,14813058,221,14797143,0,-221
IV,-,14795434,0.0,0.00390625,8,8,0,0,0,gene,Y57G11C.11,2,14795244,0.81123,945,14796379,190,14795434,0,-190
IV,-,14793581,0.00373134,0.0,268,267,1,1,15,gene,Y57G11C.11,2,14793575,0.81123,2798,14796379,6,14793581,0,-6
IV,-,14792894,0.166667,0.09375,6,5,1,0,2,gene,Y57G11C.10,3,14792811,10.2668,173,14793067,83,14792846,48,-35
IV,-,14792846,0.174322,0.0,3723,3074,649,397,8,gene,Y57G11C.10,3,14792811,10.2668,221,14793067,35,14792846,0,-35
IV,-,14784180,0.0043573,0.0,459,457,2,2,29,gene,Y57G11C.45,0,14784180,0.606435,6597,14790777,0,14784180,0,0
IV,-,14774260,0.0,0.00390625,8,8,0,0,0,gene,Y57G11C.51,0,14774254,0.492602,9041,14783301,6,14774260,0,-6
IV,-,14773357,0.5,0.5,2,1,1,1,18,gene,Y57G11C.36,1,14773345,0.802325,202,14773559,12,14773481,-124,-136
IV,-,14773206,0.0,6.10352e-05,14,14,0,0,42,gene,Y57G11C.36,1,14773204,0.802325,353,14773559,2,14773206,0,-2
IV,-,14773199,0.0,0.25,2,2,0,0,47,gene,Y57G11C.36,1,14773176,0.802325,360,14773559,23,14773199,0,-23
IV,-,14773016,0.0,0.00012207,13,13,0,0,2,gene,Y57G11C.36,1,14772997,0.802325,543,14773559,19,14773016,0,-19
IV,-,14771256,1.0,0.5,1,0,1,1,5,gene,Y57G11C.44,2,14771247,0.319897,132,14771388,9,14771386,-130,-139
IV,-,14771035,0.0,0.25,2,2,0,0,0,gene,Y57G11C.44,2,14771028,0.319897,353,14771388,7,14771386,-351,-358
IV,-,14767691,0.00771208,0.0,778,772,6,6,0,gene,Y57G11C.34,1,14767686,1.00752,2922,14770613,5,14767686,5,0
IV,-,14766617,0.862745,8.54771e-28,204,28,176,103,154,gene,Y57G11C.4,2,14766617,0.603487,107,14766724,0,14766617,0,0
IV,-,14754928,0.0,3.05176e-05,15,15,0,0,0,gene,Y57G11C.499,0,14754895,None,806,14755734,33,14754895,33,0
IV,-,14653338,0.0,0.0078125,7,7,0,0,0,gene,Y57G11C.32,0,14653334,0.0319912,49831,14703169,4,14653340,-2,-6
IV,-,14554846,0.04,7.45058e-07,25,24,1,0,0,gene,Y57G11B.6,0,14554841,0.111778,15279,14570125,5,14554841,5,0
IV,-,14551929,0.0,0.000976562,10,10,0,0,0,gene,Y57G11B.1,0,14551922,0.0282196,1541,14553470,7,14551922,7,0
IV,-,14549371,1.0,0.5,1,0,1,1,0,gene,T27E7.9,0,14549351,0.00126472,403,14549774,20,14549351,20,0
IV,-,14542575,0.0,1.13687e-13,43,43,0,0,0,gene,T27E7.6,0,14542568,0.0400003,4322,14546897,7,14542568,7,0
IV,-,14531632,0.0,0.000976562,10,10,0,0,0,gene,T27E7.10,0,14531612,None,1850,14533482,20,14531612,20,0
IV,-,14505132,0.00712589,0.0,421,418,3,3,0,gene,Y57G11A.1,0,14505105,1.47894,6716,14511848,27,14505132,0,-27
IV,-,14444149,0.0,0.0,207,207,0,0,0,gene,LLC1.1,0,14444115,0.575473,42902,14487051,34,14444149,0,-34
IV,-,14430886,0.00190476,0.0,2100,2096,4,3,43,gene,F55B11.4,0,14430882,2.72676,5488,14436374,4,14430886,0,-4
IV,-,14417196,0.0,1.52588e-05,16,16,0,0,0,gene,F55B11.6,0,14417167,0.0289589,2459,14419655,29,14417167,29,0
IV,-,14412858,0.00306748,0.0,326,325,1,0,0,gene,F55B11.1,0,14412852,0.465333,3441,14416299,6,14412852,6,0
IV,-,14383662,0.0,0.0,304,304,0,0,1,gene,Y67A10A.8,0,14383647,0.18434,17416,14401078,15,14383647,15,0
IV,-,14350707,0.0,0.000488281,11,11,0,0,0,gene,Y67A10A.1,0,14350696,0.0198647,29215,14379922,11,14350717,-10,-21
IV,-,14325631,0.0169492,1.02349e-16,59,58,1,1,2,gene,Y67A10A.4,0,14325611,0.103834,3328,14328959,20,14325631,0,-20
IV,-,14250182,0.0,3.05176e-05,15,15,0,0,0,gene,Y64G10A.8,0,14250181,0.00774637,69616,14319798,1,14250181,1,0
IV,-,14158016,0.0,0.5,1,1,0,0,1,gene,R05A10.8,0,14158016,0.00147237,2306,14160322,0,14158016,0,0
IV,-,14116020,0.0,6.77626e-21,67,67,0,0,0,gene,Y37A1C.1,0,14116002,0.700382,34267,14150287,18,14116002,18,0
IV,-,14103121,0.0169492,2.0773e-32,118,116,2,2,57,gene,F52B11.5,0,14103115,0.161138,4567,14107688,6,14103121,0,-6
IV,-,14069822,0.0107759,0.0,464,459,5,3,0,gene,Y37A1B.2,0,14069818,1.19204,28382,14098204,4,14069822,0,-4
IV,-,13982491,1.0,0.0078125,7,0,7,3,0,gene,Y37A1B.15,2,13982491,0.0414155,159,13982650,0,13982491,0,0
IV,-,13979808,0.0,1.86265e-09,29,29,0,0,0,gene,Y37A1B.17,0,13979807,0.657718,1245,13981053,1,13979807,1,0
IV,-,13912265,0.0,7.70372e-34,110,110,0,0,0,gene,Y37A1A.2,0,13912258,0.277972,52077,13964342,7,13912265,0,-7
IV,-,13902823,0.0,2.38419e-07,22,22,0,0,3,gene,Y37A1A.3,0,13902815,0.126441,3135,13905958,8,13902840,-17,-25
IV,-,13876583,0.00206612,0.0,484,483,1,0,6,gene,B0513.5,0,13876573,0.477762,21198,13897781,10,13876583,0,-10
IV,-,13861355,0.00112108,0.0,892,891,1,1,3,gene,B0513.9,0,13861352,1.32218,7169,13868524,3,13861355,0,-3
IV,-,13852680,1.0,0.25,2,0,2,2,0,gene,B0513.7,0,13852680,None,7658,13860338,0,13852678,2,2
IV,-,13807785,0.0,0.0625,4,4,0,0,0,gene,Y45F10D.14,0,13807736,0.029596,9668,13817453,49,13807612,173,124
IV,-,13797870,0.00892857,0.0,224,222,2,2,0,gene,Y45F10D.6,0,13797863,0.26552,6161,13804031,7,13797863,7,0
IV,-,13788692,0.00684932,0.0,584,580,4,3,3,gene,Y45F10D.9,0,13788676,0.715668,7485,13796177,16,13788689,3,-13
IV,-,13785613,0.923567,1.66553e-30,157,12,145,92,1,gene,Y45F10D.11,2,13785612,0.480036,97,13785710,1,13785612,1,0
IV,-,13703925,0.0,0.00195312,9,9,0,0,218,gene,T23G4.1,0,13703923,0.873933,37064,13740989,2,13703995,-70,-72
IV,-,13686982,0.00961538,5.1276e-30,104,103,1,1,1,gene,T23G4.3,0,13686980,0.30143,1226,13688208,2,13686980,2,0
IV,-,13666877,0.00419664,0.0,1668,1661,7,7,45,gene,Y45F10C.3,0,13666864,1.02233,18167,13685044,13,13666837,40,27
IV,-,13652493,0.0,0.5,1,1,0,0,0,gene,C08F11.16,0,13652401,None,430,13652923,92,13652731,-238,-330
IV,-,13651478,0.0,0.25,2,2,0,0,0,gene,C08F11.12,0,13651463,0.267572,1012,13652490,15,13651479,-1,-16
IV,-,13650312,1.0,0.5,1,0,1,0,1,gene,C08F11.17,0,13650306,0.0500972,669,13650981,6,13650306,6,0
IV,-,13637004,0.0,0.00195312,9,9,0,0,4,gene,C08F11.6,0,13636943,None,7425,13644429,61,13636943,61,0
IV,-,13609837,0.0,0.000244141,12,12,0,0,1,gene,C08F11.13,0,13609795,0.698627,2965,13612802,42,13609837,0,-42
IV,-,13591726,0.0,0.125,3,3,0,0,0,gene,Y45F10B.1,0,13591713,0.000129737,5212,13596938,13,13591713,13,0
IV,-,13548198,0.0,1.42109e-14,46,46,0,0,1,gene,F52G2.3,0,13548190,0.199633,1423,13549621,8,13548198,0,-8
IV,-,13540237,0.0,0.0,156,156,0,0,1,gene,F52G2.2,1,13540233,0.904013,3135,13543372,4,13540233,4,0
IV,-,13538642,0.00995025,0.0,402,398,4,4,6,gene,F52G2.2,1,13538626,0.904013,4730,13543372,16,13538642,0,-16
IV,-,13521852,0.5,0.273438,8,4,4,4,4,gene,F52G2.1,2,13521808,0.902089,85,13521937,44,13521840,12,-32
IV,-,13521838,0.658537,2.40428e-09,328,112,216,152,96,gene,F52G2.1,2,13521808,0.902089,99,13521937,30,13521840,-2,-32
IV,-,13512130,0.1,0.000181198,20,18,2,2,2,gene,Y45F10A.2,0,13512113,1.80127,1209,13513339,17,13512130,0,-17
IV,-,13502818,0.0181269,0.0,331,325,6,5,7,gene,Y45F10A.6,0,13502813,0.621156,2417,13505235,5,13502813,5,0
IV,-,13454720,0.166667,0.09375,6,5,1,0,18,gene,K09B11.9,0,13454687,0.576456,5088,13459808,33,13454766,-46,-79
IV,-,13454704,0.0,0.0078125,7,7,0,0,65,gene,K09B11.9,0,13454687,0.576456,5104,13459808,17,13454766,-62,-79
IV,-,13453749,0.0,0.00195312,9,9,0,0,2,gene,K09B11.9,0,13453604,0.576456,6059,13459808,145,13453604,145,0
IV,-,13414839,0.00352734,0.0,567,565,2,2,0,gene,Y62E10A.17,0,13414839,0.442166,16379,13431218,0,13414839,0,0
IV,-,13412863,0.0212355,0.0,518,507,11,7,1,gene,Y62E10A.16,0,13412857,0.233484,671,13413534,6,13412863,0,-6
IV,-,13408151,1.0,0.5,1,0,1,0,62,gene,Y62E10A.19,0,13408141,0.339493,186,13408337,10,13408151,0,-10
IV,-,13392987,0.0,0.25,2,2,0,0,0,gene,Y62E10A.13,0,13392941,3.68296,6049,13399036,46,13392570,417,371
IV,-,13392569,0.121978,0.0,1820,1598,222,176,10,gene,Y62E10A.13,0,13392568,3.68296,6467,13399036,1,13392569,0,-1
IV,-,13386059,0.0,0.0,429,429,0,0,1,gene,Y62E10A.20,1,13386056,1.10824,3017,13389076,3,13386059,0,-3
IV,-,13383925,0.00309598,0.0,323,322,1,1,51,gene,Y62E10A.9,2,13383904,1.64752,360,13384285,21,13383925,0,-21
IV,-,13381891,0.911962,0.0,1045,92,953,626,0,gene,Y62E10A.10,3,13381891,3.68983,136,13382027,0,13381891,0,0
IV,-,13370253,0.00856475,0.0,34210,33917,293,263,7,gene,Y62E10A.1,1,13370248,71.8821,10039,13380292,5,13370253,0,-5
IV,-,13369385,0.983333,0.0,300,5,295,225,0,gene,Y62E10A.5,2,13369380,0.744102,7,13369392,5,13369385,0,-5
IV,-,13369382,1.0,0.000244141,12,0,12,8,0,gene,Y62E10A.5,2,13369380,0.744102,10,13369392,2,13369382,0,-2
IV,-,13353161,0.0,0.0,243,243,0,0,0,gene,W02A2.6,0,13353161,0.450511,2920,13356081,0,13353161,0,0
IV,-,13297795,0.0,0.125,3,3,0,0,434,gene,Y67H2A.2,1,13297787,0.588025,31681,13329476,8,13297836,-41,-49
IV,-,13291743,0.5,0.5,2,1,1,1,0,gene,Y67H2A.2,1,13291723,0.588025,37733,13329476,20,13291741,2,-18
IV,-,13290074,0.00540541,0.0,370,368,2,2,0,gene,Y67H2A.2,1,13289981,0.588025,39402,13329476,93,13290074,0,-93
IV,-,13289467,0.873333,3.8845e-22,150,19,131,107,40,gene,Y67H2A.10,2,13289414,2.09394,286,13289753,53,13289467,0,-53
IV,-,13282846,0.960452,0.0,531,21,510,398,0,gene,Y67H2A.1,3,13282837,0.921807,107,13282953,9,13282846,0,-9
IV,-,13282840,1.0,4.03897e-28,91,0,91,66,206,gene,Y67H2A.1,3,13282837,0.921807,113,13282953,3,13282846,-6,-9
IV,-,13272731,0.857143,0.0546875,7,1,6,4,2,gene,JC8.10,4,13272661,0.464619,1139,13273870,70,13272482,249,179
IV,-,13272482,0.435345,0.00754456,232,131,101,70,3,gene,JC8.10,4,13272479,0.464619,1388,13273870,3,13272482,0,-3
IV,-,13252319,0.0,0.03125,5,5,0,0,9,gene,JC8.8,0,13252294,30.0319,9205,13261524,25,13252281,38,13
IV,-,13252279,0.000514252,0.0,27224,27210,14,11,11,gene,JC8.8,0,13252279,30.0319,9245,13261524,0,13252279,0,0
IV,-,13240366,0.0,0.25,2,2,0,0,4,gene,JC8.3,1,13240100,103.252,10260,13250626,266,13240366,0,-266
IV,-,13240208,1.0,0.5,1,0,1,0,20848,gene,JC8.3,1,13240100,103.252,25,13240233,108,13240356,-148,-256
IV,-,13239901,0.96875,7.45058e-09,32,1,31,27,83,gene,JC8.3,1,13239892,103.252,259,13240160,9,13239901,0,-9
IV,-,13239382,0.762319,1.03182e-23,345,82,263,217,8,gene,JC8.13,2,13239380,0.419364,174,13239556,2,13239380,2,0
IV,-,13236553,0.903846,0.0,572,55,517,368,1,gene,JC8.2,3,13236548,1.66236,696,13237249,5,13236553,0,-5
IV,-,13214534,0.0571429,1.73168e-08,35,33,2,1,0,gene,C48D1.3,0,13214527,0.184147,10290,13224824,7,13214534,0,-7
IV,-,13196650,0.0,1.42109e-14,46,46,0,0,2,gene,C48D1.1,0,13196638,0.18767,1600,13198250,12,13196650,0,-12
IV,-,13189021,0.0,4.03897e-28,91,91,0,0,1,gene,F58D2.4,0,13189014,None,83,13189104,7,13189023,-2,-9
IV,-,13180790,0.0,1.90735e-06,19,19,0,0,4,gene,F58D2.3,0,13180717,None,7195,13187985,73,13180812,-22,-95
IV,-,13179120,0.0,0.125,3,3,0,0,27,gene,F09E8.7,0,13179115,0.219852,8865,13187985,5,13179115,5,0
IV,-,13154410,0.00671141,2.08793e-43,149,148,1,1,20,gene,F09E8.2,0,13154298,0.88114,19718,13174128,112,13154298,112,0
IV,-,13154305,0.0,2.98023e-08,25,25,0,0,1,gene,F09E8.2,0,13154298,0.88114,19823,13174128,7,13154298,7,0
IV,-,13113053,0.0,0.5,1,1,0,0,0,gene,B0564.4,0,13113051,0.0498268,20351,13133404,2,13113051,2,0
IV,-,13109748,0.0,0.0,226,226,0,0,52,gene,B0564.3,0,13109729,0.289696,1739,13111487,19,13109748,0,-19
IV,-,13098702,0.0147059,2.30393e-19,68,67,1,1,295,gene,C39E9.14,0,13098699,1.77997,9419,13108121,3,13098702,0,-3
IV,-,13076762,0.0,0.25,2,2,0,0,1,gene,C39E9.7,0,13076749,0.147266,12850,13089612,13,13076709,53,40
IV,-,13038957,0.0,1.81899e-12,39,39,0,0,0,gene,F49E11.2,0,13038924,0.10484,26743,13065700,33,13038959,-2,-35
IV,-,12946551,0.0,0.0625,4,4,0,0,1,gene,F55G11.1,0,12946546,0.0173663,3857,12950408,5,12946546,5,0
IV,-,12907103,1.0,0.125,3,0,3,2,0,gene,K08D8.3,0,12907058,0.244525,335,12907438,45,12906593,510,465
IV,-,12890477,0.0,0.0,350,350,0,0,48,gene,K08D8.6,0,12890469,0.920284,13460,12903937,8,12890477,0,-8
IV,-,12885979,0.0,0.5,1,1,0,0,0,gene,ZK896.3,0,12885934,None,1054,12887033,45,12886096,-117,-162
IV,-,12879614,0.0,3.63798e-12,38,38,0,0,2,gene,ZK896.5,0,12879599,0.20786,1009,12880623,15,12879614,0,-15
IV,-,12875327,0.0,6.10352e-05,14,14,0,0,0,gene,ZK896.1,0,12875314,0.0456972,1597,12876924,13,12875329,-2,-15
IV,-,12757535,0.0,1.86265e-09,29,29,0,0,1577,gene,C36H8.3,0,12757472,3.52423,66252,12823787,63,12757643,-108,-171
IV,-,12741506,0.0,1.90735e-06,19,19,0,0,0,gene,T23F6.5,0,12741493,0.0867689,1504,12743010,13,12741493,13,0
IV,-,12711714,0.00266667,0.0,375,374,1,1,2,gene,C27D8.3,0,12711711,0.503111,11358,12723072,3,12711714,0,-3
IV,-,12684348,0.004111,0.0,973,969,4,4,0,gene,T23B5.1,0,12684348,1.32176,22336,12706684,0,12684348,0,0
IV,-,12630992,0.00393701,0.0,254,253,1,1,0,gene,C01C7.1,0,12630936,0.60318,46372,12677364,56,12630992,0,-56
IV,-,12614693,0.00609756,0.0,328,326,2,2,4,gene,Y55D9A.1,1,12614689,1.11098,7370,12622063,4,12614689,4,0
IV,-,12605395,0.333333,1.67127e-08,264,176,88,71,1,gene,Y55D9A.2,2,12605337,0.446418,271,12605666,58,12605395,0,-58
IV,-,12599139,0.0,3.15544e-30,98,98,0,0,5,gene,K08E7.9,0,12599137,0.303664,1967,12601106,2,12599139,0,-2
IV,-,12590413,0.0,2.91038e-11,35,35,0,0,0,gene,K08E7.7,0,12590397,0.124574,1251,12591664,16,12590397,16,0
IV,-,12586016,0.0,0.5,1,1,0,0,7,gene,K08E7.8,0,12585985,0.212377,438,12586454,31,12586098,-82,-113
IV,-,12585770,1.0,0.25,2,0,2,2,1,gene,K08E7.8,0,12585750,0.212377,684,12586454,20,12585750,20,0
IV,-,12581113,0.00564972,0.0,177,176,1,1,1,gene,K08E7.6,0,12581097,0.168296,4046,12585159,16,12581097,16,0
IV,-,12571055,0.0,0.5,1,1,0,0,0,gene,K08E7.4,0,12571023,0.0290599,7770,12578825,32,12571191,-136,-168
IV,-,12567196,0.00193257,0.0,4657,4648,9,9,4,gene,K08E7.2,1,12567182,3.58022,3441,12570637,14,12567182,14,0
IV,-,12567188,0.0,1.00974e-28,93,93,0,0,4055,gene,K08E7.2,1,12567182,3.58022,3449,12570637,6,12567182,6,0
IV,-,12566398,0.0,0.5,1,1,0,0,3,gene,K08E7.1,2,12566381,1.231,483,12566881,17,12566398,0,-17
IV,-,12565953,0.862245,0.0,392,54,338,241,10,gene,K08E7.1,2,12565951,1.231,1,12565954,2,12565953,0,-2
IV,-,12562728,0.142857,0.0546875,7,6,1,1,0,gene,K08E7.10,0,12562723,None,1017,12563745,5,12562723,5,0
IV,-,12527318,0.027027,2.6921e-10,37,36,1,1,35,gene,F53B2.8,0,12527293,1.54408,1186,12528504,25,12527310,8,-17
IV,-,12520215,0.0,0.0078125,7,7,0,0,0,gene,F53B2.2,0,12520202,0.00386868,993,12521208,13,12520202,13,0
IV,-,12486507,0.0294118,7.71816e-18,68,66,2,2,0,gene,T04A11.5,0,12486507,0,29374,12515881,0,12486507,0,0
IV,-,12454185,0.0,1.19209e-07,23,23,0,0,1,gene,C25G4.4,0,12454161,0.226168,5602,12459787,24,12454185,0,-24
IV,-,12451264,0.152038,0.0,638,541,97,79,9,gene,C25G4.5,1,12451260,1.03435,772,12452036,4,12451264,0,-4
IV,-,12445854,0.968454,0.0,317,10,307,223,2,gene,C25G4.3,2,12445854,0.538836,273,12446127,0,12445854,0,0
IV,-,12445846,1.0,0.00195312,9,0,9,7,386,gene,C25G4.3,2,12445834,0.538836,281,12446127,12,12445854,-8,-20
IV,-,12444148,0.0,0.25,2,2,0,0,0,gene,C25G4.2,3,12444035,1.73413,272,12444420,113,12444005,143,30
IV,-,12444005,0.962785,0.0,833,31,802,348,0,gene,C25G4.2,3,12444004,1.73413,415,12444420,1,12444005,0,-1
IV,-,12417549,0.0142857,6.98093e-39,140,138,2,1,4,gene,F08G5.3,0,12417536,0.526519,9924,12427473,13,12417549,0,-13
IV,-,12414747,0.0,5.29396e-23,74,74,0,0,4,gene,F08G5.3,0,12414682,0.526519,12726,12427473,65,12414682,65,0
IV,-,12398674,0.00384615,0.0,520,518,2,2,0,gene,F28D1.9,0,12398610,0.73453,14219,12412893,64,12398674,0,-64
IV,-,12391021,0.00325977,0.0,120254,119862,392,359,3,gene,F28D1.7,0,12391016,130.479,1066,12392087,5,12391021,0,-5
IV,-,12360760,0.00757576,0.0,396,393,3,2,0,gene,ZC518.2,0,12360737,1.08801,883,12361643,23,12360760,0,-23
IV,-,12334570,0.0172712,0.0,579,569,10,9,2,gene,F19B6.1,1,12334569,2.30888,20998,12355568,1,12334570,0,-1
IV,-,12334071,0.0,4.65661e-10,31,31,0,0,17,gene,F19B6.1,1,12334054,2.30888,21497,12355568,17,12334071,0,-17
IV,-,12330963,1.0,0.5,1,0,1,1,1,gene,F19B6.2,2,12330947,1.99791,230,12331193,16,12330861,102,86
IV,-,12330860,0.641234,5.07815e-13,616,221,395,279,2,gene,F19B6.2,2,12330844,1.99791,90,12330950,16,12330861,-1,-17
IV,-,12311728,0.0,0.125,3,3,0,0,1,gene,K09E10.2,0,12311703,0.0323964,17645,12329373,25,12311576,152,127
IV,-,12301250,0.0,3.76158e-37,121,121,0,0,0,gene,C42C1.7,0,12301227,0.27026,3007,12304257,23,12301250,0,-23
IV,-,12282177,0.0129032,0.0,310,306,4,4,0,gene,C42C1.12,0,12282174,1.1867,11035,12293212,3,12282177,0,-3
IV,-,12278022,0.0122951,0.0,488,482,6,5,3,gene,C42C1.5,1,12278001,1.08178,3613,12281635,21,12278022,0,-21
IV,-,12275962,0.862069,2.09168e-16,116,16,100,78,0,gene,C42C1.4,2,12275953,0.362535,99,12276061,9,12275953,9,0
IV,-,12268286,0.0,0.000244141,12,12,0,0,1,gene,C42C1.2,0,12268276,0.0459309,1262,12269548,10,12268276,10,0
IV,-,12259175,0.0350877,1.10745e-14,57,55,2,0,1,gene,Y39C12A.9,0,12259162,0.280837,592,12259767,13,12259162,13,0
IV,-,12252642,0.0,6.01853e-36,117,117,0,0,1,gene,Y39C12A.8,0,12252618,0.191392,4935,12257577,24,12252618,24,0
IV,-,12225041,0.0,0.5,1,1,0,0,0,gene,Y39C12A.2,0,12224969,None,2689,12227730,72,12225041,0,-72
IV,-,12215957,0.00309598,0.0,969,966,3,2,47,gene,F35G2.4,0,12215956,1.33456,6885,12222842,1,12215957,0,-1
IV,-,12208980,0.00926377,0.0,2051,2032,19,16,6,gene,F35G2.2,0,12208977,1.78701,2088,12211068,3,12208980,0,-3
IV,-,12186576,0.0,0.125,3,3,0,0,0,gene,F20B10.2,0,12186554,None,21579,12208155,22,12186537,39,17
IV,-,12178344,0.0,0.015625,6,6,0,0,0,gene,F20B10.1,0,12178322,0.454879,1040,12179384,22,12178305,39,17
IV,-,12154215,0.00290698,0.0,344,343,1,1,0,gene,B0001.7,1,12154212,0.41147,16579,12170794,3,12154212,3,0
IV,-,12150943,0.893805,4.75867e-19,113,12,101,83,8,gene,B0001.2,2,12150934,0.483002,198,12151141,9,12150934,9,0
IV,-,12145892,1.0,0.5,1,0,1,1,0,gene,B0001.3,3,12145871,0.657011,557,12146449,21,12145701,191,170
IV,-,12145701,0.28882,6.56049e-15,322,229,93,73,0,gene,B0001.3,3,12145670,0.657011,748,12146449,31,12145701,0,-31
IV,-,12143314,1.0,0.125,3,0,3,2,7,gene,B0001.5,4,12143295,0.713684,87,12143401,19,12143301,13,-6
IV,-,12143301,0.839286,3.26659e-20,168,27,141,106,8,gene,B0001.5,4,12143295,0.713684,100,12143401,6,12143301,0,-6
IV,-,12141027,0.865285,8.99987e-27,193,26,167,123,1,gene,B0001.8,5,12141017,0.600395,104,12141131,10,12141027,0,-10
IV,-,12137317,0.565844,0.00053303,486,211,275,211,0,gene,B0001.4,6,12137317,1.55165,1500,12138817,0,12137317,0,0
IV,-,12121135,0.00365297,0.0,1095,1091,4,3,24,gene,M18.5,0,12121094,1.14707,14204,12135339,41,12121135,0,-41
IV,-,12111540,0.00153374,0.0,652,651,1,1,0,gene,M18.2,0,12111470,0.748109,3239,12114779,70,12111547,-7,-77
IV,-,12110181,0.583333,0.193359,12,5,7,5,1367,gene,M18.1,0,12110124,4.83454,379,12110560,57,12110228,-47,-104
IV,-,12093415,0.00986842,0.0,304,301,3,3,3,gene,F11A10.8,1,12093415,1.63791,15229,12108644,0,12093442,-27,-27
IV,-,12092183,0.875458,1.76523e-39,273,34,239,173,3,gene,F11A10.3,2,12092183,0.666553,107,12092290,0,12092183,0,0
IV,-,12092155,1.0,0.5,1,0,1,1,253,gene,F11A10.3,2,12092062,0.666553,135,12092290,93,12092183,-28,-121
IV,-,12088998,0.446429,0.0773609,56,31,25,21,306,gene,F11A10.6,0,12088993,0.858989,109,12089107,5,12089066,-68,-73
IV,-,12078133,0.0034904,0.0,573,571,2,2,0,gene,K08E4.6,0,12078131,1.70592,8862,12086995,2,12078135,-2,-4
IV,-,12056625,0.0103093,6.12156e-28,97,96,1,1,6,gene,K08E4.2,0,12056612,0.366842,3743,12060368,13,12056619,6,-7
IV,-,12043706,0.00560224,0.0,357,355,2,1,1,gene,T12G3.2,0,12043566,1.32092,6123,12049829,140,12043568,138,-2
IV,-,12043479,0.0,0.25,2,2,0,0,83,gene,T12G3.2,0,12043425,1.32092,6350,12049829,54,12043479,0,-54
IV,-,12030858,0.00330396,0.0,908,905,3,3,9,gene,T12G3.6,0,12030845,1.92068,8096,12038954,13,12030845,13,0
IV,-,12029145,0.0229277,0.0,567,554,13,11,0,gene,T12G3.7,0,12029135,0.849078,875,12030020,10,12029135,10,0
IV,-,12015648,0.0,0.0078125,7,7,0,0,8,gene,ZK617.2,0,12015629,0.0396152,11205,12026853,19,12015629,19,0
IV,-,12010977,0.0,1.43493e-42,139,139,0,0,0,gene,ZK617.1,0,12010929,0.712122,3142,12014119,48,12010977,0,-48
IV,-,12003244,0.0,0.03125,5,5,0,0,0,gene,ZK617.4,0,12003072,0.00530542,10875,12014119,172,12003072,172,0
IV,-,11961505,0.00200401,0.0,2495,2490,5,3,6,gene,ZK829.7,1,11961502,2.1806,2373,11963878,3,11961505,0,-3
IV,-,11959769,0.839506,1.42545e-19,162,26,136,90,231,gene,ZK829.6,2,11959763,0.503017,102,11959871,6,11959740,29,23
IV,-,11923144,0.00194553,0.0,1028,1026,2,2,8,gene,ZK822.2,0,11923143,2.58088,1470,11924614,1,11923144,0,-1
IV,-,11915657,0.00245298,0.0,2446,2440,6,4,2,gene,VZK822L.1,0,11915638,13.893,2360,11918017,19,11915657,0,-19
IV,-,11856327,0.0,6.10352e-05,14,14,0,0,30,gene,F38H4.8,1,11856311,0.669603,9679,11866006,16,11856346,-19,-35
IV,-,11856319,0.00330033,0.0,303,302,1,1,22,gene,F38H4.8,1,11856311,0.669603,9687,11866006,8,11856346,-27,-35
IV,-,11821887,0.0139892,0.0,4432,4370,62,54,61,gene,M117.2,0,11821867,28.6903,5668,11827555,20,11821887,0,-20
IV,-,11804120,0.00116482,0.0,1717,1715,2,1,1,gene,H01G02.1,0,11804086,1.30688,16330,11820450,34,11804086,34,0
IV,-,11792563,0.0,0.0,225,225,0,0,0,gene,H01G02.3,0,11792528,0.479653,6070,11798633,35,11792563,0,-35
IV,-,11773607,0.0,5.42101e-20,64,64,0,0,0,gene,T12A7.4,0,11773606,0.128274,10304,11783911,1,11773712,-105,-106
IV,-,11761034,0.0,0.0,306,306,0,0,1,gene,T12A7.2,0,11760937,0.602949,7595,11768629,97,11761034,0,-97
IV,-,11759366,0.0,5.29396e-23,74,74,0,0,0,gene,T12A7.2,0,11759344,0.602949,9263,11768629,22,11759366,0,-22
IV,-,11738543,0.0,0.0,153,153,0,0,1,gene,K01A6.7,0,11738537,None,411,11738954,6,11738486,57,51
IV,-,11700392,0.0,0.000244141,12,12,0,0,6,gene,T22B3.1,0,11700343,0.0976968,2806,11703198,49,11699860,532,483
IV,-,11699696,0.0,0.015625,6,6,0,0,8,gene,T22B3.1,0,11699696,0.0976968,3502,11703198,0,11699860,-164,-164
IV,-,11691056,0.0121655,0.0,822,812,10,9,1,gene,ZK792.6,1,11691047,3.26069,5357,11696413,9,11691058,-2,-11
IV,-,11688088,0.875486,2.87275e-37,257,32,225,125,1,gene,ZK792.5,2,11688087,0.590462,107,11688195,1,11688088,0,-1
IV,-,11688023,1.0,0.5,1,0,1,1,50,gene,ZK792.5,2,11688014,0.590462,172,11688195,9,11688088,-65,-74
IV,-,11681975,0.0,1.90735e-06,19,19,0,0,1,gene,ZK792.4,0,11681960,0.0748505,2969,11684944,15,11681975,0,-15
IV,-,11655440,0.00982801,0.0,407,403,4,3,1,gene,ZK809.4,0,11655434,2.96912,22969,11678409,6,11655440,0,-6
IV,-,11651993,0.0105263,0.0,190,188,2,2,38,gene,ZK809.2,0,11651989,0.485551,1392,11653385,4,11651993,0,-4
IV,-,11647658,0.00198511,0.0,4030,4022,8,6,0,gene,ZK809.8,0,11647649,7.16445,3031,11650689,9,11647658,0,-9
IV,-,11635457,0.00129199,0.0,774,773,1,1,0,gene,F58B3.5,1,11635442,2.11003,4596,11640053,15,11635457,0,-15
IV,-,11631820,0.785714,0.00140347,28,6,22,13,2,gene,F58B3.4,2,11631808,0.745016,88,11631908,12,11631811,9,-3
IV,-,11631811,0.966981,0.0,212,7,205,130,72,gene,F58B3.4,2,11631808,0.745016,97,11631908,3,11631811,0,-3
IV,-,11604895,0.00813743,0.0,1106,1097,9,8,2,gene,Y24F12A.2,0,11604894,2.60832,14549,11619444,1,11604894,1,0
IV,-,11592826,0.0103896,0.0,385,381,4,3,5,gene,F40F11.3,0,11592817,1.19477,10756,11603582,9,11592817,9,0
IV,-,11566162,0.00335008,0.0,1194,1190,4,3,1,gene,F12F6.6,1,11566161,1.89215,17304,11583466,1,11566161,1,0
IV,-,11561803,0.878788,1.23725e-29,198,24,174,142,20,gene,F12F6.7,2,11561802,0.923338,146,11561949,1,11561803,0,-1
IV,-,11548741,0.0,0.015625,6,6,0,0,0,gene,F12F6.10,0,11548724,0.0190702,1232,11549973,17,11548557,184,167
IV,-,11521002,0.00423729,0.0,236,235,1,1,2,gene,M04B2.4,0,11521001,0.524654,9582,11530584,1,11521001,1,0
IV,-,11510735,0.00207039,0.0,483,482,1,0,3,gene,M04B2.6,0,11510716,0.777579,6821,11517556,19,11510716,19,0
IV,-,11498139,0.00826446,4.55151e-35,121,120,1,1,27,gene,H21P03.3,0,11498138,1.82135,11497,11509636,1,11498138,1,0
IV,-,11496333,0.0,0.125,3,3,0,0,0,gene,H21P03.3,0,11496330,1.82135,13303,11509636,3,11496333,0,-3
IV,-,11486079,0.00212766,0.0,470,469,1,0,1,gene,H21P03.3,0,11485897,1.82135,23557,11509636,182,11486079,0,-182
IV,-,11480437,0.0,0.5,1,1,0,0,5,gene,H21P03.1,1,11480374,5.06837,2197,11482634,63,11480156,281,218
IV,-,11480156,0.00424469,0.0,4005,3988,17,14,4,gene,H21P03.1,1,11480123,5.06837,2478,11482634,33,11480156,0,-33
IV,-,11479222,0.913043,1.74658e-41,230,20,210,129,0,gene,C10C6.6,2,11479203,1.20757,107,11479329,19,11479222,0,-19
IV,-,11467208,0.0,1.81899e-12,39,39,0,0,1,gene,C10C6.7,0,11467203,0.0751674,6129,11473337,5,11467210,-2,-7
IV,-,11467137,0.0,0.00012207,13,13,0,0,3,gene,C10C6.7,0,11467137,0.0751674,6200,11473337,0,11467210,-73,-73
IV,-,11403309,0.00662252,0.0,1208,1200,8,5,1,gene,H02I12.5,0,11403308,0.585721,3035,11406344,1,11403308,1,0
IV,-,11371763,0.00583658,0.0,514,511,3,2,91,gene,T01G1.3,0,11371723,0.978555,6327,11378090,40,11371763,0,-40
IV,-,11361480,0.231005,0.0,1303,1002,301,217,2,gene,T01G1.4,0,11361475,0.77362,4101,11365581,5,11361480,0,-5
IV,-,11359834,0.015748,0.0,254,250,4,2,3,gene,T01G1.1,0,11359815,1.08259,1,11359835,19,11359834,0,-19
IV,-,11351159,0.0,0.125,3,3,0,0,2,gene,T01G1.1,0,11351143,1.08259,5268,11356427,16,11351159,0,-16
IV,-,11350902,0.0,0.25,2,2,0,0,5,gene,T01G1.1,0,11350810,1.08259,5525,11356427,92,11350902,0,-92
IV,-,11343536,0.0,0.5,1,1,0,0,1,gene,T01G1.1,0,11343451,1.08259,12891,11356427,85,11343536,0,-85
IV,-,11343007,0.0,0.5,1,1,0,0,20,gene,T01G1.1,0,11342978,1.08259,13420,11356427,29,11343007,0,-29
IV,-,11336835,0.0225564,0.0,532,520,12,9,0,gene,F54E12.2,1,11336834,0.887872,989,11337824,1,11336835,0,-1
IV,-,11332863,0.526087,0.0384751,230,109,121,98,77,gene,B0035.12,2,11332842,0.764008,188,11333051,21,11332863,0,-21
IV,-,11329685,0.0,0.5,1,1,0,0,77,gene,B0035.11,3,11329629,1.42279,3366,11333051,56,11329340,345,289
IV,-,11329340,0.945996,0.0,537,29,508,332,1,gene,B0035.11,3,11329340,1.42279,108,11329448,0,11329340,0,0
IV,-,11314949,0.0217391,6.53699e-13,46,45,1,1,473,gene,B0035.3,1,11314938,1.5126,9078,11324027,11,11315021,-72,-83
IV,-,11313951,0.940298,2.02067e-42,201,12,189,121,0,gene,B0035.2,2,11313947,0.816978,97,11314048,4,11313951,0,-4
IV,-,11298219,0.00729927,7.86341e-40,137,136,1,1,55,gene,B0035.15,1,11298219,0.584119,6474,11304693,0,11298390,-171,-171
IV,-,11296858,0.913043,2.319e-09,46,4,42,31,1,gene,B0035.16,2,11296858,0.11222,60,11296918,0,11296858,0,0
IV,-,11268826,0.0,9.31323e-10,30,30,0,0,0,gene,F54D1.4,0,11268793,0.19639,26256,11295082,33,11268826,0,-33
IV,-,11266048,0.0,0.25,2,2,0,0,0,gene,F54D1.3,0,11265994,0,190,11266238,54,11265896,152,98
IV,-,11259506,0.0,0.0,154,154,0,0,0,gene,C05C12.3,0,11259436,0.281156,880,11260386,70,11259436,70,0
IV,-,11248050,0.00784314,0.0,255,253,2,2,2,gene,C05C12.4,0,11248041,1.48488,805,11248855,9,11248023,27,18
IV,-,11233094,0.0,2.27374e-13,42,42,0,0,0,gene,C05C12.6,0,11233094,0.124448,13328,11246422,0,11233094,0,0
IV,-,11223939,0.0,0.125,3,3,0,0,0,gene,C29F4.3,0,11223932,0.0213826,2743,11226682,7,11223907,32,25
IV,-,11215170,0.0,0.00195312,9,9,0,0,0,gene,R07H5.10,0,11215162,0.0168332,6847,11222017,8,11215192,-22,-30
IV,-,11210802,0.0016546,0.0,9670,9654,16,15,8,gene,R07H5.8,0,11210775,10.6693,2662,11213464,27,11210802,0,-27
IV,-,11189798,0.0,0.0625,4,4,0,0,1,gene,R07H5.7,0,11189743,0.000479158,5770,11195568,55,11189609,189,134
IV,-,11178567,0.0100264,0.0,3790,3752,38,29,1,gene,C08F8.9,0,11178561,9.28283,17001,11195568,6,11178567,0,-6
IV,-,11149476,0.0026764,0.0,16440,16396,44,41,8,gene,F01G4.6,1,11149467,34.6189,7621,11157097,9,11149476,0,-9
IV,-,11147219,0.943089,6.67923e-27,123,7,116,71,4,gene,F01G4.5,2,11147214,0.730122,9,11147228,5,11147214,5,0
IV,-,11142330,0.00763359,4.81218e-38,131,130,1,0,0,gene,F01G4.3,0,11142313,0.368223,3729,11146059,17,11142313,17,0
IV,-,11118859,0.0028777,0.0,2085,2079,6,5,7,gene,T05E11.5,0,11118835,4.25678,4246,11123105,24,11118859,0,-24
IV,-,11111017,0.00271891,0.0,43032,42915,117,96,8,gene,T05E11.1,1,11111016,114.495,5686,11116703,1,11111017,0,-1
IV,-,11109987,0.91875,2.99932e-30,160,13,147,120,8,gene,T05E11.6,2,11109973,0.41999,88,11110075,14,11109973,14,0
IV,-,11105790,0.0144928,1.16891e-19,69,68,1,1,1,gene,T05E11.8,0,11105790,0.223212,2632,11108422,0,11105790,0,0
IV,-,11097820,0.0,0.0625,4,4,0,0,89,gene,M7.12,0,11097812,0.161933,598,11098418,8,11097823,-3,-11
IV,-,11097798,0.0,0.25,2,2,0,0,27,gene,M7.12,0,11097667,0.161933,620,11098418,131,11097823,-25,-156
IV,-,11095057,0.0,3.38813e-21,68,68,0,0,10,gene,M7.8,0,11094975,0.176053,1635,11096692,82,11094975,82,0
IV,-,11092524,0.0,4.70198e-38,124,124,0,0,1,gene,M7.3,0,11092520,0.119406,1293,11093817,4,11092524,0,-4
IV,-,11082225,0.00488661,0.0,7981,7942,39,32,3,gene,M7.1,1,11082179,18.4218,3821,11086046,46,11082225,0,-46
IV,-,11081027,0.679012,1.64199e-06,162,52,110,78,11,gene,M7.5,2,11081022,1.087,25,11081052,5,11081027,0,-5
IV,-,11078554,1.0,0.0,154,0,154,126,10,gene,Y5F2A.4,3,11078548,0.54107,103,11078657,6,11078554,0,-6
IV,-,11066998,0.00220103,0.0,4089,4080,9,8,747,gene,Y5F2A.2,0,11066996,5.48151,9058,11076056,2,11066998,0,-2
IV,-,11064177,0.0,0.25,2,2,0,0,1,gene,Y5F2A.1,0,11064086,31.4515,1799,11065976,91,11064113,64,-27
IV,-,11036230,0.0,0.00012207,13,13,0,0,0,gene,F36H1.13,0,11036225,None,16523,11052753,5,11036235,-5,-10
IV,-,11030963,0.0,6.01853e-36,117,117,0,0,2,gene,F36H1.5,0,11030962,0.517169,21790,11052753,1,11030962,1,0
IV,-,11029073,0.0,0.25,2,2,0,0,0,gene,F36H1.9,0,11029056,0.0103308,1009,11030082,17,11029056,17,0
IV,-,11021896,0.0769231,0.00158691,13,12,1,1,0,gene,F13H10.4,1,11021809,0.933369,6549,11028445,87,11021872,24,-63
IV,-,11019686,0.00246914,0.0,1215,1212,3,2,1,gene,F13H10.4,1,11019686,0.933369,8759,11028445,0,11019686,0,0
IV,-,11015853,1.0,0.125,3,0,3,1,21,gene,F13H10.3,2,11015853,0.7463,346,11016199,0,11015853,0,0
IV,-,11015724,0.752399,2.56273e-32,521,129,392,331,59,gene,F13H10.3,2,11015661,0.7463,475,11016199,63,11015724,0,-63
IV,-,11011990,0.865591,6.64e-26,186,25,161,113,3,gene,F13H10.2,3,11011971,0.712846,95,11012085,19,11011990,0,-19
IV,-,11011846,0.0,3.8147e-06,18,18,0,0,2,gene,F13H10.2,3,11011818,0.712846,239,11012085,28,11011846,0,-28
IV,-,10957625,0.00134589,0.0,1486,1484,2,1,683,gene,Y69E1A.5,0,10957613,1.86981,3571,10961196,12,10957655,-30,-42
IV,-,10935880,0.00584795,0.0,171,170,1,1,38,gene,ZK593.6,0,10935831,8.8068,11323,10947203,49,10935875,5,-44
IV,-,10935873,0.00236267,0.0,3386,3378,8,5,69,gene,ZK593.6,0,10935831,8.8068,11330,10947203,42,10935873,0,-42
IV,-,10933128,0.0298507,0.0,201,195,6,6,10,gene,ZK593.5,0,10933075,0.873539,963,10934091,53,10933130,-2,-55
IV,-,10904352,0.0,7.10543e-15,47,47,0,0,0,gene,ZK596.3,0,10904327,0.119028,3751,10908103,25,10904327,25,0
IV,-,10892066,0.0,0.00195312,9,9,0,0,1,gene,F13E9.14,0,10892064,0.0130028,1535,10893601,2,10892064,2,0
IV,-,10889847,0.00084246,0.0,1187,1186,1,1,12,gene,F13E9.15,0,10889841,1.96011,1455,10891302,6,10889841,6,0
IV,-,10887407,0.0,0.25,2,2,0,0,0,gene,F13E9.16,0,10887356,0.000881895,2035,10889442,51,10887668,-261,-312
IV,-,10874596,0.0,0.0,603,603,0,0,0,gene,F13E9.12,0,10874580,0.86748,3084,10877680,16,10874598,-2,-18
IV,-,10858530,0.0,0.5,1,1,0,0,1,gene,T11G6.2,0,10858478,0.592813,6692,10865222,52,10858530,0,-52
IV,-,10858034,0.0206186,2.93835e-26,97,95,2,2,0,gene,T11G6.2,0,10858025,0.592813,7188,10865222,9,10858034,0,-9
IV,-,10851904,0.00719424,1.99455e-40,139,138,1,1,0,gene,T11G6.4,0,10851900,0.395704,737,10852641,4,10851904,0,-4
IV,-,10842727,0.0120482,8.582e-24,83,82,1,1,4,gene,T11G6.5,0,10842717,0.483539,1827,10844554,10,10842727,0,-10
IV,-,10842719,0.0,3.05176e-05,15,15,0,0,460,gene,T11G6.5,0,10842717,0.483539,1835,10844554,2,10842727,-8,-10
IV,-,10842303,0.0,0.0078125,7,7,0,0,15,gene,T11G6.5,0,10842264,0.483539,2251,10844554,39,10842303,0,-39
IV,-,10832220,0.0,1.16415e-10,33,33,0,0,0,gene,R13.3,0,10832216,0.0709845,3579,10835799,4,10832220,0,-4
IV,-,10827994,0.0,0.125,3,3,0,0,11,gene,R13.2,0,10827993,0.0247908,1527,10829521,1,10827993,1,0
IV,-,10734554,0.00806452,5.83045e-36,124,123,1,1,40,gene,ZC168.3,0,10734550,0.749188,3697,10738251,4,10734604,-50,-54
IV,-,10711764,0.0,0.03125,5,5,0,0,5,gene,R102.9,0,10711764,0.0181337,21039,10732803,0,10711764,0,0
IV,-,10701345,0.0,1.00974e-28,93,93,0,0,0,gene,R102.6,0,10701335,0.135914,8243,10709588,10,10701335,10,0
IV,-,10699542,0.0,0.0078125,7,7,0,0,126,gene,R102.11,0,10699538,None,10046,10709588,4,10699732,-190,-194
IV,-,10697043,0.00344828,0.0,1740,1734,6,5,89,gene,R102.5,1,10697040,2.5674,1308,10698351,3,10697043,0,-3
IV,-,10695198,1.0,3.46945e-18,58,0,58,40,0,gene,R102.4,2,10695185,1.2137,94,10695292,13,10695185,13,0
IV,-,10694104,0.0118343,0.0,169,167,2,2,6,gene,R102.4,2,10694072,1.2137,1188,10695292,32,10694104,0,-32
IV,-,10680449,0.0,6.93889e-18,57,57,0,0,0,gene,K08C7.4,0,10680447,0.11352,3953,10684402,2,10680447,2,0
IV,-,10645263,0.0,0.015625,6,6,0,0,2,gene,F56C4.3,0,10645251,0.211675,34144,10679407,12,10645263,0,-12
IV,-,10593575,0.0,0.0,273,273,0,0,0,gene,C43F9.7,0,10593547,0.395227,28134,10621709,28,10593547,28,0
IV,-,10545026,0.0,0.015625,6,6,0,0,33,gene,T07G12.5,0,10544981,0.0744109,42464,10587490,45,10545063,-37,-82
IV,-,10542248,0.0,0.5,1,1,0,0,0,gene,T07G12.5,0,10542230,0.0744109,45242,10587490,18,10542230,18,0
IV,-,10515006,0.0,0.5,1,1,0,0,143,gene,C02F4.4,0,10514976,0.537401,21935,10536941,30,10515255,-249,-279
IV,-,10501569,0.0,0.0,1167,1167,0,0,0,gene,C02F4.2,0,10501316,2.59012,12296,10513865,253,10501556,13,-240
IV,-,10501098,0.0,0.125,3,3,0,0,0,gene,C02F4.2,0,10501032,2.59012,12767,10513865,66,10501032,66,0
IV,-,10483627,0.00372787,0.0,1073,1069,4,3,3,gene,F01D4.5,0,10483620,0.644281,9220,10492847,7,10483620,7,0
IV,-,10481816,0.0,6.16298e-33,107,107,0,0,10,gene,F01D4.4,0,10481739,7.62255,783,10482599,77,10481816,0,-77
IV,-,10461073,0.0,0.0078125,7,7,0,0,2,gene,F01D4.6,0,10461073,0.113416,9228,10470301,0,10461073,0,0
IV,-,10456651,0.0,0.5,1,1,0,0,0,gene,F01D4.7,0,10456617,0.0119717,2183,10458834,34,10456617,34,0
IV,-,10453071,0.0,1.03398e-25,83,83,0,0,0,gene,F01D4.8,0,10453070,0.208383,1298,10454369,1,10453070,1,0
IV,-,10446776,0.0,1.2326e-32,106,106,0,0,12,gene,F13B12.4,0,10446774,0.262622,3960,10450736,2,10446776,0,-2
IV,-,10425155,0.0,0.0078125,7,7,0,0,0,gene,F13B12.1,0,10425017,2.10779,1048,10426203,138,10424609,546,408
IV,-,10424607,0.0032352,0.0,3091,3081,10,9,0,gene,F13B12.1,0,10424590,2.10779,1596,10426203,17,10424607,0,-17
IV,-,10417853,0.370588,1.14571e-09,510,321,189,171,0,gene,F13B12.6,1,10417823,1.01872,2982,10420835,30,10417853,0,-30
IV,-,10413901,0.967532,2.96022e-38,154,5,149,129,0,gene,R10H10.7,2,10413901,0.236672,108,10414009,0,10413901,0,0
IV,-,10409449,0.893103,0.0,290,31,259,188,43,gene,R10H10.6,3,10409449,0.710197,509,10409958,0,10409449,0,0
IV,-,10394930,0.0,0.0,416,416,0,0,1,gene,R10H10.4,0,10394926,0.525121,13745,10408675,4,10394926,4,0
IV,-,10367769,0.0133333,7.83046e-42,150,148,2,2,1,gene,R11A8.5,1,10367762,1.35041,4844,10372613,7,10367762,7,0
IV,-,10367762,0.0161725,0.0,742,730,12,11,94,gene,R11A8.5,1,10367762,1.35041,4851,10372613,0,10367762,0,0
IV,-,10366201,0.964286,0.0,336,12,324,260,11,gene,R11A8.4,2,10366160,0.948295,103,10366304,41,10366201,0,-41
IV,-,10366146,0.851852,0.000130758,27,4,23,17,499,gene,R11A8.4,2,10366051,0.948295,158,10366304,95,10366201,-55,-150
IV,-,10366132,0.952381,1.00136e-05,21,1,20,16,408,gene,R11A8.4,2,10366051,0.948295,172,10366304,81,10366201,-69,-150
IV,-,10357142,0.0,6.93889e-18,57,57,0,0,0,gene,R11A8.1,0,10357134,0.226428,6153,10363295,8,10357134,8,0
IV,-,10357080,0.0,0.5,1,1,0,0,10,gene,R11A8.1,0,10357073,0.226428,6215,10363295,7,10357134,-54,-61
IV,-,10348937,0.0,7.88861e-31,100,100,0,0,0,gene,K11E8.1,0,10348833,3.11035,2466,10351403,104,10348937,0,-104
IV,-,10340528,0.0059761,0.0,1004,998,6,6,1,gene,K11E8.1,0,10340467,3.11035,10875,10351403,61,10340528,0,-61
IV,-,10340292,0.0,0.5,1,1,0,0,13,gene,K11E8.1,0,10340140,3.11035,11111,10351403,152,10340292,0,-152
IV,-,10334141,0.0,7.62939e-06,17,17,0,0,0,gene,K11E8.1,0,10334123,3.11035,2877,10337018,18,10334141,0,-18
IV,-,10321093,0.0,0.5,1,1,0,0,0,gene,R09E10.1,0,10321048,0.113974,3135,10324228,45,10321033,60,15
IV,-,10302267,0.0,1.38778e-17,56,56,0,0,0,gene,R09E10.5,0,10302264,0.622863,3876,10306143,3,10302330,-63,-66
IV,-,10283985,0.00776197,0.0,773,767,6,6,1,gene,Y43C5A.6,1,10283976,0.948957,8991,10292976,9,10283985,0,-9
IV,-,10281553,0.752095,0.0,1432,355,1077,864,21,gene,Y43C5A.5,2,10281538,1.28126,55,10281608,15,10281553,0,-15
IV,-,10269199,0.0,9.18355e-41,133,133,0,0,53,gene,Y43C5A.1,0,10269158,3.4562,10230,10279429,41,10269199,0,-41
IV,-,10259628,0.0,0.0,160,160,0,0,1,gene,F01G10.9,0,10259628,0.273979,9222,10268850,0,10259628,0,0
IV,-,10239104,0.0,0.0625,4,4,0,0,29,gene,F01G10.2,0,10239085,0.376413,145,10239249,19,10239085,19,0
IV,-,10239089,0.0,0.0,523,523,0,0,26,gene,F01G10.2,0,10239085,0.376413,160,10239249,4,10239085,4,0
IV,-,10235300,0.0,0.0,200,200,0,0,1,gene,F01G10.3,0,10235281,0.106777,1302,10236602,19,10235300,0,-19
IV,-,10235265,0.0,0.000488281,11,11,0,0,40,gene,F01G10.3,0,10235245,0.106777,1337,10236602,20,10235300,-35,-55
IV,-,10232525,0.166667,0.09375,6,5,1,1,0,gene,F01G10.4,0,10232523,0.0291431,805,10233330,2,10232162,363,361
IV,-,10221252,0.0103359,0.0,774,766,8,6,1,gene,C24F3.1,1,10221250,4.56037,5051,10226303,2,10221252,0,-2
IV,-,10221241,0.0,0.25,2,2,0,0,2934,gene,C24F3.1,1,10221189,4.56037,5062,10226303,52,10221252,-11,-63
IV,-,10219279,0.938967,0.0,426,26,400,324,0,gene,C24F3.4,2,10219276,0.61559,17,10219296,3,10219279,0,-3
IV,-,10194412,0.0,1.17549e-38,126,126,0,0,1,gene,K04D7.4,0,10194412,0.381532,9774,10204186,0,10194380,32,32
IV,-,10174310,0.00237248,0.0,843,841,2,2,1,gene,T14G10.2,0,10174301,0.78209,9446,10183756,9,10174301,9,0
IV,-,10150573,0.00400802,0.0,1996,1988,8,8,2,gene,T14G10.6,1,10150524,1.56247,13690,10164263,49,10150554,19,-30
IV,-,10149009,0.901961,0.0,408,40,368,267,2,gene,T14G10.7,2,10149008,0.662716,127,10149136,1,10149009,0,-1
IV,-,10143744,1.0,0.5,1,0,1,1,3,gene,K08F4.8,0,10143711,3.80721,2495,10146239,33,10143746,-2,-35
IV,-,10128927,0.0112045,0.0,714,706,8,8,0,gene,K08F4.2,1,10128916,5.20141,5977,10134904,11,10128927,0,-11
IV,-,10128910,0.0,0.0625,4,4,0,0,5096,gene,K08F4.2,1,10128883,5.20141,5994,10134904,27,10128927,-17,-44
IV,-,10126615,0.955294,0.0,425,19,406,278,1,gene,K08F4.1,2,10126609,0.773582,105,10126720,6,10126615,0,-6
IV,-,10126611,1.0,4.65661e-10,31,0,31,18,6,gene,K08F4.1,2,10126609,0.773582,109,10126720,2,10126615,-4,-6
IV,-,10059150,0.00294985,0.0,1017,1014,3,3,0,gene,T04B2.5,0,10059097,1.06681,11090,10070240,53,10059150,0,-53
IV,-,10055690,0.0,0.5,1,1,0,0,0,gene,T04B2.7,0,10055683,0.0569939,881,10056571,7,10055690,0,-7
IV,-,10003318,0.0,0.0,477,477,0,0,0,gene,C47E12.2,1,10003309,0.706948,698,10004016,9,10003318,0,-9
IV,-,10001818,0.913979,5.14866e-34,186,16,170,121,22,gene,C47E12.3,2,10001797,0.548946,127,10001945,21,10001818,0,-21
IV,-,9998913,0.0,3.05176e-05,15,15,0,0,42,gene,C47E12.4,3,9998911,8.76301,171,9999084,2,9998897,16,14
IV,-,9997955,0.0,2.98023e-08,25,25,0,0,15,gene,C47E12.4,3,9997935,8.76301,1129,9999084,20,9997935,20,0
IV,-,9997935,0.000454339,0.0,2201,2200,1,1,47,gene,C47E12.4,3,9997935,8.76301,1149,9999084,0,9997935,0,0
IV,-,9996763,0.00543478,0.0,2392,2379,13,13,10,gene,C47E12.4,3,9996717,8.76301,626,9997389,46,9996763,0,-46
IV,-,9994917,0.353982,3.91474e-32,1582,1022,560,381,5,gene,C47E12.5,4,9994895,4.14075,495,9995412,22,9994917,0,-22
IV,-,9994877,0.0,0.5,1,1,0,0,1289,gene,C47E12.5,4,9994702,4.14075,535,9995412,175,9994877,0,-175
IV,-,9993321,0.0366972,8.57155e-27,109,105,4,2,0,gene,C47E12.5,4,9993261,4.14075,2091,9995412,60,9993321,0,-60
IV,-,9993318,0.0,1.52588e-05,16,16,0,0,7,gene,C47E12.5,4,9993261,4.14075,2094,9995412,57,9993318,0,-57
IV,-,9982248,0.0124069,0.0,403,398,5,3,1,gene,C47E12.7,0,9982238,0.759253,7395,9989643,10,9982248,0,-10
IV,-,9972566,0.0,0.125,3,3,0,0,3,gene,C47E12.12,0,9972500,0.119149,8127,9980693,66,9972670,-104,-170
IV,-,9932116,0.0140845,1.79564e-39,142,140,2,2,253,gene,F25H8.1,0,9932107,0.548245,2108,9934224,9,9932162,-46,-55
IV,-,9928195,0.00176056,0.0,568,567,1,1,0,gene,F25H8.5,0,9928194,1.62166,2674,9930869,1,9928194,1,0
IV,-,9884256,0.00201613,0.0,496,495,1,1,2,gene,F32B6.3,0,9884253,0.497901,2866,9887122,3,9884253,3,0
IV,-,9851220,0.0,0.0078125,7,7,0,0,1,gene,K07F5.9,0,9851199,2.14219,30860,9882080,21,9851043,177,156
IV,-,9851122,0.0769231,0.00158691,13,12,1,1,2,gene,K07F5.9,0,9851004,2.14219,30958,9882080,118,9851034,88,-30
IV,-,9840780,0.0,0.5,1,1,0,0,0,gene,K07F5.4,0,9840773,0.0665736,4181,9844961,7,9840780,0,-7
IV,-,9824606,0.0126582,3.36312e-44,158,156,2,2,0,gene,W08D2.5,0,9824554,0.684101,11402,9836008,52,9824606,0,-52
IV,-,9815500,0.00454545,0.0,220,219,1,0,1,gene,W08D2.1,0,9815495,0.379923,1885,9817385,5,9815500,0,-5
IV,-,9810707,0.0,1.52588e-05,16,16,0,0,1,gene,W08D2.3,0,9810681,0.0616166,1621,9812328,26,9810707,0,-26
IV,-,9797328,0.00273224,0.0,1464,1460,4,4,1,gene,T13F2.2,1,9797326,2.36909,9054,9806382,2,9797328,0,-2
IV,-,9796566,0.940722,0.0,388,23,365,234,0,gene,T13F2.3,2,9796563,0.904354,96,9796662,3,9796563,3,0
IV,-,9784658,0.0,0.000244141,12,12,0,0,2,gene,T13F2.5,0,9784652,0.222025,7256,9791914,6,9784652,6,0
IV,-,9777608,0.0043573,0.0,459,457,2,2,35,gene,T13F2.7,0,9777600,0.678344,3326,9780934,8,9777608,0,-8
IV,-,9740870,0.00440852,0.0,2722,2710,12,12,11,gene,C28D4.3,0,9740829,4.38359,975,9741845,41,9740870,0,-41
IV,-,9733917,0.0,0.25,2,2,0,0,0,gene,C28D4.2,0,9733903,0.589243,5314,9739231,14,9733903,14,0
IV,-,9733903,0.00165017,0.0,606,605,1,1,4,gene,C28D4.2,0,9733903,0.589243,5328,9739231,0,9733903,0,0
IV,-,9709286,0.0,2.38419e-07,22,22,0,0,2,gene,K01H12.2,0,9709235,0.234159,22423,9731709,51,9709279,7,-44
IV,-,9706700,0.00512821,0.0,195,194,1,1,3,gene,ZK1251.9,0,9706695,0.469294,1450,9708150,5,9706695,5,0
IV,-,9687709,0.0,0.5,1,1,0,0,0,gene,ZK1251.5,0,9687694,None,9255,9696964,15,9688187,-478,-493
IV,-,9680726,0.0,0.03125,5,5,0,0,0,gene,ZK1251.11,0,9680726,0.00988905,1262,9681988,0,9680726,0,0
IV,-,9675649,0.0,0.0,180,180,0,0,0,gene,F58G6.5,0,9675633,0.563448,4713,9680362,16,9675649,0,-16
IV,-,9672647,0.0,0.0625,4,4,0,0,1,gene,F58G6.5,0,9672638,0.563448,7715,9680362,9,9672647,0,-9
IV,-,9669281,0.0,6.16298e-33,107,107,0,0,2,gene,F58G6.5,0,9669172,0.563448,11081,9680362,109,9669281,0,-109
IV,-,9647674,0.00154083,0.0,649,648,1,1,10,gene,F58G6.1,0,9647668,1.03408,16665,9664339,6,9647674,0,-6
IV,-,9642000,0.0,0.015625,6,6,0,0,1,gene,F58G6.6,0,9642000,0.0604725,2198,9644198,0,9641980,20,20
IV,-,9634925,0.0,0.0,536,536,0,0,0,gene,W09C2.3,0,9634846,1.58078,1992,9636917,79,9634925,0,-79
IV,-,9632101,0.0,0.125,3,3,0,0,4,gene,W09C2.3,0,9632027,1.58078,4816,9636917,74,9632088,13,-61
IV,-,9632088,0.0,1.57772e-30,99,99,0,0,8,gene,W09C2.3,0,9632027,1.58078,4829,9636917,61,9632088,0,-61
IV,-,9624816,0.0,0.25,2,2,0,0,0,gene,W09C2.8,0,9624760,None,1071,9625887,56,9624369,447,391
IV,-,9601672,0.0327869,7.93636e-16,61,59,2,1,0,gene,F27C8.1,0,9601671,0.406957,20257,9621929,1,9601672,0,-1
IV,-,9588811,0.00832266,0.0,1562,1549,13,13,0,gene,F27C8.6,0,9588754,2.47777,959,9589770,57,9588811,0,-57
IV,-,9580196,0.0,0.5,1,1,0,0,0,gene,T05A1.1,0,9580029,0.15305,6854,9587050,167,9580045,151,-16
IV,-,9580098,0.0,3.05176e-05,15,15,0,0,0,gene,T05A1.1,0,9580029,0.15305,6952,9587050,69,9580045,53,-16
IV,-,9576460,0.0,0.000976562,10,10,0,0,0,gene,T05A1.1,0,9576448,0.15305,10590,9587050,12,9576460,0,-12
IV,-,9571926,0.0,0.03125,5,5,0,0,2,gene,T05A1.1,0,9571926,0.15305,15124,9587050,0,9571926,0,0
IV,-,9566627,0.0,3.30872e-24,78,78,0,0,0,gene,T05A1.3,0,9566589,0.0854279,2179,9568806,38,9566582,45,7
IV,-,9533148,0.0,2.35099e-38,125,125,0,0,3,gene,F56H11.2,0,9533130,0.400796,27614,9560762,18,9533118,30,12
IV,-,9532235,0.0,0.5,1,1,0,0,2,gene,F56H11.2,0,9532235,0.400796,28527,9560762,0,9532235,0,0
IV,-,9524870,0.00956768,0.0,2822,2795,27,25,1,gene,C33A12.1,0,9524867,5.25337,3462,9528332,3,9524872,-2,-5
IV,-,9518902,0.0034965,0.0,286,285,1,0,1,gene,C33A12.2,0,9518877,0.734269,4844,9523746,25,9518904,-2,-27
IV,-,9512979,0.00708661,0.0,1270,1261,9,7,61,gene,C33A12.3,0,9512970,1.46293,4585,9517564,9,9512979,0,-9
IV,-,9512972,0.0,4.65661e-10,31,31,0,0,488,gene,C33A12.3,0,9512970,1.46293,4592,9517564,2,9512979,-7,-9
IV,-,9510585,0.0,0.015625,6,6,0,0,5,gene,C33A12.4,0,9510524,3.54168,136,9510721,61,9510571,14,-47
IV,-,9477212,0.0,0.00195312,9,9,0,0,8,gene,F38E11.7,0,9477177,0.17184,287,9477499,35,9477323,-111,-146
IV,-,9467495,0.0,9.53674e-07,20,20,0,0,0,gene,F38E11.6,0,9467464,0.0568882,6145,9473640,31,9467495,0,-31
IV,-,9457443,0.0,0.5,1,1,0,0,0,gene,F38E11.4,0,9457315,0.0355822,6482,9463925,128,9457478,-35,-163
IV,-,9447074,0.0,0.00390625,8,8,0,0,0,gene,F38E11.2,0,9447068,8.53406,2227,9449301,6,9446957,117,111
IV,-,9446887,0.00177242,0.0,2821,2816,5,2,129,gene,F38E11.2,0,9446861,8.53406,2414,9449301,26,9446886,1,-25
IV,-,9444011,0.0,4.76837e-07,21,21,0,0,10,gene,F38E11.9,0,9444009,0.206551,756,9444767,2,9444023,-12,-14
IV,-,9440764,0.00260417,0.0,5376,5362,14,11,11,gene,F59B8.2,0,9440742,11.2852,2120,9442884,22,9440765,-1,-23
IV,-,9408098,0.0,1.61559e-27,89,89,0,0,2,gene,F56D5.5,0,9408081,0.153191,11160,9419258,17,9408081,17,0
IV,-,9403845,0.0,0.00390625,8,8,0,0,0,gene,F56D5.4,0,9403842,None,3347,9407192,3,9404015,-170,-173
IV,-,9403555,0.0,0.5,1,1,0,0,30,gene,F56D5.4,0,9403555,None,3637,9407192,0,9404015,-460,-460
IV,-,9396195,0.0,2.11758e-22,72,72,0,0,1,gene,F56D5.1,0,9396187,1.42963,650,9396845,8,9396195,0,-8
IV,-,9366481,0.00625,0.0,160,159,1,1,0,gene,C10C5.1,0,9366475,0.604101,28442,9394923,6,9366483,-2,-8
IV,-,9343127,0.572581,0.000190995,496,212,284,230,4,gene,T20D3.8,2,9343124,0.964984,212,9343339,3,9343111,16,13
IV,-,9341772,0.8,0.0439453,10,2,8,6,1,gene,T20D3.7,3,9341767,0.918755,230,9342002,5,9341767,5,0
IV,-,9341626,0.0575673,0.0,1077,1015,62,52,17,gene,T20D3.7,3,9341611,0.918755,376,9342002,15,9341611,15,0
IV,-,9339282,0.990868,0.0,1095,10,1085,644,8,gene,T20D3.6,4,9339275,1.3056,98,9339380,7,9339282,0,-7
IV,-,9336488,0.0,0.03125,5,5,0,0,0,gene,T20D3.3,0,9336216,1.08615,2075,9338563,272,9335886,602,330
IV,-,9335868,0.00840336,0.0,714,708,6,5,252,gene,T20D3.3,0,9335864,1.08615,2695,9338563,4,9335868,0,-4
IV,-,9335709,0.0,0.5,1,1,0,0,0,gene,T20D3.3,0,9335666,1.08615,2854,9338563,43,9335709,0,-43
IV,-,9330832,0.00160138,0.0,8118,8105,13,10,0,gene,T20D3.2,0,9330829,11.0333,2557,9333389,3,9330832,0,-3
IV,-,9321066,0.00619195,0.0,2261,2247,14,12,1,gene,F49C12.12,0,9321061,10.0465,1400,9322466,5,9321066,0,-5
IV,-,9311134,0.0,0.0,199,199,0,0,7,gene,F49C12.7,0,9311115,0.708623,3661,9314795,19,9311134,0,-19
IV,-,9299229,0.0,0.25,2,2,0,0,0,gene,F49C12.2,0,9299197,0.00150647,3411,9302640,32,9299222,7,-25
IV,-,9266540,0.0,2.38419e-07,22,22,0,0,2,gene,Y11D7A.19,0,9266539,None,18328,9284868,1,9266539,1,0
IV,-,9264240,0.00763359,0.0,393,390,3,3,15,gene,Y11D7A.12,0,9264208,1.28897,1457,9265697,32,9264240,0,-32
IV,-,9261809,0.0,0.5,1,1,0,0,21,gene,Y11D7A.11,0,9261776,1.72474,183,9261992,33,9261744,65,32
IV,-,9259741,0.00454181,0.0,3743,3726,17,11,8,gene,Y11D7A.10,0,9259737,6.99299,822,9260563,4,9259751,-10,-14
IV,-,9256094,0.0,0.0,1008,1008,0,0,2,gene,Y11D7A.9,0,9256076,0.676569,2796,9258890,18,9256076,18,0
IV,-,9245378,0.0,4.65661e-10,31,31,0,0,111,gene,Y11D7A.5,0,9245364,0.680998,2475,9247853,14,9245501,-123,-137
IV,-,9245318,0.0,0.0625,4,4,0,0,53,gene,Y11D7A.5,0,9245273,0.680998,2535,9247853,45,9245501,-183,-228
IV,-,9245291,0.0,0.125,3,3,0,0,67,gene,Y11D7A.5,0,9245273,0.680998,2562,9247853,18,9245501,-210,-228
IV,-,9243988,0.0144928,1.16891e-19,69,68,1,1,0,gene,Y11D7A.4,0,9243977,0.179034,508,9244496,11,9243977,11,0
IV,-,9165107,0.0,0.0,211,211,0,0,0,gene,F23B2.12,0,9165102,0.489638,26511,9191618,5,9165107,0,-5
IV,-,9158999,0.0,2.24208e-44,145,145,0,0,0,gene,F23B2.11,0,9158995,1.15429,1617,9160616,4,9158999,0,-4
IV,-,9146905,0.03125,7.45058e-09,32,31,1,1,0,gene,F23B2.13,0,9146849,10.877,5841,9152746,56,9147012,-107,-163
IV,-,9146850,0.00705533,0.0,2693,2674,19,17,176,gene,F23B2.13,0,9146849,10.877,5896,9152746,1,9147012,-162,-163
IV,-,9135465,0.0,0.015625,6,6,0,0,0,gene,F23B2.3,0,9135458,0.000355632,1463,9136928,7,9135458,7,0
IV,-,9104171,0.00578035,0.0,173,172,1,1,8,gene,C01F6.3,0,9104113,None,1996,9106167,58,9103831,340,282
IV,-,9103692,1.0,0.0078125,7,0,7,5,1,gene,C01F6.3,0,9103620,None,164,9103856,72,9103831,-139,-211
IV,-,9096211,0.00679777,0.0,4119,4091,28,25,21,gene,C01F6.9,1,9096209,8.57296,5450,9101661,2,9096210,1,-1
IV,-,9095633,0.95794,0.0,1165,49,1116,759,210,gene,C01F6.8,2,9095625,1.81983,101,9095734,8,9095633,0,-8
IV,-,9094457,0.90566,3.92625e-19,106,10,96,71,4,gene,ZC410.7,3,9094432,1.20803,69,9094526,25,9094436,21,-4
IV,-,9094436,0.949095,0.0,884,45,839,508,373,gene,ZC410.7,3,9094432,1.20803,90,9094526,4,9094436,0,-4
IV,-,9078321,0.0,0.25,2,2,0,0,45,gene,ZC410.3,0,9078246,0.411088,13850,9092171,75,9078577,-256,-331
IV,-,9040451,0.222222,0.0703125,9,7,2,0,377,gene,Y73F4A.3,0,9040440,0.746869,1929,9042380,11,9040473,-22,-33
IV,-,9037143,0.0,0.0,414,414,0,0,0,gene,C53D6.7,0,9037142,0.515378,2412,9039555,1,9037142,1,0
IV,-,9031635,0.0,3.8147e-06,18,18,0,0,2,gene,C53D6.6,0,9031626,0.222021,1937,9033572,9,9031635,0,-9
IV,-,9020920,0.00162338,0.0,1232,1230,2,2,2,gene,C53D6.4,0,9020915,0.429752,489,9021409,5,9020915,5,0
IV,-,9020854,0.153846,0.00952148,13,11,2,2,177,gene,C53D6.4,0,9020803,0.429752,555,9021409,51,9020915,-61,-112
IV,-,9005390,0.0,2.46519e-32,105,105,0,0,2,gene,C53D6.2,0,9005365,0.542401,13762,9019152,25,9005390,0,-25
IV,-,8973296,0.0,2.22045e-16,52,52,0,0,15,gene,C53B4.3,0,8973286,0.423102,5610,8978906,10,8973296,0,-10
IV,-,8926058,0.0,0.00390625,8,8,0,0,19,gene,D1046.2,0,8926041,0.726996,33515,8959573,17,8926049,9,-8
IV,-,8926049,0.0,0.0,156,156,0,0,109,gene,D1046.2,0,8926041,0.726996,33524,8959573,8,8926049,0,-8
IV,-,8918872,0.0509344,0.0,2729,2590,139,121,2,gene,C27B7.8,0,8918756,3.23031,5270,8924142,116,8918872,0,-116
IV,-,8873039,0.0,9.53674e-07,20,20,0,0,0,gene,C09G9.3,0,8872987,0.00889747,4443,8877482,52,8872987,52,0
IV,-,8869661,0.0,0.0,550,550,0,0,8,gene,C09G9.2,1,8869651,0.864071,284,8869945,10,8869651,10,0
IV,-,8865465,0.260457,0.0,1793,1326,467,375,4,gene,C09G9.1,2,8865272,1.78635,2552,8868017,193,8865465,0,-193
IV,-,8865170,0.0,0.5,1,1,0,0,1,gene,C09G9.1,2,8865028,1.78635,2847,8868017,142,8865170,0,-142
IV,-,8856045,0.0,0.0,327,327,0,0,0,gene,T11B7.5,0,8856045,1.06819,6066,8862111,0,8856045,0,0
IV,-,8844463,0.0,3.72529e-09,28,28,0,0,682,gene,T11B7.2,0,8844449,0.722488,1466,8845929,14,8844486,-23,-37
IV,-,8830684,0.0,0.0,276,276,0,0,38,gene,T28C6.8,0,8830572,0.794046,8854,8839538,112,8830668,16,-96
IV,-,8830444,0.0,5.82077e-11,34,34,0,0,1,gene,T28C6.8,0,8830444,0.794046,9094,8839538,0,8830444,0,0
IV,-,8804839,0.0,0.0,195,195,0,0,0,gene,C33D9.1,0,8804786,0.355396,11601,8816440,53,8804839,0,-53
IV,-,8792884,0.0,2.35099e-38,125,125,0,0,0,gene,C33D9.3,0,8792884,0.380607,3977,8796861,0,8792884,0,0
IV,-,8792758,0.0,0.5,1,1,0,0,25,gene,C33D9.3,0,8792667,0.380607,4103,8796861,91,8792884,-126,-217
IV,-,8786640,0.0,0.0078125,7,7,0,0,1,gene,C33D9.8,0,8786632,0.162994,759,8787399,8,8786632,8,0
IV,-,8784840,0.0,3.72529e-09,28,28,0,0,2,gene,C33D9.13,0,8784836,None,692,8785532,4,8784840,0,-4
IV,-,8780867,0.0,1.00974e-28,93,93,0,0,27,gene,C33D9.5,1,8780854,0.200935,2386,8783253,13,8780854,13,0
IV,-,8780618,0.0,0.000244141,12,12,0,0,61,gene,C33D9.5,1,8780529,0.200935,2635,8783253,89,8780854,-236,-325
IV,-,8778127,0.776398,3.70802e-13,161,36,125,36,0,gene,C33D9.6,2,8778088,0.452196,213,8778340,39,8778127,0,-39
IV,-,8775299,0.826667,3.35108e-09,75,13,62,17,19,gene,C33D9.9,3,8775256,0.223512,108,8775407,43,8775299,0,-43
IV,-,8773188,0.969298,0.0,228,7,221,108,3,gene,F20C5.6,4,8773170,0.901602,94,8773282,18,8773186,2,-16
IV,-,8770102,0.705882,0.0472107,17,5,12,4,1,gene,F20C5.5,5,8770098,0.0448422,1437,8771539,4,8770098,4,0
IV,-,8762062,0.0,0.125,3,3,0,0,1,gene,F20C5.2,0,8762035,0.425508,5579,8767641,27,8762039,23,-4
IV,-,8762056,0.0,6.31089e-30,97,97,0,0,1,gene,F20C5.2,0,8762035,0.425508,5585,8767641,21,8762039,17,-4
IV,-,8757635,0.0166667,5.20417e-17,60,59,1,1,3,gene,F20C5.2,0,8757498,0.425508,10006,8767641,137,8757498,137,0
IV,-,8757629,0.0,0.25,2,2,0,0,49,gene,F20C5.2,0,8757498,0.425508,10012,8767641,131,8757498,131,0
IV,-,8754803,0.130435,0.00021112,23,20,3,1,0,gene,F20C5.3,0,8754794,1.11845,225,8755028,9,8754794,9,0
IV,-,8743686,0.0121359,0.0,412,407,5,5,2,gene,F21D5.7,1,8743680,2.07021,705,8744391,6,8743686,0,-6
IV,-,8741370,0.989362,0.0,470,5,465,318,9,gene,F21D5.6,2,8741363,0.92978,1,8741371,7,8741370,0,-7
IV,-,8740008,0.895238,0.0,735,77,658,494,0,gene,F21D5.8,3,8740008,2.70329,114,8740122,0,8740008,0,0
IV,-,8739376,0.949091,0.0,275,14,261,178,4,gene,F21D5.5,4,8739356,0.680977,106,8739482,20,8739376,0,-20
IV,-,8739366,1.0,0.0078125,7,0,7,1,640,gene,F21D5.5,4,8739356,0.680977,116,8739482,10,8739376,-10,-20
IV,-,8691495,0.0294118,3.38619e-26,102,99,3,3,1,gene,F08B4.6,1,8691491,0.382751,11367,8702862,4,8691495,0,-4
IV,-,8687792,0.0578292,0.0,2248,2118,130,90,5,gene,F08B4.7,2,8687791,3.427,472,8688264,1,8687792,0,-1
IV,-,8686619,1.0,0.015625,6,0,6,2,0,gene,F08B4.5,3,8686592,0.634015,119,8686738,27,8686593,26,-1
IV,-,8686592,0.932836,0.0,268,18,250,181,2,gene,F08B4.5,3,8686592,0.634015,146,8686738,0,8686593,-1,-1
IV,-,8679307,0.0666667,4.05125e-07,30,28,2,1,0,gene,F08B4.4,0,8679288,0.0558023,2918,8682225,19,8679288,19,0
IV,-,8653652,0.0,3.63798e-12,38,38,0,0,449,gene,C49C8.5,0,8653640,1.33673,3763,8657415,12,8653646,6,-6
IV,-,8653646,0.0,2.77556e-17,55,55,0,0,584,gene,C49C8.5,0,8653640,1.33673,3769,8657415,6,8653646,0,-6
IV,-,8648163,0.0,4.33681e-19,61,61,0,0,1,gene,C49C8.4,0,8648162,0.177188,485,8648648,1,8648163,0,-1
IV,-,8638849,0.0,8.88178e-16,50,50,0,0,0,gene,F42A9.9,0,8638843,0.0239898,6664,8645513,6,8638843,6,0
IV,-,8618768,0.00558659,0.0,1074,1068,6,6,18,gene,F42A9.8,0,8618761,1.56653,10126,8628894,7,8618761,7,0
IV,-,8600727,0.0,1.38778e-17,56,56,0,0,3,gene,Y59H11AR.4,0,8600724,0.138973,10821,8611548,3,8600724,3,0
IV,-,8510531,0.019084,0.0,262,257,5,4,37,gene,C28C12.10,0,8510522,0.40068,52924,8563455,9,8510467,64,55
IV,-,8498836,0.0,0.0078125,7,7,0,0,5,gene,C28C12.9,1,8498805,0.54675,2161,8500997,31,8498805,31,0
IV,-,8498805,0.0,2.84217e-14,45,45,0,0,346,gene,C28C12.9,1,8498805,0.54675,2192,8500997,0,8498805,0,0
IV,-,8496345,0.931507,7.14662e-44,219,15,204,164,30,gene,C28C12.12,2,8496341,0.623159,121,8496466,4,8496345,0,-4
IV,-,8472575,0.0163934,2.64545e-17,61,60,1,0,1,gene,T01B11.7,0,8472571,0.267636,6002,8478577,4,8472575,0,-4
IV,-,8472519,0.0,0.5,1,1,0,0,2,gene,T01B11.7,0,8472519,0.267636,6058,8478577,0,8472575,-56,-56
IV,-,8463798,0.0,0.0,226,226,0,0,1,gene,T01B11.5,0,8463796,None,939,8464737,2,8463796,2,0
IV,-,8451741,0.00162866,0.0,614,613,1,1,1,gene,T01B11.2,0,8451734,1.32648,7419,8459160,7,8451741,0,-7
IV,-,8431475,0.00496689,0.0,604,601,3,3,1,gene,T26A8.4,0,8431472,1.36768,17874,8449349,3,8431475,0,-3
IV,-,8421043,0.0121951,1.69572e-23,82,81,1,1,0,gene,M116.5,0,8421003,0.158621,4008,8425051,40,8421045,-2,-42
IV,-,8382777,0.00542495,0.0,553,550,3,1,5,gene,D2096.9,0,8382774,1.13049,4831,8387608,3,8382787,-10,-13
IV,-,8379301,0.00269823,0.0,11489,11458,31,27,8,gene,D2096.8,1,8379293,19.5369,2577,8381878,8,8379301,0,-8
IV,-,8377680,0.931818,1.75107e-18,88,6,82,53,1,gene,D2096.7,2,8377612,0.460325,6,8377686,68,8377612,68,0
IV,-,8377644,0.9,4.34235e-11,60,6,54,42,49,gene,D2096.7,2,8377612,0.460325,42,8377686,32,8377612,32,0
IV,-,8369217,0.00468019,0.0,641,638,3,3,2,gene,D2096.6,0,8369204,0.943985,6479,8375696,13,8369204,13,0
IV,-,8359667,1.0,0.5,1,0,1,0,23,gene,D2096.5,0,8359607,0.0989544,8656,8368323,60,8359698,-31,-91
IV,-,8358437,0.0,0.5,1,1,0,0,17,gene,D2096.13,0,8358415,0.118437,672,8359109,22,8358574,-137,-159
IV,-,8313351,0.0,0.25,2,2,0,0,0,gene,F35H10.10,0,8313239,1.41717,17675,8331026,112,8312928,423,311
IV,-,8312928,0.00258398,0.0,387,386,1,1,0,gene,F35H10.10,0,8312926,1.41717,18098,8331026,2,8312928,0,-2
IV,-,8289511,0.0180879,0.0,1161,1140,21,19,1,gene,K07H8.10,1,8289500,4.75182,11452,8300963,11,8289511,0,-11
IV,-,8286458,0.931624,4.1042e-24,117,8,109,94,3,gene,K07H8.9,2,8286457,0.452063,110,8286568,1,8286415,43,42
IV,-,8286434,0.0,0.5,1,1,0,0,485,gene,K07H8.9,2,8286360,0.452063,134,8286568,74,8286415,19,-55
IV,-,8276691,0.0,1.88079e-37,122,122,0,0,0,gene,K07H8.12,0,8276653,0.445983,8466,8285157,38,8276641,50,12
IV,-,8236583,0.00498753,0.0,401,399,2,2,0,gene,T09A12.4,0,8236563,0.791917,22597,8259180,20,8236583,0,-20
IV,-,8236572,0.0192308,6.7949e-42,156,153,3,3,590,gene,T09A12.4,0,8236563,0.791917,22608,8259180,9,8236583,-11,-20
IV,-,8236184,0.0,0.015625,6,6,0,0,0,gene,T09A12.4,0,8236113,0.791917,22996,8259180,71,8236184,0,-71
IV,-,8235890,0.0769231,0.00158691,13,12,1,1,16,gene,T09A12.4,0,8235747,0.791917,23290,8259180,143,8235890,0,-143
IV,-,8231817,0.0,1.77636e-15,49,49,0,0,1,gene,T09A12.4,0,8231678,0.791917,27363,8259180,139,8231817,0,-139
IV,-,8231737,0.0,0.0078125,7,7,0,0,146,gene,T09A12.4,0,8231678,0.791917,27443,8259180,59,8231817,-80,-139
IV,-,8229501,0.0,0.25,2,2,0,0,14,gene,T09A12.4,0,8229424,0.791917,29679,8259180,77,8229483,18,-59
IV,-,8229380,0.0,0.125,3,3,0,0,9,gene,T09A12.4,0,8229335,0.791917,29800,8259180,45,8229483,-103,-148
IV,-,8220062,0.0,0.00390625,8,8,0,0,0,gene,T09A12.3,0,8220017,0.0413842,6256,8226318,45,8220017,45,0
IV,-,8211822,0.0,0.00012207,13,13,0,0,2,gene,C07G1.7,0,8211809,0.0167051,1964,8213786,13,8211809,13,0
IV,-,8205046,0.00527705,0.0,379,377,2,2,3,gene,C07G1.5,1,8205037,1.68247,4093,8209139,9,8205046,0,-9
IV,-,8201214,0.783851,0.0,805,174,631,394,0,gene,C07G1.8,2,8201209,1.8005,145,8201359,5,8201209,5,0
IV,-,8198932,0.458333,0.0343965,168,91,77,48,0,gene,C07G1.4,3,8198908,0.966054,1617,8200549,24,8198932,0,-24
IV,-,8193170,0.0,2.38419e-07,22,22,0,0,1,gene,C07G1.4,3,8193133,0.966054,7379,8200549,37,8193133,37,0
IV,-,8136036,0.00595871,0.0,4699,4671,28,21,0,gene,F42G8.12,0,8136021,13.5921,7431,8143467,15,8136036,0,-15
IV,-,8133536,0.00617284,0.0,324,322,2,2,12,gene,F42G8.11,0,8133528,0.564847,342,8133878,8,8133673,-137,-145
IV,-,8130212,0.013834,0.0,2024,1996,28,20,15,gene,F42G8.10,0,8130212,5.28192,1939,8132151,0,8130212,0,0
IV,-,8112199,0.00735294,1.5612e-39,136,135,1,0,7,gene,Y42H9AR.4,1,8112186,0.652724,16722,8128921,13,8112206,-7,-20
IV,-,8107581,0.85,1.99849e-13,100,15,85,55,2,gene,Y42H9AR.3,2,8107579,0.249186,166,8107747,2,8107579,2,0
IV,-,8086633,0.0192308,2.64071e-28,104,102,2,1,6,gene,C18F3.4,0,8086632,0.643441,17703,8104336,1,8086633,0,-1
IV,-,8029495,0.00245098,0.0,408,407,1,0,2,gene,C26B2.3,0,8029404,1.29627,220,8029715,91,8029495,0,-91
IV,-,8029418,0.0,7.62939e-06,17,17,0,0,48,gene,C26B2.3,0,8029404,1.29627,297,8029715,14,8029418,0,-14
IV,-,8026019,0.0,0.0,231,231,0,0,0,gene,C26B2.3,0,8026012,1.29627,3696,8029715,7,8026019,0,-7
IV,-,8019790,0.0,0.0,223,223,0,0,0,gene,C26B2.1,0,8019770,0.529983,1355,8021145,20,8019790,0,-20
IV,-,8012486,0.0,0.5,1,1,0,0,0,gene,Y42H9B.3,0,8012479,0.867155,5634,8018120,7,8012412,74,67
IV,-,8012412,0.0107914,0.0,556,550,6,5,4,gene,Y42H9B.3,0,8012409,0.867155,5708,8018120,3,8012412,0,-3
IV,-,8004102,0.0182482,0.0,274,269,5,4,6,gene,Y42H9B.2,0,8004038,0.87133,6908,8011010,64,8004104,-2,-66
IV,-,7946575,0.00816326,0.0,245,243,2,2,5,gene,F20D12.4,0,7946558,1.35351,6917,7953492,17,7946575,0,-17
IV,-,7940799,0.0117188,0.0,256,253,3,1,11,gene,F20D12.5,0,7940789,2.18633,2798,7943597,10,7940833,-34,-44
IV,-,7938923,0.25,0.25,4,3,1,0,0,gene,F20D12.7,0,7938917,0.0150156,869,7939792,6,7938917,6,0
IV,-,7926374,0.00185924,0.0,18287,18253,34,29,0,gene,C49H3.11,0,7926354,75.5294,359,7926733,20,7926375,-1,-21
IV,-,7926368,0.00289855,0.0,345,344,1,1,359,gene,C49H3.11,0,7926354,75.5294,365,7926733,14,7926368,0,-14
IV,-,7924110,0.0193133,0.0,466,457,9,7,0,gene,C49H3.10,0,7924049,0.740277,1169,7925279,61,7924110,0,-61
IV,-,7909451,0.0176056,0.0,284,279,5,5,1,gene,C49H3.9,0,7909433,1.22248,7245,7916696,18,7909457,-6,-24
IV,-,7902473,0.0162162,0.0,370,364,6,5,0,gene,C49H3.8,0,7902338,0.687378,4603,7907076,135,7902254,219,84
IV,-,7897526,0.0107914,0.0,278,275,3,3,1,gene,C55F2.2,0,7897237,0.598702,2666,7900192,289,7897526,0,-289
IV,-,7834669,0.0,0.03125,5,5,0,0,0,gene,C06A6.5,0,7834655,2.12246,2570,7837239,14,7834658,11,-3
IV,-,7834658,0.00528169,0.0,568,565,3,2,7,gene,C06A6.5,0,7834655,2.12246,2581,7837239,3,7834658,0,-3
IV,-,7829274,0.0,0.0,936,936,0,0,1,gene,C06A6.4,0,7829271,1.6719,3049,7832323,3,7829274,0,-3
IV,-,7822597,0.0,0.0,1825,1825,0,0,2,gene,T14A8.2,0,7822596,5.60244,3719,7826316,1,7822668,-71,-72
IV,-,7822547,0.0,0.25,2,2,0,0,308,gene,T14A8.2,0,7822469,5.60244,3769,7826316,78,7822668,-121,-199
IV,-,7815716,0.00842105,0.0,475,471,4,3,0,gene,C33H5.18,1,7815716,1.02517,5938,7821654,0,7815716,0,0
IV,-,7812792,0.967213,7.93636e-16,61,2,59,39,2,gene,C33H5.17,2,7812792,0.274176,99,7812891,0,7812792,0,0
IV,-,7812678,1.0,0.5,1,0,1,1,24,gene,C33H5.17,2,7812663,0.274176,69,7812747,15,7812792,-114,-129
IV,-,7796359,0.0126582,3.36312e-44,158,156,2,2,0,gene,C33H5.15,1,7796249,0.53004,5449,7801808,110,7796287,72,-38
IV,-,7794800,1.0,0.5,1,0,1,1,0,gene,C33H5.14,2,7794736,0.589842,54,7794854,64,7794792,8,-56
IV,-,7794641,0.955665,0.0,203,9,194,173,65,gene,C33H5.14,2,7794634,0.589842,213,7794854,7,7794641,0,-7
IV,-,7792272,1.0,0.5,1,0,1,1,11,gene,C33H5.13,0,7792272,5.66664,59,7792331,0,7792208,64,64
IV,-,7792184,0.333333,0.12085,12,8,4,4,765,gene,C33H5.13,0,7792175,5.66664,147,7792331,9,7792208,-24,-33
IV,-,7791212,0.0165899,0.0,1085,1067,18,16,8,gene,C33H5.12,1,7791211,7.12962,476,7791688,1,7791212,0,-1
IV,-,7789450,0.5,0.0604006,174,87,87,73,68,gene,C33H5.11,2,7789430,0.950942,378,7789828,20,7789450,0,-20
IV,-,7789445,0.440298,0.0265975,134,75,59,36,171,gene,C33H5.11,2,7789430,0.950942,383,7789828,15,7789445,0,-15
IV,-,7785539,0.0823529,0.0,425,390,35,34,7,gene,C33H5.10,3,7785537,0.743794,444,7785983,2,7785539,0,-2
IV,-,7783834,0.675351,9.2603e-16,499,162,337,237,21,gene,C33H5.19,4,7783808,0.754135,101,7783935,26,7783834,0,-26
IV,-,7782482,0.946524,5.75065e-41,187,10,177,111,0,gene,C33H5.9,5,7782482,0.58033,96,7782578,0,7782482,0,0
IV,-,7778948,0.935743,0.0,249,16,233,154,2,gene,C33H5.8,6,7778946,0.625924,414,7779362,2,7778946,2,0
IV,-,7774258,0.0084317,0.0,593,588,5,4,14,gene,C46A5.9,0,7774253,1.65554,3658,7777916,5,7774253,5,0
IV,-,7770245,0.0,0.0625,4,4,0,0,0,gene,C46A5.8,0,7770238,0.087323,503,7770748,7,7770008,237,230
IV,-,7770014,0.05,1.90735e-05,20,19,1,1,0,gene,C46A5.8,0,7770008,0.087323,734,7770748,6,7770008,6,0
IV,-,7763831,0.0230769,2.62841e-34,130,127,3,3,0,gene,C46A5.6,1,7763825,0.556592,4381,7768212,6,7763825,6,0
IV,-,7759610,0.939394,3.38215e-28,132,8,124,104,1,gene,C46A5.5,2,7759610,0.151397,373,7759983,0,7759610,0,0
IV,-,7723183,0.0,4.81482e-35,114,114,0,0,0,gene,C50F7.6,0,7723181,0.203665,7469,7730652,2,7723183,0,-2
IV,-,7717993,0.0,8.96831e-44,143,143,0,0,1,gene,F33D4.6,0,7717993,1.31572,2557,7720550,0,7717993,0,0
IV,-,7709720,0.00572246,0.0,699,695,4,4,2,gene,F33D4.7,1,7709712,1.91154,4428,7714148,8,7709714,6,-2
IV,-,7709068,0.950474,0.0,949,47,902,655,3,gene,F33D4.5,2,7709067,1.54439,54,7709122,1,7709068,0,-1
IV,-,7706888,0.62963,1.97447e-06,297,110,187,131,2,gene,F33D4.4,3,7706886,1.67587,671,7707559,2,7706888,0,-2
IV,-,7698404,0.0,5.55112e-17,54,54,0,0,4,gene,F33D4.3,0,7698352,0.902788,5452,7703856,52,7698352,52,0
IV,-,7698386,0.0,0.0,365,365,0,0,210,gene,F33D4.3,0,7698352,0.902788,5470,7703856,34,7698352,34,0
IV,-,7654246,0.0170068,0.0,294,289,5,4,48,gene,F45E4.10,1,7654235,0.726551,9914,7664160,11,7654198,48,37
IV,-,7646203,0.860104,0.0,579,81,498,378,0,gene,F45E4.9,2,7646202,1.37344,104,7646307,1,7646203,0,-1
IV,-,7643061,0.0,2.84217e-14,45,45,0,0,36,gene,F45E4.8,0,7643043,3.98825,1815,7644876,18,7643055,6,-12
IV,-,7643055,0.0967742,2.09315e-06,31,28,3,1,534,gene,F45E4.8,0,7643043,3.98825,1821,7644876,12,7643055,0,-12
IV,-,7641839,0.0,0.0078125,7,7,0,0,8,gene,F45E4.7,0,7641810,0.0819928,195,7642034,29,7641842,-3,-32
IV,-,7632089,0.0,0.5,1,1,0,0,0,gene,F45E4.6,0,7632016,0.116055,3557,7635646,73,7632150,-61,-134
IV,-,7580096,0.00812619,0.0,2092,2075,17,12,1,gene,F32E10.6,1,7580088,4.14939,48131,7628227,8,7580096,0,-8
IV,-,7578365,0.91,1.5006e-18,100,9,91,64,0,gene,F32E10.5,2,7578365,0.289658,118,7578483,0,7578365,0,0
IV,-,7561648,0.0226155,0.0,1017,994,23,18,2,gene,F32E10.4,0,7561644,5.38571,531,7562179,4,7561648,0,-4
IV,-,7556349,0.0,0.00390625,8,8,0,0,58,gene,F49E8.7,1,7556347,0.702544,2334,7558683,2,7556349,0,-2
IV,-,7554407,0.333333,0.375,3,2,1,1,97,gene,F49E8.6,2,7554229,0.540245,121,7554528,178,7554366,41,-137
IV,-,7552858,0.195434,0.0,1095,881,214,174,8,gene,F49E8.5,3,7552848,2.70349,301,7553159,10,7552858,0,-10
IV,-,7550796,0.923913,1.76918e-18,92,7,85,49,2,gene,F49E8.3,5,7550788,4.06817,535,7551331,8,7550788,8,0
IV,-,7550789,1.0,0.25,2,0,2,2,133,gene,F49E8.3,5,7550788,4.06817,542,7551331,1,7550788,1,0
IV,-,7547877,0.0,0.0,639,639,0,0,55,gene,F49E8.4,4,7547877,1.10552,3454,7551331,0,7547879,-2,-2
IV,-,7547101,0.00865052,0.0,578,573,5,4,3,gene,F49E8.3,5,7547100,4.06817,87,7547188,1,7547101,0,-1
IV,-,7520349,0.0273973,2.7825e-19,73,71,2,2,1,gene,R05G6.10,0,7520313,0.414345,8165,7528514,36,7520349,0,-36
IV,-,7512651,0.015625,2.3886e-35,128,126,2,2,1,gene,R05G6.8,0,7512645,0.672432,1697,7514348,6,7512657,-6,-12
IV,-,7507875,0.00307917,0.0,12341,12303,38,31,2,gene,R05G6.7,0,7507872,29.983,1632,7509507,3,7507875,0,-3
IV,-,7501286,0.0,0.0625,4,4,0,0,18,gene,F55G1.15,0,7501249,0.114436,5119,7506405,37,7501249,37,0
IV,-,7477281,0.00413223,0.0,242,241,1,1,4,gene,F55G1.9,0,7477273,0.392642,8537,7485818,8,7477328,-47,-55
IV,-,7473193,0.00314607,0.0,2225,2218,7,6,2,gene,F55G1.8,0,7473193,1.65245,2908,7476101,0,7473193,0,0
IV,-,7473187,0.0,0.0625,4,4,0,0,228,gene,F55G1.8,0,7473186,1.65245,2914,7476101,1,7473193,-6,-7
IV,-,7468377,0.04,7.45058e-07,25,24,1,1,0,gene,F55G1.7,0,7468371,0.194317,2466,7470843,6,7468446,-69,-75
IV,-,7465950,0.0,1.38778e-17,56,56,0,0,30,gene,F13B6.3,0,7465940,1.28236,737,7466687,10,7465941,9,-1
IV,-,7465941,0.024735,0.0,283,276,7,1,83,gene,F13B6.3,0,7465940,1.28236,746,7466687,1,7465941,0,-1
IV,-,7465875,0.0,0.0625,4,4,0,0,64,gene,F13B6.3,0,7465873,1.28236,812,7466687,2,7465941,-66,-68
IV,-,7460510,0.857143,0.0546875,7,1,6,1,2,gene,F13B6.2,0,7460482,0.217592,1437,7461947,28,7460802,-292,-320
IV,-,7451429,0.00258398,0.0,387,386,1,0,0,gene,B0496.8,0,7451427,0.333869,7391,7458820,2,7451429,0,-2
IV,-,7445318,0.0,0.0,410,410,0,0,513,gene,B0496.7,0,7445291,0.91841,3737,7449055,27,7445349,-31,-58
IV,-,7388927,0.0,0.0,423,423,0,0,0,gene,T12B3.4,0,7388910,0.96087,44601,7433528,17,7388922,5,-12
IV,-,7352446,0.0285714,1.01863e-09,35,34,1,0,0,gene,Y40C5A.4,0,7352442,0.234911,32294,7384740,4,7352446,0,-4
IV,-,7328970,0.0,7.62939e-06,17,17,0,0,15,gene,Y40C5A.1,0,7328944,0.489083,691,7329661,26,7329092,-122,-148
IV,-,7328959,0.00787402,7.46439e-37,127,126,1,0,24,gene,Y40C5A.1,0,7328944,0.489083,702,7329661,15,7329092,-133,-148
IV,-,7326647,0.00401606,0.0,249,248,1,1,2,gene,F42C5.10,0,7326646,1.39619,450,7327097,1,7326647,0,-1
IV,-,7317087,0.00624025,0.0,641,637,4,3,2,gene,F42C5.9,0,7317078,1.63005,3624,7320711,9,7317087,0,-9
IV,-,7313844,0.0066576,0.0,27938,27752,186,162,15,gene,F42C5.8,0,7313843,211.733,515,7314359,1,7313844,0,-1
IV,-,7310890,0.0,0.00390625,8,8,0,0,1,gene,F42C5.7,0,7310742,3.0954,2075,7312965,148,7310744,146,-2
IV,-,7310742,0.00165792,0.0,3619,3613,6,4,5,gene,F42C5.7,0,7310742,3.0954,2223,7312965,0,7310744,-2,-2
IV,-,7292279,0.0,0.5,1,1,0,0,1,gene,F42C5.4,1,7292273,0.203253,242,7292521,6,7292111,168,162
IV,-,7285855,0.428571,0.0945276,35,20,15,11,3,gene,C06E4.8,3,7285786,0.0888607,228,7286083,69,7285504,351,282
IV,-,7263221,0.0,1.16415e-10,33,33,0,0,0,gene,C06E4.7,0,7263220,0.0846604,20883,7284104,1,7263220,1,0
IV,-,7242254,0.0,0.0,301,301,0,0,0,gene,D2024.7,0,7242239,0.402335,3195,7245449,15,7242254,0,-15
IV,-,7230207,0.00265722,0.0,1129,1126,3,3,0,gene,D2024.6,1,7230206,2.3827,9933,7240140,1,7230207,0,-1
IV,-,7228290,0.856595,0.0,1304,187,1117,754,296,gene,D2024.5,2,7228290,1.32318,115,7228405,0,7228290,0,0
IV,-,7228238,0.0,0.5,1,1,0,0,188,gene,D2024.5,2,7228049,1.32318,167,7228405,189,7228290,-52,-241
IV,-,7219475,0.0,1.19209e-07,23,23,0,0,1,gene,R13A1.8,0,7219468,0.116412,5868,7225343,7,7219468,7,0
IV,-,7191822,0.0,3.00927e-36,118,118,0,0,0,gene,R13A1.5,0,7191792,0.169277,1574,7193396,30,7191824,-2,-32
IV,-,7187934,0.125,0.03125,8,7,1,0,17,gene,C42D4.13,0,7187881,0.283745,3181,7191115,53,7188094,-160,-213
IV,-,7165731,0.0165746,0.0,181,178,3,3,0,gene,C42D4.8,0,7165704,0.581712,4181,7169912,27,7165697,34,7
IV,-,7152482,0.00564972,0.0,354,352,2,0,1,gene,C34D4.15,0,7152473,1.04366,7630,7160112,9,7152473,9,0
IV,-,7144696,0.0153257,0.0,261,257,4,4,2,gene,C34D4.14,1,7144632,2.49695,5902,7150598,64,7144698,-2,-66
IV,-,7144551,0.0,0.000976562,10,10,0,0,0,gene,C34D4.14,1,7144547,2.49695,6047,7150598,4,7144551,0,-4
IV,-,7134066,0.796407,6.06762e-43,501,102,399,264,38,gene,C34D4.13,2,7134057,1.69591,264,7134330,9,7134057,9,0
IV,-,7133200,0.0587403,0.0,1413,1330,83,68,30,gene,C34D4.12,3,7133197,1.75282,230,7133430,3,7133197,3,0
IV,-,7121382,0.0,2.29589e-41,135,135,0,0,7,gene,C34D4.10,0,7121379,0.0799188,9237,7130619,3,7121396,-14,-17
IV,-,7103245,0.0109091,0.0,275,272,3,3,0,gene,ZC477.5,0,7103235,0.641383,7141,7110386,10,7103245,0,-10
IV,-,7094348,0.00298507,0.0,335,334,1,0,2,gene,ZC477.9,0,7094348,3.30876,4178,7098526,0,7094348,0,0
IV,-,7087891,0.0,7.45058e-09,27,27,0,0,2,gene,ZC477.9,0,7087884,3.30876,907,7088798,7,7087891,0,-7
IV,-,7084666,0.00158927,0.0,48450,48373,77,65,25,gene,Y43B11AR.4,0,7084645,119.567,540,7085206,21,7084666,0,-21
IV,-,7084660,0.00609756,0.0,164,163,1,1,1101,gene,Y43B11AR.4,0,7084645,119.567,546,7085206,15,7084666,-6,-21
IV,-,7044586,0.00695012,0.0,2446,2429,17,16,4,gene,C06G3.11,0,7044586,7.43957,8945,7053531,0,7044586,0,0
IV,-,7036843,0.950739,1.4013e-45,203,10,193,135,3,gene,C06G3.9,2,7036843,0.926652,98,7036941,0,7036843,0,0
IV,-,7032543,0.759825,1.68156e-44,687,165,522,397,2,gene,C06G3.8,3,7032543,0.959156,139,7032682,0,7032543,0,0
IV,-,6986919,0.0,3.08149e-33,108,108,0,0,0,gene,ZK381.5,0,6986919,0.495327,44361,7031280,0,6986919,0,0
IV,-,6977127,0.00277393,0.0,1442,1438,4,4,2,gene,ZK381.4,0,6977112,2.32151,1631,6978758,15,6977127,0,-15
IV,-,6972590,1.0,0.5,1,0,1,1,0,gene,ZK381.3,0,6972511,0.00207816,1812,6974402,79,6972511,79,0
IV,-,6931103,0.0,3.8147e-06,18,18,0,0,0,gene,T22D1.12,0,6931102,0.205587,32674,6963777,1,6931102,1,0
IV,-,6919409,0.0,0.0625,4,4,0,0,80,gene,T22D1.10,0,6919382,1.32264,312,6919721,27,6919390,19,-8
IV,-,6919390,0.00613497,0.0,489,486,3,2,196,gene,T22D1.10,0,6919382,1.32264,331,6919721,8,6919390,0,-8
IV,-,6909926,0.0,0.0625,4,4,0,0,1,gene,T22D1.9,0,6909888,2.91985,7171,6917097,38,6909897,29,-9
IV,-,6909897,0.00358138,0.0,2513,2504,9,9,19,gene,T22D1.9,0,6909888,2.91985,7200,6917097,9,6909897,0,-9
IV,-,6887635,0.00374532,0.0,534,532,2,2,0,gene,T05A12.3,1,6887632,0.729444,3870,6891505,3,6887635,0,-3
IV,-,6883445,0.953704,3.43491e-25,108,5,103,64,1,gene,T05A12.2,2,6883426,0.745922,112,6883557,19,6882929,516,497
IV,-,6879414,0.0,0.0,360,360,0,0,0,gene,T05A12.2,2,6879358,0.745922,4143,6883557,56,6879414,0,-56
IV,-,6850846,0.0,0.0625,4,4,0,0,2,gene,R13H7.2,0,6850825,0.133094,25869,6876715,21,6850846,0,-21
IV,-,6789623,0.00361011,0.0,277,276,1,1,3,gene,C17H12.2,1,6789605,0.551915,4277,6793900,18,6789605,18,0
IV,-,6784324,0.627586,2.38774e-08,435,162,273,208,3,gene,C17H12.1,2,6784323,1.46281,2449,6786773,1,6784324,0,-1
IV,-,6747450,0.0,3.8147e-06,18,18,0,0,0,gene,Y73B6A.5,1,6747388,1.02397,32306,6779756,62,6747442,8,-54
IV,-,6747442,0.003367,0.0,297,296,1,1,9,gene,Y73B6A.5,1,6747388,1.02397,32314,6779756,54,6747442,0,-54
IV,-,6742427,0.955882,9.02116e-32,136,6,130,97,0,gene,Y73B6A.4,2,6742414,0.291636,95,6742522,13,6742427,0,-13
IV,-,6740244,1.0,0.5,1,0,1,1,200,gene,Y73B6A.3,0,6740200,0.242798,239,6740483,44,6740266,-22,-66
IV,-,6631677,0.0,0.25,2,2,0,0,6,gene,C01B10.4,0,6631538,0.0850178,29500,6661177,139,6631729,-52,-191
IV,-,6621336,0.00392157,0.0,255,254,1,0,0,gene,C01B10.3,0,6621335,0.722883,3172,6624508,1,6621336,0,-1
IV,-,6618487,0.00479616,0.0,417,415,2,0,0,gene,C01B10.1,1,6618482,0.696087,964,6619451,5,6618482,5,0
IV,-,6613337,0.0740741,0.0,324,300,24,13,3,gene,F15B10.2,2,6613332,0.365727,385,6613722,5,6613337,0,-5
IV,-,6606172,0.0498562,0.0,1043,991,52,41,4,gene,F15B10.1,3,6606167,2.16988,1187,6607359,5,6606172,0,-5
IV,-,6605886,0.833333,2.95205e-07,54,9,45,38,0,gene,F15B10.1,3,6605870,2.16988,1473,6607359,16,6605886,0,-16
IV,-,6585384,0.00819672,0.0,488,484,4,4,38,gene,F38A5.2,1,6585384,1.99677,2792,6588176,0,6585384,0,0
IV,-,6582750,0.166667,0.09375,6,5,1,0,9,gene,F38A5.1,2,6582734,1.20204,54,6582804,16,6582660,90,74
IV,-,6582664,0.0410959,6.58526e-18,73,70,3,2,4,gene,F38A5.1,2,6582644,1.20204,7,6582671,20,6582660,4,-16
IV,-,6582602,0.812292,0.0,602,113,489,340,6,gene,F38A5.1,2,6582602,1.20204,69,6582671,0,6582602,0,0
IV,-,6572320,0.00444444,0.0,225,224,1,1,0,gene,C43G2.2,0,6572312,0.918533,7504,6579824,8,6572322,-2,-10
IV,-,6572260,0.0,0.5,1,1,0,0,28,gene,C43G2.2,0,6572254,0.918533,7564,6579824,6,6572322,-62,-68
IV,-,6555874,0.0,0.5,1,1,0,0,87,gene,C43G2.1,0,6555873,1.76735,9490,6565364,1,6555874,0,-1
IV,-,6555422,0.0046729,0.0,856,852,4,4,3,gene,C43G2.1,0,6555415,1.76735,9942,6565364,7,6555422,0,-7
IV,-,6529786,0.0,0.125,3,3,0,0,0,gene,C01G5.2,0,6529780,0.874415,22624,6552410,6,6529786,0,-6
IV,-,6473217,0.00149031,0.0,2013,2010,3,2,7,gene,Y73B6BL.27,0,6473213,1.80656,9973,6483190,4,6473203,14,10
IV,-,6431612,0.0,5.96046e-08,24,24,0,0,14,gene,Y73B6BL.25,0,6431611,0.110434,15024,6446636,1,6431677,-65,-66
IV,-,6426123,0.00391543,0.0,1277,1272,5,3,2,gene,Y73B6BL.24,0,6426121,4.75144,2166,6428289,2,6426121,2,0
IV,-,6402542,0.0,0.000244141,12,12,0,0,4,gene,Y73B6BL.21,0,6402411,0.359135,7002,6409544,131,6402566,-24,-155
IV,-,6384052,0.0,8.47033e-22,70,70,0,0,0,gene,Y73B6BL.19,0,6383966,0.145909,12514,6396566,86,6384054,-2,-88
IV,-,6376507,0.00468384,0.0,1708,1700,8,8,3,gene,Y73B6BL.33,1,6376506,1.39972,1762,6378269,1,6376506,1,0
IV,-,6373080,0.95,1.90735e-05,20,1,19,10,1,gene,Y73B6BL.18,2,6373077,0.524299,31,6373111,3,6373071,9,6
IV,-,6373071,0.903846,1.28688e-18,104,10,94,65,20,gene,Y73B6BL.18,2,6373071,0.524299,40,6373111,0,6373071,0,0
IV,-,6342948,0.0909091,0.00537109,11,10,1,1,0,gene,Y73B6BL.14,0,6342948,0.0308528,3703,6346651,0,6342967,-19,-19
IV,-,6335978,0.00787402,7.46439e-37,127,126,1,0,12,gene,Y73B6BL.13,0,6335971,0.198255,5444,6341422,7,6336031,-53,-60
IV,-,6303726,0.0,0.5,1,1,0,0,0,gene,Y73B6BL.11,0,6303726,0.000767789,13303,6317029,0,6303726,0,0
IV,-,6284362,0.0,0.03125,5,5,0,0,0,gene,T13A10.13,0,6284351,0.000660579,3984,6288346,11,6284371,-9,-20
IV,-,6282227,0.0,0.5,1,1,0,0,0,gene,T13A10.12,0,6282227,0.00363584,686,6282913,0,6282227,0,0
IV,-,6279163,0.0,5.82077e-11,34,34,0,0,1,gene,T13A10.11,0,6279126,0.342529,966,6280129,37,6279163,0,-37
IV,-,6275699,0.0,5.96046e-08,24,24,0,0,0,gene,T13A10.10,0,6275697,0.142422,1720,6277419,2,6275697,2,0
IV,-,6259803,0.0,6.93889e-18,57,57,0,0,110,gene,T13A10.5,0,6259802,0.68445,1237,6261040,1,6259826,-23,-24
IV,-,6248476,0.0,0.000488281,11,11,0,0,1,gene,F58F9.7,0,6248463,0.911253,6579,6255055,13,6248476,0,-13
IV,-,6248470,0.0103093,6.12156e-28,97,96,1,1,2,gene,F58F9.7,0,6248463,0.911253,6585,6255055,7,6248470,0,-7
IV,-,6209443,0.0,0.5,1,1,0,0,20,gene,C49A9.8,0,6209437,0.110993,26480,6235923,6,6209511,-68,-74
IV,-,6206326,0.00434028,0.0,1152,1147,5,3,0,gene,C49A9.10,0,6206313,0.864363,486,6206812,13,6206500,-174,-187
IV,-,6156883,0.0,0.0,353,353,0,0,5,gene,C11D2.4,1,6156875,0.599327,410,6157293,8,6156880,3,-5
IV,-,6155380,0.918332,0.0,1151,94,1057,723,4,gene,C11D2.7,2,6155376,1.68902,92,6155472,4,6155380,0,-4
IV,-,6149938,0.0,1.00974e-28,93,93,0,0,0,gene,H10D12.2,0,6149911,0.0512244,4596,6154534,27,6149911,27,0
IV,-,6127286,0.0,8.47033e-22,70,70,0,0,1,gene,M03D4.4,0,6127279,0.689906,15612,6142898,7,6127286,0,-7
IV,-,6125182,0.0,7.62939e-06,17,17,0,0,0,gene,M03D4.4,0,6125176,0.689906,17716,6142898,6,6125182,0,-6
IV,-,6112362,0.00562588,0.0,711,707,4,2,131,gene,M03D4.3,0,6112356,2.80949,9389,6121751,6,6112356,6,0
IV,-,6089390,0.0,0.5,1,1,0,0,0,gene,K08B4.5,0,6089387,0.00172047,2076,6091466,3,6089387,3,0
IV,-,6083575,0.0,0.000976562,10,10,0,0,0,gene,K08B4.4,0,6083575,0.0711264,2945,6086520,0,6083575,0,0
IV,-,6079928,0.0,7.45058e-09,27,27,0,0,1,gene,K08B4.3,0,6079928,0.140309,954,6080882,0,6079928,0,0
IV,-,6031602,0.0,3.58732e-43,141,141,0,0,0,gene,C46G7.4,0,6031530,2.34608,43614,6075216,72,6031530,72,0
IV,-,6027507,0.0,0.0625,4,4,0,0,0,gene,C46G7.4,0,6027476,2.34608,47709,6075216,31,6027509,-2,-33
IV,-,5947589,0.00260721,0.0,112764,112470,294,260,4,gene,K02B2.5,0,5947584,154.775,14083,5961672,5,5947589,0,-5
IV,-,5946949,1.0,0.5,1,0,1,0,2,gene,K02B2.4,0,5946938,0.367895,60,5947009,11,5946663,286,275
IV,-,5946657,0.1,0.00976562,10,9,1,1,65,gene,K02B2.4,0,5946614,0.367895,352,5947009,43,5946663,-6,-49
IV,-,5939214,0.0,0.0,542,542,0,0,30,gene,K02B2.3,0,5939197,1.56907,4758,5943972,17,5939214,0,-17
IV,-,5859961,0.0,0.0,192,192,0,0,0,gene,C06E7.4,0,5859961,1.2749,4554,5864515,0,5859961,0,0
IV,-,5846354,0.00395257,0.0,1265,1260,5,3,325,gene,C06E7.3,0,5846320,2.62281,4455,5850809,34,5846354,0,-34
IV,-,5814125,0.00478469,0.0,836,832,4,3,8,gene,C31H1.8,0,5814119,0.581064,29848,5843973,6,5814125,0,-6
IV,-,5805466,0.0,0.0,153,153,0,0,21,gene,C31H1.6,0,5805416,0.885579,6102,5811568,50,5805416,50,0
IV,-,5757847,0.013986,9.10553e-40,143,141,2,1,0,gene,C45E5.6,0,5757800,1.39313,37068,5794915,47,5757847,0,-47
IV,-,5757685,0.0,0.0078125,7,7,0,0,64,gene,C45E5.6,0,5757665,1.39313,37230,5794915,20,5757847,-162,-182
IV,-,5749875,0.0,0.0,313,313,0,0,98,gene,C45E5.6,0,5749875,1.39313,45040,5794915,0,5749875,0,0
IV,-,5749468,0.2,0.15625,5,4,1,1,5,gene,C45E5.6,0,5749451,1.39313,45447,5794915,17,5749468,0,-17
IV,-,5703453,0.00310559,0.0,322,321,1,1,0,gene,C55C3.5,0,5703436,0.932978,26194,5729647,17,5703453,0,-17
IV,-,5669488,0.0136986,0.0,292,288,4,3,23,gene,T19E7.6,0,5669480,0.819836,3128,5672616,8,5669488,0,-8
IV,-,5664410,0.00373832,0.0,535,533,2,1,1,gene,T19E7.3,1,5664402,0.915811,3082,5667492,8,5664410,0,-8
IV,-,5660508,0.925926,0.0,378,28,350,240,1,gene,T19E7.2,2,5660369,3.87318,617,5661125,139,5660508,0,-139
IV,-,5655893,0.00514403,0.0,972,967,5,5,1,gene,T19E7.2,2,5655748,3.87318,5232,5661125,145,5655893,0,-145
IV,-,5652780,0.0,0.03125,5,5,0,0,9,gene,T19E7.2,2,5652761,3.87318,384,5653164,19,5653123,-343,-362
IV,-,5640186,0.0,0.0078125,7,7,0,0,0,gene,B0547.3,0,5640175,None,3170,5643356,11,5640175,11,0
IV,-,5635647,0.0,0.5,1,1,0,0,0,gene,C39H7.7,0,5635636,0.00598705,2396,5638043,11,5635636,11,0
IV,-,5630235,0.0,0.25,2,2,0,0,1,gene,C39H7.6,0,5630224,0.00675442,3566,5633801,11,5630224,11,0
IV,-,5614593,0.0,0.0,457,457,0,0,4,gene,C39H7.4,0,5614586,0.707574,801,5615394,7,5614593,0,-7
IV,-,5537958,0.0,0.25,2,2,0,0,3,gene,F35D6.1,0,5537843,0.84122,29072,5567030,115,5537917,41,-74
IV,-,5516252,0.0,0.0,201,201,0,0,0,gene,B0273.4,0,5516250,0.555554,16875,5533127,2,5516252,0,-2
IV,-,5486201,0.0,1.97215e-31,102,102,0,0,0,gene,B0273.3,0,5486197,0.0624987,4254,5490455,4,5486197,4,0
IV,-,5394794,0.00342466,0.0,2044,2037,7,3,513,gene,ZK616.6,0,5394793,2.43943,13618,5408412,1,5394838,-44,-45
IV,-,5391546,0.00345224,0.0,869,866,3,3,1,gene,F41H10.10,0,5391546,0.734196,2283,5393829,0,5391546,0,0
IV,-,5388561,0.0,7.27596e-12,37,37,0,0,1,gene,F41H10.8,0,5388542,10.1098,1612,5390173,19,5388548,13,-6
IV,-,5388548,0.00162418,0.0,14161,14138,23,21,79,gene,F41H10.8,0,5388542,10.1098,1625,5390173,6,5388548,0,-6
IV,-,5364216,0.0,4.76837e-07,21,21,0,0,651,gene,F41H10.6,0,5364210,0.745263,10388,5374604,6,5364210,6,0
IV,-,5353346,0.0,0.0625,4,4,0,0,122,gene,Y4C6B.7,0,5353333,1.1461,3145,5356491,13,5353407,-61,-74
IV,-,5351141,0.974359,7.09406e-11,39,1,38,16,1,gene,Y4C6B.6,0,5351123,0.778479,333,5351474,18,5350918,223,205
IV,-,5215181,0.0,2.38419e-07,22,22,0,0,0,gene,Y59E9AL.4,0,5215172,0.259316,6074,5221255,9,5215181,0,-9
IV,-,5195615,0.0,9.53674e-07,20,20,0,0,0,gene,W03F8.9,0,5195589,0.0285509,11484,5207099,26,5195589,26,0
IV,-,5160238,0.00238663,0.0,838,836,2,1,0,gene,C24D10.6,0,5160237,1.8305,2578,5162816,1,5160238,0,-1
IV,-,5152475,0.0,0.00195312,9,9,0,0,0,gene,C24D10.9,0,5152457,0.0452291,4708,5157183,18,5152475,0,-18
IV,-,5145615,0.0,6.10352e-05,14,14,0,0,0,gene,AC7.2,0,5145605,1.02896,6565,5152180,10,5145800,-185,-195
IV,-,5133847,0.0,0.0,315,315,0,0,36,gene,AC7.2,0,5133760,1.02896,18333,5152180,87,5133847,0,-87
IV,-,5103269,0.00898876,0.0,445,441,4,3,0,gene,C02B10.3,0,5103266,1.52506,9688,5112957,3,5103269,0,-3
IV,-,5091031,0.00700701,0.0,999,992,7,7,3,gene,C02B10.2,0,5091026,1.23332,1763,5092794,5,5091099,-68,-73
IV,-,5088854,0.0493392,0.0,1135,1079,56,49,11,gene,C02B10.1,0,5088824,2.44882,1521,5090375,30,5088854,0,-30
IV,-,5045473,0.0,2.84217e-14,45,45,0,0,4,gene,C09B9.8,0,5045442,0.17418,10148,5055621,31,5045386,87,56
IV,-,5020623,0.0208333,1.7053e-13,48,47,1,0,4,gene,T28H11.8,0,5020617,0.112167,553,5021176,6,5020623,0,-6
IV,-,4975652,0.0,0.25,2,2,0,0,0,gene,Y9C9A.16,0,4975494,0.116756,4125,4979777,158,4975494,158,0
IV,-,4887364,0.0,7.27596e-12,37,37,0,0,1,gene,T08B6.1,0,4887348,0.00762926,6954,4894318,16,4887348,16,0
IV,-,4821073,0.0,0.0078125,7,7,0,0,131,gene,H06H21.8,0,4821064,0.551008,4405,4825478,9,4821064,9,0
IV,-,4821067,0.0,7.17465e-43,140,140,0,0,282,gene,H06H21.8,0,4821064,0.551008,4411,4825478,3,4821064,3,0
IV,-,4809964,0.00990099,3.98375e-29,101,100,1,0,2,gene,H06H21.6,1,4809954,1.47217,6972,4816936,10,4809964,0,-10
IV,-,4809685,0.00746269,0.0,268,266,2,2,0,gene,H06H21.6,1,4809477,1.47217,7251,4816936,208,4809685,0,-208
IV,-,4807309,0.907975,5.12838e-29,163,15,148,123,1,gene,H06H21.11,2,4807282,1.21985,107,4807416,27,4807282,27,0
IV,-,4807282,0.833724,0.0,427,71,356,283,96,gene,H06H21.11,2,4807282,1.21985,134,4807416,0,4807282,0,0
IV,-,4806576,0.674839,2.92885e-23,775,252,523,377,28,gene,R11E3.8,3,4806558,1.65424,110,4806686,18,4806576,0,-18
IV,-,4802582,0.919014,0.0,284,23,261,205,5,gene,R11E3.7,4,4802538,0.446951,110,4802692,44,4802582,0,-44
IV,-,4799317,0.933333,0.000457764,15,1,14,12,110,gene,R11E3.6,0,4799230,0.717856,59,4799376,87,4799347,-30,-117
IV,-,4788442,0.0,0.03125,5,5,0,0,191,gene,R11E3.5,0,4788427,0.334075,4754,4793196,15,4788427,15,0
IV,-,4780214,0.0,6.61744e-24,77,77,0,0,0,gene,R11E3.4,0,4780109,0.242944,3999,4784213,105,4780074,140,35
IV,-,4760419,0.0,0.0625,4,4,0,0,0,gene,Y17G9B.9,1,4760418,0.472715,14715,4775134,1,4760419,0,-1
IV,-,4758831,0.916667,0.00292969,12,1,11,10,0,gene,Y17G9B.8,2,4758818,0.555107,140,4758971,13,4758724,107,94
IV,-,4758716,0.315789,0.00984974,38,26,12,12,105,gene,Y17G9B.8,2,4758696,0.555107,255,4758971,20,4758724,-8,-28
IV,-,4754401,0.0,0.25,2,2,0,0,0,gene,Y17G9B.6,0,4754384,0.00223558,286,4754687,17,4754384,17,0
IV,-,4749769,0.00412992,0.0,51817,51603,214,195,60,gene,E04A4.8,1,4749760,118.165,4419,4754188,9,4749769,0,-9
IV,-,4748440,0.493372,0.000121686,39755,20141,19614,13977,759,gene,E04A4.7,2,4748432,70.9439,392,4748832,8,4748440,0,-8
IV,-,4747627,1.0,0.5,1,0,1,1,0,gene,E04A4.6,0,4747589,0.0733798,260,4747887,38,4747823,-196,-234
IV,-,4745483,0.0206561,0.0,823,806,17,6,0,gene,E04A4.5,1,4745464,3.26839,331,4745814,19,4745483,0,-19
IV,-,4744258,0.931507,9.92035e-30,146,10,136,108,0,gene,E04A4.4,2,4744241,0.77924,67,4744325,17,4744258,0,-17
IV,-,4743429,0.0,1.52588e-05,16,16,0,0,1,gene,E04A4.4,2,4743230,0.77924,896,4744325,199,4743429,0,-199
IV,-,4743045,0.111111,0.0175781,9,8,1,0,0,gene,E04A4.4,2,4743002,0.77924,1280,4744325,43,4743045,0,-43
IV,-,4727831,0.0,0.5,1,1,0,0,0,gene,K08F11.6,0,4727701,None,707,4728538,130,4727954,-123,-253
IV,-,4715798,0.04,7.45058e-07,25,24,1,0,0,gene,K08F11.5,1,4715797,0.797658,10269,4726067,1,4715798,0,-1
IV,-,4712503,0.323144,7.65668e-15,458,310,148,109,53,gene,K08F11.4,2,4712487,0.610512,311,4712814,16,4712492,11,-5
IV,-,4710745,1.0,1.19209e-07,23,0,23,18,1,gene,K08F11.3,3,4710730,4.88859,107,4710852,15,4710746,-1,-16
IV,-,4710384,0.890075,0.0,2529,278,2251,1672,1,gene,K08F11.3,3,4710384,4.88859,468,4710852,0,4710384,0,0
IV,-,4704002,0.232558,0.0,1204,924,280,221,8,gene,T22B11.5,4,4703975,4.42282,2792,4706794,27,4704002,0,-27
IV,-,4660192,0.00389181,0.0,25695,25595,100,85,23,gene,F29B9.11,1,4660191,46.1964,36640,4696832,1,4660191,1,0
IV,-,4659508,0.910784,0.0,1020,91,929,618,23,gene,F29B9.10,2,4659508,1.94992,24,4659532,0,4659403,105,105
IV,-,4657582,0.0,0.0625,4,4,0,0,164,gene,F29B9.9,0,4657578,1.08472,1452,4659034,4,4657578,4,0
IV,-,4618782,0.0,0.0625,4,4,0,0,3,gene,F19C7.8,0,4618762,0.394991,18999,4637781,20,4618782,0,-20
IV,-,4513312,0.00513809,0.0,1557,1549,8,8,2,gene,ZK180.4,1,4513305,5.23026,1725,4515037,7,4513314,-2,-9
IV,-,4511603,0.0731707,4.84761e-09,41,38,3,0,24,gene,ZK180.3,2,4511576,0.440035,246,4511849,27,4511313,290,263
IV,-,4511313,0.783784,3.56073e-07,74,16,58,36,0,gene,ZK180.3,2,4511293,0.440035,115,4511428,20,4511313,0,-20
IV,-,4510857,0.0,1.45519e-11,36,36,0,0,0,gene,ZK180.3,2,4510702,0.440035,571,4511428,155,4510857,0,-155
IV,-,4481718,0.0,0.0625,4,4,0,0,6,gene,M01H9.4,0,4481705,0.57044,7214,4488932,13,4481718,0,-13
IV,-,4481346,0.0,0.25,2,2,0,0,3,gene,M01H9.4,0,4481226,0.57044,7586,4488932,120,4481718,-372,-492
IV,-,4477052,0.00945378,0.0,952,943,9,7,1,gene,M01H9.3,0,4477051,12.7712,2582,4479634,1,4477052,0,-1
IV,-,4470817,0.00369004,0.0,1355,1350,5,4,2,gene,M01H9.3,0,4470734,12.7712,8817,4479634,83,4470817,0,-83
IV,-,4469835,0.0,1.16415e-10,33,33,0,0,3115,gene,M01H9.3,0,4469834,12.7712,9799,4479634,1,4469835,0,-1
IV,-,4445767,0.0,1.49012e-08,26,26,0,0,730,gene,R08C7.10,0,4445733,1.15579,8999,4454766,34,4445733,34,0
IV,-,4445737,0.0,1.90735e-06,19,19,0,0,453,gene,R08C7.10,0,4445733,1.15579,9029,4454766,4,4445733,4,0
IV,-,4335373,0.0,0.00195312,9,9,0,0,10,gene,W03B1.3,0,4335310,0.250578,6979,4342352,63,4335365,8,-55
IV,-,4333719,0.0,0.5,1,1,0,0,10,gene,W03B1.3,0,4333690,0.250578,1375,4335094,29,4333719,0,-29
IV,-,4299074,0.0,1.52588e-05,16,16,0,0,0,gene,F15E6.9,0,4299065,0.0300059,8092,4307166,9,4299076,-2,-11
IV,-,4284111,0.0,7.62939e-06,17,17,0,0,0,gene,F15E6.6,0,4284111,0.113689,1283,4285394,0,4284113,-2,-2
IV,-,4231852,0.0,4.93038e-32,104,104,0,0,0,gene,F30B5.7,0,4231838,0.227802,6366,4238218,14,4231853,-1,-15
IV,-,4192934,0.0,0.125,3,3,0,0,0,gene,K06B9.4,0,4192924,0.0327974,3198,4196132,10,4192924,10,0
IV,-,4134656,0.0,0.125,3,3,0,0,0,gene,F49F1.8,0,4134624,0.00643,945,4135601,32,4134624,32,0
IV,-,4125681,0.0,0.5,1,1,0,0,212,gene,F49F1.7,0,4125637,0.416962,4813,4130494,44,4125750,-69,-113
IV,-,4120406,0.0,0.0625,4,4,0,0,0,gene,F49F1.5,0,4120383,0.781238,929,4121335,23,4120391,15,-8
IV,-,4112473,0.0,5.68434e-14,44,44,0,0,0,gene,F49F1.14,0,4112463,0.0306808,6979,4119452,10,4112480,-7,-17
IV,-,4084202,0.00278843,0.0,2869,2861,8,7,2,gene,C35B1.5,0,4084183,6.47921,26277,4110479,19,4084202,0,-19
IV,-,4078767,0.0,0.5,1,1,0,0,0,gene,C35B1.8,0,4078747,0.197074,1382,4080149,20,4078769,-2,-22
IV,-,4078208,0.0,0.5,1,1,0,0,1,gene,C35B1.8,0,4078182,0.197074,1941,4080149,26,4078208,0,-26
IV,-,4063106,0.0,0.5,1,1,0,0,0,gene,W03D2.7,0,4063097,0.0984356,9952,4073058,9,4063106,0,-9
IV,-,4058295,0.0,1.0842e-19,63,63,0,0,3,gene,W03D2.6,0,4058292,0.361047,1629,4059924,3,4058295,0,-3
IV,-,4051623,0.0,1.13687e-13,43,43,0,0,52,gene,W03D2.5,0,4051611,0.547643,4890,4056513,12,4051624,-1,-13
IV,-,4049441,0.0040858,0.0,4895,4875,20,16,0,gene,W03D2.4,0,4049428,9.67613,557,4049998,13,4049441,0,-13
IV,-,4028121,0.0,0.0,518,518,0,0,3,gene,W02C12.3,0,4028080,2.33522,19801,4047922,41,4028121,0,-41
IV,-,4027057,0.0,0.00195312,9,9,0,0,1,gene,W02C12.3,0,4027057,2.33522,20865,4047922,0,4027057,0,0
IV,-,4019330,0.0,0.5,1,1,0,0,1,gene,W02C12.3,0,4019300,2.33522,28592,4047922,30,4019036,294,264
IV,-,4019036,0.0,0.0,216,216,0,0,8,gene,W02C12.3,0,4018975,2.33522,28886,4047922,61,4018975,61,0
IV,-,4019033,0.0,4.1359e-25,81,81,0,0,7,gene,W02C12.3,0,4018975,2.33522,28889,4047922,58,4018975,58,0
IV,-,4018576,0.0,6.10352e-05,14,14,0,0,0,gene,W02C12.3,0,4018453,2.33522,29346,4047922,123,4018576,0,-123
IV,-,4018325,0.0,0.25,2,2,0,0,3,gene,W02C12.3,0,4018306,2.33522,29597,4047922,19,4018325,0,-19
IV,-,4007965,0.0,1.05879e-22,73,73,0,0,1,gene,W02C12.2,0,4007811,0.34359,6788,4014753,154,4007817,148,-6
IV,-,3998564,0.0,0.0625,4,4,0,0,9,gene,F47C12.8,0,3998523,0.0725212,6907,4005471,41,3998601,-37,-78
IV,-,3941696,0.0,6.93889e-18,57,57,0,0,3,gene,Y46C8AL.2,0,3941696,0.216912,12236,3953932,0,3941696,0,0
IV,-,3878327,0.00777202,0.0,386,383,3,3,33,gene,F37C4.6,0,3878325,0.751674,198,3878525,2,3878327,0,-2
IV,-,3873800,0.00228137,0.0,2630,2624,6,4,0,gene,F37C4.5,0,3873795,4.44028,1604,3875404,5,3873800,0,-5
IV,-,3865036,0.0,0.015625,6,6,0,0,0,gene,F28F9.4,0,3865024,0.0239065,6787,3871823,12,3865024,12,0
IV,-,3835202,0.0526316,3.62396e-05,19,18,1,0,0,gene,M02B7.6,0,3835159,0.118958,26919,3862121,43,3835159,43,0
IV,-,3819323,0.00330033,0.0,303,302,1,1,0,gene,M02B7.5,1,3819318,1.00317,10341,3829664,5,3819318,5,0
IV,-,3807183,0.804878,2.06153e-30,328,64,264,198,1,gene,M02B7.7,2,3807183,0.638404,453,3807636,0,3807209,-26,-26
IV,-,3803377,0.111111,0.0175781,9,8,1,1,170,gene,M02B7.4,0,3803367,0.206503,2446,3805823,10,3803404,-27,-37
IV,-,3803339,0.0,0.125,3,3,0,0,14,gene,M02B7.4,0,3803317,0.206503,2484,3805823,22,3803404,-65,-87
IV,-,3800456,0.0,0.0625,4,4,0,0,5,gene,M02B7.3,0,3800442,0.0919269,1469,3801925,14,3800456,0,-14
IV,-,3799093,0.0,0.125,3,3,0,0,0,gene,M02B7.3,0,3799091,0.0919269,2832,3801925,2,3799093,0,-2
IV,-,3766821,0.00222222,0.0,450,449,1,1,0,gene,Y37E11AR.6,0,3766815,0.491514,29480,3796301,6,3766821,0,-6
IV,-,3751096,0.0,1.38778e-17,56,56,0,0,0,gene,Y37E11AR.5,0,3751093,0.264538,1480,3752576,3,3751096,0,-3
IV,-,3740873,0.0,1.83671e-40,132,132,0,0,0,gene,Y37E11AR.4,0,3740866,0.152121,7332,3748205,7,3740866,7,0
IV,-,3737912,0.0,8.27181e-25,80,80,0,0,8,gene,Y37E11AR.3,0,3737906,0.437542,1605,3739517,6,3737912,0,-6
IV,-,3725345,0.00110742,0.0,1806,1804,2,2,1,gene,Y37E11AM.2,1,3725345,0.96231,10495,3735840,0,3725345,0,0
IV,-,3722785,0.738889,3.40812e-11,180,47,133,83,2,gene,Y37E11AM.3,2,3722776,1.21371,97,3722882,9,3722785,0,-9
IV,-,3700650,0.0,0.00390625,8,8,0,0,0,gene,Y37E11AL.9,0,3700632,0.019398,669,3701319,18,3700649,1,-17
IV,-,3694728,0.0,2.27374e-13,42,42,0,0,7,gene,Y37E11AL.8,1,3694711,0.39465,5014,3699742,17,3694738,-10,-27
IV,-,3686860,0.904545,0.0,880,84,796,582,3,gene,Y37E11AL.7,2,3686852,1.00778,886,3687746,8,3686857,3,-5
IV,-,3668721,0.0,2.40741e-35,115,115,0,0,0,gene,Y37E11AL.6,0,3668709,0.267798,14810,3683531,12,3668698,23,11
IV,-,3663122,0.0,0.5,1,1,0,0,0,gene,Y37E11AL.5,0,3663073,0.240968,20409,3683531,49,3662763,359,310
IV,-,3648679,0.000927644,0.0,1078,1077,1,1,0,gene,CC8.2,0,3648656,1.49456,10198,3658877,23,3648679,0,-23
IV,-,3624692,0.0217391,8.45356e-25,92,90,2,0,1,gene,ZC416.8,0,3624570,0.297056,16708,3641400,122,3624692,0,-122
IV,-,3623480,0.0,3.8147e-06,18,18,0,0,2,gene,ZC416.8,0,3623466,0.297056,17920,3641400,14,3623466,14,0
IV,-,3613067,0.0,0.0,219,219,0,0,3,gene,ZC416.6,0,3613066,1.05929,860,3613927,1,3613067,0,-1
IV,-,3605668,0.0,0.5,1,1,0,0,48,gene,Y37E11B.10,0,3605637,0.254647,3543,3609211,31,3605637,31,0
IV,-,3598547,0.865979,1.05767e-39,291,39,252,175,0,gene,Y37E11B.5,2,3598541,0.508421,104,3598651,6,3598547,0,-6
IV,-,3593608,0.873626,1.4172e-26,182,23,159,114,1,gene,Y37E11B.4,3,3593594,0.338015,346,3593954,14,3593610,-2,-16
IV,-,3582902,0.826866,9.10069e-36,335,58,277,198,7,gene,Y37E11B.3,4,3582893,0.683522,1487,3584389,9,3582904,-2,-11
IV,-,3557436,0.0,0.0078125,7,7,0,0,1,gene,B0212.5,0,3557427,0.0643624,21142,3578578,9,3557427,9,0
IV,-,3547596,0.0,1.2326e-32,106,106,0,0,0,gene,B0212.4,0,3547588,0.116972,3286,3550882,8,3547596,0,-8
IV,-,3514557,0.00314961,0.0,635,633,2,1,1,gene,C09G12.9,1,3514550,1.26214,29098,3543655,7,3514559,-2,-9
IV,-,3509524,0.921416,0.0,1158,91,1067,661,0,gene,C09G12.8,2,3509490,1.53872,102,3509626,34,3509524,0,-34
IV,-,3422611,0.0,0.0078125,7,7,0,0,1,gene,C04C3.6,0,3422604,0.0132045,5433,3428044,7,3422604,7,0
IV,-,3384142,0.0,0.0,660,660,0,0,3,gene,B0546.4,1,3384113,1.33715,3929,3388071,29,3384143,-1,-30
IV,-,3382207,0.25,0.0537109,12,9,3,2,0,gene,B0546.3,2,3382177,0.545422,738,3382945,30,3382108,99,69
IV,-,3378126,0.842857,3.25872e-41,350,55,295,176,1,gene,B0546.2,3,3378100,0.990976,367,3378493,26,3378126,0,-26
IV,-,3350023,0.0,2.52435e-29,95,95,0,0,2,gene,F42A6.9,0,3349914,0.734801,23369,3373392,109,3350014,9,-100
IV,-,3338540,0.00549133,0.0,3460,3441,19,19,12,gene,F42A6.7,1,3338401,12.0583,128,3338668,139,3338540,0,-139
IV,-,3338294,0.0,0.25,2,2,0,0,5,gene,F42A6.7,1,3338293,12.0583,374,3338668,1,3338294,0,-1
IV,-,3336864,0.972222,0.0,396,11,385,289,0,gene,F42A6.6,2,3336850,0.444003,59,3336923,14,3336850,14,0
IV,-,3267671,0.00238663,0.0,419,418,1,1,10,gene,T26C12.6,0,3267671,1.40674,1789,3269460,0,3267671,0,0
IV,-,3254589,0.0,0.25,2,2,0,0,7,gene,Y67D8A.3,0,3254458,0.546224,9181,3263770,131,3254539,50,-81
IV,-,3254439,0.0,1.4013e-45,149,149,0,0,7,gene,Y67D8A.3,0,3254301,0.546224,9331,3263770,138,3254539,-100,-238
IV,-,3210615,0.0,0.00012207,13,13,0,0,0,gene,M4.2,0,3210578,0.00854583,42643,3253258,37,3210578,37,0
IV,-,3190400,0.0,0.5,1,1,0,0,1,gene,Y67D8B.2,0,3190371,0.0327527,11122,3201522,29,3190371,29,0
IV,-,3176109,0.0106383,4.74579e-27,94,93,1,0,1,gene,Y67D8B.4,0,3176087,0.00145753,9892,3186001,22,3176111,-2,-24
IV,-,3133138,0.00341297,0.0,586,584,2,1,1,gene,Y67D8C.10,0,3133057,4.16925,36802,3169940,81,3133138,0,-81
IV,-,3132272,0.00456621,0.0,219,218,1,1,1,gene,Y67D8C.10,0,3132095,4.16925,37668,3169940,177,3132272,0,-177
IV,-,3131370,0.00719424,1.99455e-40,139,138,1,1,0,gene,Y67D8C.10,0,3131366,4.16925,844,3132214,4,3131366,4,0
IV,-,3086919,0.0,1.29247e-26,86,86,0,0,0,gene,Y67D8C.9,0,3086866,0.240297,16234,3103153,53,3086919,0,-53
IV,-,3050097,0.0153061,0.0,196,193,3,2,1,gene,Y67D8C.5,0,3049968,1.7429,1314,3051411,129,3050099,-2,-131
IV,-,3028939,0.015748,4.70257e-35,127,125,2,1,3,gene,Y54G2A.29,0,3028929,0.299943,3771,3032710,10,3028939,0,-10
IV,-,3000780,0.0,0.5,1,1,0,0,0,gene,Y54G2A.27,0,3000753,0.00280463,8783,3009563,27,3000753,27,0
IV,-,2995570,0.00183655,0.0,1089,1087,2,2,1,gene,Y54G2A.26,0,2995469,1.84573,5040,3000610,101,2995570,0,-101
IV,-,2978475,0.0,2.32831e-10,32,32,0,0,0,gene,Y54G2A.25,0,2978461,0.178015,7609,2986084,14,2978458,17,3
IV,-,2928418,0.00234442,0.0,4692,4681,11,10,4,gene,Y54G2A.23,1,2928415,5.49457,9512,2937930,3,2928418,0,-3
IV,-,2925688,0.65195,4.6362e-30,1359,473,886,552,4,gene,Y54G2A.31,2,2925687,2.92436,1733,2927421,1,2925688,0,-1
IV,-,2922238,0.0187668,0.0,373,366,7,5,1,gene,Y54G2A.22,3,2922226,0.19671,348,2922586,12,2922226,12,0
IV,-,2914473,0.0,0.5,1,1,0,0,0,gene,Y54G2A.21,0,2914457,0.0217945,5350,2919823,16,2914813,-340,-356
IV,-,2894727,0.00555556,0.0,180,179,1,1,0,gene,Y54G2A.19,0,2894705,0.317735,2075,2896802,22,2894705,22,0
IV,-,2892492,0.0425225,0.0,5550,5314,236,178,7,gene,Y54G2A.18,0,2892485,4.59666,1324,2893816,7,2892492,0,-7
IV,-,2890446,0.00224719,0.0,445,444,1,1,2,gene,Y54G2A.17,0,2890345,0.986104,1108,2891554,101,2890446,0,-101
IV,-,2885289,0.0,7.52316e-37,120,120,0,0,32,gene,Y54G2A.17,0,2885253,0.986104,6265,2891554,36,2885289,0,-36
IV,-,2882338,0.0357143,1.04308e-07,28,27,1,1,1,gene,Y54G2A.17,0,2882300,0.986104,9216,2891554,38,2882338,0,-38
IV,-,2857268,0.0102041,3.09233e-28,98,97,1,1,3,gene,Y54G2A.16,0,2857112,0.180836,14754,2872022,156,2857112,156,0
IV,-,2852954,0.0,1.97215e-31,102,102,0,0,0,gene,Y54G2A.49,0,2852873,0.295056,2636,2855590,81,2852871,83,2
IV,-,2852945,0.0,0.5,1,1,0,0,173,gene,Y54G2A.49,0,2852873,0.295056,2645,2855590,72,2852871,74,2
IV,-,2840682,0.00214823,0.0,1862,1858,4,4,25,gene,Y54G2A.14,0,2840682,4.08183,2525,2843207,0,2840682,0,0
IV,-,2782840,0.0,0.0078125,7,7,0,0,0,gene,Y54G2A.12,0,2782821,0.0874814,14216,2797056,19,2782821,19,0
IV,-,2771787,0.00566572,0.0,1059,1053,6,5,0,gene,Y54G2A.11,0,2771732,2.78231,5445,2777232,55,2771787,0,-55
IV,-,2725855,0.00692521,0.0,722,717,5,3,7,gene,Y94H6A.9,1,2725816,2.07865,39862,2765717,39,2725855,0,-39
IV,-,2719831,0.962963,3.52875e-20,81,3,78,65,0,gene,Y94H6A.8,2,2719831,7.54463,483,2720314,0,2719831,0,0
IV,-,2716571,0.88764,8.21529e-15,89,10,79,44,0,gene,Y94H6A.7,1,2716568,0.559495,65,2716636,3,2716568,3,0
IV,-,2713032,0.819512,1.52049e-21,205,37,168,124,2,gene,Y94H6A.12,2,2713028,None,957,2713989,4,2713032,0,-4
IV,-,2711060,0.0,0.00195312,9,9,0,0,8,gene,Y94H6A.10,5,2711013,5.99384,887,2711947,47,2710667,393,346
IV,-,2710667,0.00498753,0.0,2005,1995,10,8,10,gene,Y94H6A.10,5,2710663,5.99384,1280,2711947,4,2710667,0,-4
IV,-,2710664,0.00143062,0.0,699,698,1,0,2965,gene,Y94H6A.10,5,2710663,5.99384,1283,2711947,1,2710667,-3,-4
IV,-,2707233,0.00627615,0.0,478,475,3,2,1,gene,Y94H6A.6,1,2707228,0.729827,2679,2709912,5,2707228,5,0
IV,-,2703974,0.0267857,4.38958e-29,112,109,3,3,0,gene,Y94H6A.5,2,2703967,0.681721,322,2704296,7,2703974,0,-7
IV,-,2641021,0.00329257,0.0,2126,2119,7,7,46,gene,Y69A2AR.30,0,2641007,2.89018,9358,2650379,14,2641021,0,-14
IV,-,2613058,0.00465477,0.0,1289,1283,6,6,1,gene,Y69A2AR.28,0,2613054,3.85017,2406,2615464,4,2613060,-2,-6
IV,-,2495165,0.0012474,0.0,2405,2402,3,2,0,gene,Y69A2AR.21,0,2495165,1.88284,9468,2504633,0,2495172,-7,-7
IV,-,2463367,0.0,7.10543e-15,47,47,0,0,7,gene,C45G7.5,0,2463363,0.155172,22015,2485382,4,2463367,0,-4
IV,-,2412416,0.0,0.0,195,195,0,0,0,gene,Y38F2AR.12,0,2412408,0.31567,24082,2436498,8,2412408,8,0
IV,-,2388673,0.00226876,0.0,11460,11434,26,24,4,gene,Y38F2AR.9,0,2388669,11.3534,7568,2396241,4,2388673,0,-4
IV,-,2348911,0.00729927,0.0,274,272,2,2,0,gene,Y38F2AR.7,0,2348910,0.321316,39279,2388190,1,2348911,0,-1
IV,-,2331012,0.0,0.25,2,2,0,0,1,gene,Y38F2AL.6,0,2330955,0.0125873,2824,2333836,57,2330679,333,276
IV,-,2315987,0.00154707,0.0,8403,8390,13,11,0,gene,Y38F2AL.4,1,2315944,2.21614,11138,2327125,43,2315987,0,-43
IV,-,2314566,0.0027248,0.0,2202,2196,6,4,6,gene,Y38F2AL.3,2,2314533,6.0434,893,2315459,33,2314566,0,-33
IV,-,2300434,0.0,0.015625,6,6,0,0,0,gene,C37F5.1,1,2300285,0.616312,3855,2304289,149,2300350,84,-65
IV,-,2300324,0.0,1.45519e-11,36,36,0,0,2,gene,C37F5.1,1,2300285,0.616312,3965,2304289,39,2300350,-26,-65
IV,-,2275621,0.037037,2.01166e-07,27,26,1,1,1,gene,M70.5,2,2275608,0.214592,242,2275863,13,2275700,-79,-92
IV,-,2263659,0.872093,3.16194e-13,86,11,75,53,4,gene,M70.4,3,2263659,0.266099,649,2264308,0,2263659,0,0
IV,-,2164871,0.0,0.03125,5,5,0,0,1,gene,C54E4.4,0,2164869,0.249442,72799,2237670,2,2164869,2,0
IV,-,2149296,0.0,0.0,634,634,0,0,5,gene,C54E4.5,0,2149295,0.524937,1353,2150649,1,2149298,-2,-3
IV,-,2113306,0.0,0.125,3,3,0,0,502,gene,C23H5.8,0,2113217,2.92913,12836,2126142,89,2113396,-90,-179
IV,-,2113298,0.0,0.00012207,13,13,0,0,305,gene,C23H5.8,0,2113217,2.92913,12844,2126142,81,2113396,-98,-179
IV,-,2059302,0.0,0.0625,4,4,0,0,0,gene,R05C11.2,0,2059243,0.00627163,32626,2091928,59,2059110,192,133
IV,-,2035853,0.0,1.86265e-09,29,29,0,0,0,gene,Y76B12C.9,0,2035822,0.0470262,22022,2057875,31,2035985,-132,-163
IV,-,2035845,0.0,0.5,1,1,0,0,12,gene,Y76B12C.9,0,2035822,0.0470262,22030,2057875,23,2035985,-140,-163
IV,-,2032995,0.0134228,1.54507e-41,149,147,2,2,0,gene,Y76B12C.7,0,2032991,0.47231,1984,2034979,4,2032991,4,0
IV,-,1972378,0.0,0.25,2,2,0,0,1,gene,Y76B12C.4,0,1972370,0.154079,36660,2009038,8,1972370,8,0
IV,-,1820251,0.000716846,0.0,9765,9758,7,4,13,gene,Y38C1BA.3,0,1820248,4.03962,150482,1970733,3,1820251,0,-3
IV,-,1815103,0.0,6.10352e-05,14,14,0,0,1,gene,Y38C1BA.2,0,1815094,0.202793,2228,1817331,9,1815097,6,-3
IV,-,1815097,0.0,3.8147e-06,18,18,0,0,5,gene,Y38C1BA.2,0,1815094,0.202793,2234,1817331,3,1815097,0,-3
IV,-,1813936,0.0,0.125,3,3,0,0,1,gene,Y38C1BA.2,0,1813871,0.202793,3395,1817331,65,1813936,0,-65
IV,-,1808510,0.0,0.00195312,9,9,0,0,0,gene,Y38C1BA.2,0,1808491,0.202793,8821,1817331,19,1808510,0,-19
IV,-,1803981,0.0,6.10352e-05,14,14,0,0,0,gene,Y38C1BA.1,0,1803980,0.0837114,1052,1805033,1,1803980,1,0
IV,-,1781651,0.0,1.61559e-27,89,89,0,0,0,gene,Y41D4A.8,0,1781560,0.35854,20373,1802024,91,1781560,91,0
IV,-,1761580,0.0,6.77626e-21,67,67,0,0,15,gene,Y41D4A.7,0,1761574,0.22431,13599,1775179,6,1761683,-103,-109
IV,-,1745583,0.0,0.0625,4,4,0,0,1,gene,Y41D4A.6,0,1745511,0.383806,6479,1752062,72,1745522,61,-11
IV,-,1745575,0.0,0.5,1,1,0,0,11,gene,Y41D4A.6,0,1745511,0.383806,6487,1752062,64,1745522,53,-11
IV,-,1745503,0.0,1.52588e-05,16,16,0,0,333,gene,Y41D4A.6,0,1745501,0.383806,6559,1752062,2,1745522,-19,-21
IV,-,1737882,0.00838926,0.0,596,591,5,5,0,gene,Y41D4A.5,0,1737863,1.64175,3119,1741001,19,1737882,0,-19
IV,-,1709743,0.00254187,0.0,6688,6671,17,15,7,gene,K08D12.1,0,1709740,5.59442,13404,1723147,3,1709743,0,-3
IV,-,1682157,0.0,0.000976562,10,10,0,0,0,gene,Y41D4B.24,0,1682157,0.0527895,26641,1708798,0,1682157,0,0
IV,-,1645286,0.00276243,0.0,724,722,2,2,3,gene,Y41D4B.21,0,1645249,0.396512,31429,1676715,37,1645249,37,0
IV,-,1595822,0.00549451,0.0,364,362,2,1,51,gene,Y41D4B.19,0,1595803,1.30977,4212,1600034,19,1595822,0,-19
IV,-,1550229,0.6,0.3125,5,2,3,3,0,gene,C34H4.5,0,1550223,0.110037,17690,1567919,6,1550239,-10,-16
IV,-,1536407,0.214286,0.0222168,14,11,3,2,0,gene,K03H6.5,0,1536396,0.0783696,8889,1545296,11,1536396,11,0
IV,-,1516623,0.0,4.33681e-19,61,61,0,0,3,gene,K03H6.7,0,1516623,0.0702619,1276,1517899,0,1516623,0,0
IV,-,1496431,0.0,0.125,3,3,0,0,0,gene,Y77E11A.13,0,1496404,1.66797,19023,1515454,27,1496019,412,385
IV,-,1496043,0.0,0.0625,4,4,0,0,20,gene,Y77E11A.13,0,1496006,1.66797,19411,1515454,37,1496006,37,0
IV,-,1496021,0.0,0.0,305,305,0,0,23,gene,Y77E11A.13,0,1496006,1.66797,19433,1515454,15,1496006,15,0
IV,-,1496013,0.00327332,0.0,611,609,2,2,274,gene,Y77E11A.13,0,1496006,1.66797,19441,1515454,7,1496006,7,0
IV,-,1475106,0.0,1.00974e-28,93,93,0,0,1,gene,Y77E11A.12,0,1475092,0.222076,15548,1490654,14,1475108,-2,-16
IV,-,1466696,1.0,0.5,1,0,1,1,0,gene,Y77E11A.12,0,1466696,0.222076,23958,1490654,0,1466381,315,315
IV,-,1466381,0.0,1.90735e-06,19,19,0,0,2,gene,Y77E11A.12,0,1466380,0.222076,24273,1490654,1,1466381,0,-1
IV,-,1460785,0.00734312,0.0,1498,1487,11,5,7,gene,Y77E11A.15,0,1460785,8.05686,1113,1461898,0,1460785,0,0
IV,-,1445992,0.00102354,0.0,977,976,1,1,123,gene,Y77E11A.11,0,1445965,0.872555,832,1446824,27,1445992,0,-27
IV,-,1419846,0.0117899,0.0,933,922,11,8,1,gene,Y77E11A.7,1,1419844,1.12917,3274,1423120,2,1419844,2,0
IV,-,1410040,0.876861,0.0,739,91,648,379,1,gene,Y77E11A.6,2,1410036,1.68449,714,1410754,4,1410036,4,0
IV,-,1359212,0.0,0.25,2,2,0,0,1,gene,F58F6.2,0,1359103,0.0315611,49391,1408603,109,1359224,-12,-121
IV,-,1355302,0.000750413,0.0,6663,6658,5,0,0,gene,F58F6.1,0,1355294,6.273,2511,1357813,8,1355304,-2,-10
IV,-,1309650,0.00833333,0.0,480,476,4,3,0,gene,F53H1.1,0,1309644,0.658627,44006,1353656,6,1309644,6,0
IV,-,1243100,0.111111,0.0175781,9,8,1,1,1,gene,F38A1.15,0,1243079,0.00423147,1145,1244245,21,1243402,-302,-323
IV,-,1239797,0.00694444,6.45718e-42,144,143,1,1,91,gene,F38A1.8,0,1239784,0.605338,1533,1241330,13,1239823,-26,-39
IV,-,1221203,0.0,0.0,297,297,0,0,122,gene,W09G12.10,0,1221201,0.398638,11623,1232826,2,1221206,-3,-5
IV,-,1149903,0.0,0.0,237,237,0,0,1,gene,C50A2.3,0,1149891,0.362676,9736,1159639,12,1149903,0,-12
IV,-,1125087,0.0,0.03125,5,5,0,0,490,gene,C44B12.5,0,1125085,16.889,3950,1129037,2,1125283,-196,-198
IV,-,1093920,0.00714286,0.0,2520,2502,18,17,0,gene,Y55F3AR.3,1,1093913,2.59736,9592,1103512,7,1093920,0,-7
IV,-,1087013,0.95847,0.0,915,38,877,623,4,gene,Y55F3AM.15,2,1087007,0.99879,110,1087123,6,1087013,0,-6
IV,-,1063185,0.01,7.88861e-29,100,99,1,0,0,gene,Y55F3AM.14,0,1063178,0.25642,14277,1077462,7,1063187,-2,-9
IV,-,1056313,0.00271739,0.0,2208,2202,6,5,5,gene,Y55F3AM.13,0,1056300,1.9068,2232,1058545,13,1056313,0,-13
IV,-,1054794,0.00454545,0.0,660,657,3,2,1,gene,Y55F3AM.12,0,1054786,1.11838,228,1055022,8,1054794,0,-8
IV,-,1041014,0.0,0.0625,4,4,0,0,2,gene,Y55F3AM.11,0,1041008,0.138627,8531,1049545,6,1041008,6,0
IV,-,1030033,0.0,0.0,466,466,0,0,0,gene,Y55F3AM.10,0,1030016,0.332597,8637,1038670,17,1030024,9,-8
IV,-,1009798,0.0,0.00195312,9,9,0,0,1,gene,Y55F3AM.9,1,1009724,0.696221,17955,1027753,74,1009717,81,7
IV,-,1005862,0.907449,0.0,443,41,402,271,0,gene,Y55F3AM.8,2,1005856,1.06194,226,1006088,6,1005856,6,0
IV,-,1005834,1.0,0.25,2,0,2,1,357,gene,Y55F3AM.8,2,1005685,1.06194,254,1006088,149,1005856,-22,-171
IV,-,990457,0.125,0.03125,8,7,1,1,0,gene,Y55F3AM.7,0,990439,0.116043,13144,1003601,18,990439,18,0
IV,-,990450,0.0,1.45519e-11,36,36,0,0,6,gene,Y55F3AM.7,0,990439,0.116043,13151,1003601,11,990439,11,0
IV,-,945653,0.0126582,1.30695e-22,79,78,1,0,1,gene,F58H7.2,0,945606,0.586254,38738,984391,47,945603,50,3
IV,-,854378,0.00488998,0.0,409,407,2,2,2,gene,Y55F3BR.8,0,854374,0.390318,32890,887268,4,854378,0,-4
IV,-,842126,0.0,2.01948e-28,92,92,0,0,0,gene,Y55F3BR.7,0,842118,0.00120526,7145,849271,8,842118,8,0
IV,-,838576,0.0,0.015625,6,6,0,0,25,gene,Y55F3BR.6,0,838560,0.528827,2690,841266,16,838536,40,24
IV,-,838489,0.00220022,0.0,909,907,2,1,18,gene,Y55F3BR.6,0,838470,0.528827,2777,841266,19,838536,-47,-66
IV,-,832242,0.0,0.125,3,3,0,0,3,gene,Y55F3BR.5,0,832028,0.163964,2791,835033,214,831896,346,132
IV,-,831910,0.0,0.0078125,7,7,0,0,4,gene,Y55F3BR.5,0,831896,0.163964,3123,835033,14,831896,14,0
IV,-,796565,0.00893697,0.0,2126,2107,19,19,28,gene,F56B3.11,1,796562,1.81647,9856,806421,3,796562,3,0
IV,-,795431,0.625,1.12377e-12,760,285,475,325,0,gene,F56B3.12,2,795406,1.24402,318,795749,25,795406,25,0
IV,-,794493,0.769231,0.0349121,13,3,10,6,1,gene,F56B3.4,3,794491,0.298227,139,794632,2,794275,218,216
IV,-,794451,1.0,0.25,2,0,2,1,0,gene,F56B3.4,3,794437,0.298227,181,794632,14,794275,176,162
IV,-,794275,0.539419,0.0243345,241,111,130,88,4,gene,F56B3.4,3,794273,0.298227,357,794632,2,794275,0,-2
IV,-,766912,0.0,0.5,1,1,0,0,1,gene,F56B3.2,0,766878,0.545874,3855,770767,34,766912,0,-34
IV,-,727482,0.0,1.90735e-06,19,19,0,0,0,gene,Y55F3C.9,0,727481,0.075807,1016,728498,1,727481,1,0
IV,-,707731,0.0,3.63798e-12,38,38,0,0,0,gene,Y55F3C.7,0,707726,0.444624,10192,717923,5,707719,12,7
IV,-,654576,0.00622839,0.0,37891,37655,236,215,2,gene,K11H12.2,1,654571,116.342,14336,668912,5,654576,0,-5
IV,-,653419,0.927611,0.0,967,70,897,651,12,gene,K11H12.1,2,653414,1.81242,11,653430,5,653421,-2,-7
IV,-,570844,0.0203046,0.0,197,193,4,4,103,gene,F56A11.5,0,570834,1.14651,9401,580245,10,570843,1,-9
IV,-,519457,0.0140449,0.0,356,351,5,5,0,gene,W03G1.6,0,519456,0.728684,757,520214,1,519456,1,0
IV,-,481167,0.030303,3.84171e-09,33,32,1,1,0,gene,M04G7.3,0,481153,0.183444,17298,498465,14,481167,0,-14
IV,-,476897,0.0,2.38419e-07,22,22,0,0,2,gene,M04G7.3,0,476862,0.183444,21568,498465,35,476897,0,-35
IV,-,463879,0.0,7.62939e-06,17,17,0,0,0,gene,M04G7.3,0,463872,0.183444,34586,498465,7,463879,0,-7
IV,-,440552,0.00537634,0.0,186,185,1,1,2,gene,Y66H1A.6,0,440544,0.329691,14406,454958,8,440544,8,0
IV,-,439724,0.0,0.5,1,1,0,0,0,gene,Y66H1A.6,0,439703,0.329691,15234,454958,21,439734,-10,-31
IV,-,425174,0.00160256,0.0,624,623,1,1,0,gene,T07A9.6,1,425148,1.6469,2993,428167,26,425173,1,-25
IV,-,425167,0.00325203,0.0,615,613,2,2,35,gene,T07A9.6,1,425148,1.6469,3000,428167,19,425173,-6,-25
IV,-,419958,0.965686,0.0,204,7,197,150,0,gene,T07A9.5,2,419951,0.406549,54,420012,7,419958,0,-7
IV,-,410033,0.0,0.0,278,278,0,0,1,gene,T07A9.3,0,409980,1.34023,5575,415608,53,410026,7,-46
IV,-,408896,0.00793651,0.0,378,375,3,3,3,gene,T07A9.3,0,408886,1.34023,6712,415608,10,408896,0,-10
IV,-,385000,0.0,1.05879e-22,73,73,0,0,1,gene,T07A9.1,1,384997,0.0217382,3667,388667,3,384936,64,61
IV,-,383185,0.444672,0.00181959,488,271,217,159,2,gene,Y66H1B.4,2,383179,1.23842,338,383523,6,383185,0,-6
IV,-,376062,0.0201005,0.0,796,780,16,12,0,gene,Y66H1B.3,0,376012,0.943626,3838,379900,50,376062,0,-50
IV,-,364307,0.00251256,0.0,796,794,2,2,0,gene,Y66H1B.2,0,364191,4.12384,5926,370233,116,364340,-33,-149
IV,-,337185,0.0106383,4.74579e-27,94,93,1,1,3,gene,F18F11.1,0,337161,0.529923,22037,359222,24,337178,7,-17
IV,-,337178,0.0166667,5.20417e-17,60,59,1,1,19,gene,F18F11.1,0,337161,0.529923,22044,359222,17,337178,0,-17
IV,-,313715,0.0,3.46945e-18,58,58,0,0,1,gene,K02D7.2,0,313697,0.0609651,1341,315056,18,313697,18,0
IV,-,294676,0.00208531,0.0,5275,5264,11,7,16,gene,K02D7.1,0,294645,4.52526,16827,311503,31,294676,0,-31
IV,-,288100,0.0,0.0,469,469,0,0,2,gene,T21D12.14,0,288088,0.618605,614,288714,12,288116,-16,-28
IV,-,273668,0.0,0.125,3,3,0,0,2,gene,T21D12.5,0,273625,0.00340337,13637,287305,43,273386,282,239
IV,-,264232,0.00431499,0.0,927,923,4,4,0,gene,T21D12.4,1,264224,1.78245,8081,272313,8,264232,0,-8
IV,-,261683,0.0294906,0.0,1119,1086,33,16,1,gene,T21D12.3,2,261680,0.79877,200,261883,3,261683,0,-3
IV,-,259204,0.00215517,0.0,464,463,1,1,17,gene,T21D12.2,0,259203,0.743013,757,259961,1,259204,0,-1
IV,-,257197,0.00176991,0.0,565,564,1,1,8,gene,R02D3.8,0,257189,0.446888,186,257383,8,257189,8,0
IV,-,255429,0.0039093,0.0,1279,1274,5,5,1,gene,R02D3.7,0,255426,0.772691,544,255973,3,255429,0,-3
IV,-,240307,0.00805153,0.0,621,616,5,3,16,gene,R02D3.5,1,240298,1.27131,11630,251937,9,240307,0,-9
IV,-,237450,0.787234,0.0,752,160,592,453,0,gene,R02D3.4,2,237450,0.607123,30,237480,0,237450,0,0
IV,-,231773,0.929907,1.58907e-42,214,15,199,136,0,gene,R02D3.3,3,231773,0.560771,736,232509,0,231773,0,0
IV,-,157899,0.0,3.72529e-09,28,28,0,0,2,gene,Y38C1AA.9,0,157890,0.174618,67542,225441,9,157897,2,-7
IV,-,147965,0.0,0.0,201,201,0,0,0,gene,Y38C1AA.8,0,147939,0.42638,8106,156071,26,147919,46,20
IV,-,125929,0.0017138,0.0,1167,1165,2,2,11,gene,F29C4.7,1,125923,1.09008,12532,138461,6,125929,0,-6
IV,-,121707,0.97549,0.0,204,5,199,143,2,gene,F29C4.6,2,121697,0.604173,91,121798,10,121697,10,0
IV,-,121697,0.923077,4.84288e-06,26,2,24,13,469,gene,F29C4.6,2,121697,0.604173,101,121798,0,121697,0,0
IV,-,48873,0.0,6.01853e-36,117,117,0,0,0,gene,Y38C1AB.8,0,48873,0.00387316,4208,53081,0,48875,-2,-2
V,-,20904965,0.0,0.00012207,13,13,0,0,0,gene,F25C8.1,0,20904964,0.0881219,0,0,1,20904964,1,0
V,-,20863647,0.00740741,3.09945e-39,135,134,1,1,0,gene,F31D4.8,0,20863638,0.316015,30420,20894067,9,20863647,0,-9
V,-,20856346,0.0,0.25,2,2,0,0,4,gene,F31D4.6,0,20856334,0.0269984,5624,20861970,12,20856371,-25,-37
V,-,20847113,0.00449438,0.0,4895,4873,22,19,3,gene,F31D4.9,0,20847112,8.09152,7447,20854560,1,20847115,-2,-3
V,-,20845697,1.0,0.5,1,0,1,1,26,gene,F31D4.4,0,20845629,0.177322,394,20846091,68,20845912,-215,-283
V,-,20840764,0.0102828,0.0,389,385,4,4,15,gene,F31D4.2,0,20840744,1.53305,2156,20842920,20,20840764,0,-20
V,-,20824280,0.0,0.125,3,3,0,0,2,gene,T03D8.3,0,20824251,9.72294,12495,20836775,29,20824104,176,147
V,-,20824086,0.0,0.5,1,1,0,0,333,gene,T03D8.3,0,20824066,9.72294,12689,20836775,20,20824104,-18,-38
V,-,20820152,0.0,0.00195312,9,9,0,0,3,gene,T03D8.5,1,20820112,0.0416724,2778,20822930,40,20820246,-94,-134
V,-,20814123,0.00843882,0.0,237,235,2,2,1,gene,T03D8.6,2,20814089,1.05301,1169,20815292,34,20814123,0,-34
V,-,20787629,0.00258398,0.0,387,386,1,0,0,gene,Y44A6D.3,0,20787621,1.08366,8780,20796409,8,20787629,0,-8
V,-,20765379,0.0,6.61744e-24,77,77,0,0,0,gene,F38A6.2,0,20765350,0.217596,2381,20767760,29,20765379,0,-29
V,-,20764470,0.0,0.125,3,3,0,0,2,gene,F38A6.2,0,20764463,0.217596,3290,20767760,7,20764362,108,101
V,-,20739557,0.00408163,0.0,245,244,1,1,9,gene,W07A8.3,1,20739537,0.845118,20629,20760186,20,20739557,0,-20
V,-,20739547,0.0,1.73472e-18,59,59,0,0,339,gene,W07A8.3,1,20739537,0.845118,20639,20760186,10,20739557,-10,-20
V,-,20724487,0.521569,0.0394073,255,122,133,103,1,gene,W07A8.2,2,20724480,0.623396,680,20725167,7,20724487,0,-7
V,-,20723966,0.0246914,1.34003e-21,81,79,2,1,1,gene,W07A8.2,2,20723957,0.623396,1201,20725167,9,20723966,0,-9
V,-,20699259,0.00111857,0.0,894,893,1,1,1,gene,F53F8.5,0,20699255,0.839674,13829,20713088,4,20699255,4,0
V,-,20693578,0.0277778,6.29104e-28,108,105,3,2,0,gene,F53F8.7,0,20693555,None,1471,20695049,23,20693496,82,59
V,-,20686903,0.00119332,0.0,838,837,1,1,54,gene,F53F8.4,0,20686902,1.24665,2192,20689095,1,20686903,0,-1
V,-,20684743,0.0113636,0.0,528,522,6,6,0,gene,F53F8.3,0,20684736,0.629333,1062,20685805,7,20684747,-4,-11
V,-,20614319,0.0,0.0625,4,4,0,0,0,gene,F46B3.7,0,20614307,0.0209582,3547,20617866,12,20613874,445,433
V,-,20603633,0.0,1.52588e-05,16,16,0,0,29,gene,F46B3.4,0,20603601,0.282928,5955,20609588,32,20603738,-105,-137
V,-,20561863,0.0,2.98023e-08,25,25,0,0,0,gene,F26F2.3,0,20561759,0.229301,26619,20588482,104,20561759,104,0
V,-,20561765,0.0,4.65661e-10,31,31,0,0,5,gene,F26F2.3,0,20561759,0.229301,26717,20588482,6,20561759,6,0
V,-,20557141,0.0,5.16988e-26,84,84,0,0,0,gene,F26F2.1,0,20557113,0.135566,3369,20560510,28,20557113,28,0
V,-,20546408,0.0,0.00390625,8,8,0,0,1,gene,Y38H6C.20,0,20546397,0.0369724,1108,20547516,11,20546382,26,15
V,-,20539410,0.0,4.76837e-07,21,21,0,0,0,gene,Y38H6C.17,0,20539397,0.0525969,2432,20541842,13,20539410,0,-13
V,-,20533373,0.0190476,1.34599e-28,105,103,2,1,1,gene,Y38H6C.16,0,20533311,0.611888,2238,20535611,62,20533361,12,-50
V,-,20528771,0.0,0.5,1,1,0,0,1,gene,Y38H6C.14,0,20528763,0.0758771,1219,20529990,8,20528771,0,-8
V,-,20517530,0.0,0.0625,4,4,0,0,14,gene,Y38H6C.9,0,20517527,0.0159932,2386,20519916,3,20517502,28,25
V,-,20513273,0.0,1.45519e-11,36,36,0,0,0,gene,Y38H6C.10,0,20513254,0.0884196,2204,20515477,19,20513254,19,0
V,-,20500321,0.0,0.00012207,13,13,0,0,1,gene,Y38H6C.4,0,20500315,0.0115635,5722,20506043,6,20500315,6,0
V,-,20494009,0.0,0.5,1,1,0,0,9,gene,Y38H6C.1,0,20493984,67.1137,1081,20495090,25,20494270,-261,-286
V,-,20480603,0.0,1.86265e-09,29,29,0,0,0,gene,B0250.9,0,20480590,0.551877,2259,20482862,13,20480603,0,-13
V,-,20474155,0.0,0.015625,6,6,0,0,72,gene,B0250.2,0,20474137,0.210597,1866,20476021,18,20474307,-152,-170
V,-,20471278,0.0,1.90735e-06,19,19,0,0,2,gene,B0250.7,0,20471252,None,690,20471968,26,20471174,104,78
V,-,20471198,0.0,4.54747e-13,41,41,0,0,6,gene,B0250.7,0,20471174,None,770,20471968,24,20471174,24,0
V,-,20471012,0.0,2.91038e-11,35,35,0,0,3,gene,B0250.7,0,20471006,None,956,20471968,6,20471174,-162,-168
V,-,20465709,0.0,0.5,1,1,0,0,0,gene,B0250.8,0,20465703,0.00978626,1973,20467682,6,20465703,6,0
V,-,20464637,0.0290179,0.0,448,435,13,12,1,gene,B0250.3,0,20464631,None,3045,20467682,6,20464631,6,0
V,-,20459710,0.0,3.72529e-09,28,28,0,0,0,gene,B0250.4,0,20459704,0.170373,3821,20463531,6,20459704,6,0
V,-,20445172,0.0,3.05176e-05,15,15,0,0,2,gene,F48F5.6,0,20445164,0.52986,2974,20448146,8,20445179,-7,-15
V,-,20445033,0.0,0.0625,4,4,0,0,33,gene,F48F5.6,0,20444990,0.52986,3113,20448146,43,20445179,-146,-189
V,-,20362116,0.0,0.5,1,1,0,0,267,gene,K02E2.8,0,20361742,0.218199,580,20362696,374,20362155,-39,-413
V,-,20330580,0.00454545,0.0,440,438,2,2,0,gene,Y38H6A.5,0,20330578,None,13124,20343704,2,20330578,2,0
V,-,20275079,0.00473634,0.0,3167,3152,15,11,6,gene,ZC15.8,0,20275072,3.28069,1530,20276609,7,20275079,0,-7
V,-,20264929,0.00114155,0.0,7008,7000,8,7,3,gene,Y113G7B.17,1,20264922,14.4339,8940,20273869,7,20264929,0,-7
V,-,20262457,0.909548,2.10814e-35,199,18,181,133,116,gene,Y113G7B.18,2,20262447,0.587225,129,20262586,10,20262454,3,-7
V,-,20244700,0.468468,0.00822954,666,354,312,246,1,gene,Y113G7B.23,3,20244678,2.33581,1335,20246035,22,20244702,-2,-24
V,-,20232961,0.865169,8.48936e-25,178,24,154,103,2,gene,Y113G7B.24,4,20232944,0.371574,1365,20234326,17,20232963,-2,-19
V,-,20210515,0.0,5.55112e-17,54,54,0,0,0,gene,Y113G7B.11,0,20210514,0.200453,13667,20224182,1,20210514,1,0
V,-,20207912,0.0,0.5,1,1,0,0,1,gene,Y113G7B.12,0,20207847,0.0798105,1127,20209039,65,20207997,-85,-150
V,-,20187370,0.0,4.33681e-19,61,61,0,0,0,gene,Y113G7B.3,2,20187336,0.135655,936,20188306,34,20187336,34,0
V,-,20158948,0.000431406,0.0,2318,2317,1,1,33,gene,F19B2.5,0,20158855,2.76904,9336,20168284,93,20158585,363,270
V,-,20133665,0.0,1.65436e-24,79,79,0,0,0,gene,Y113G7A.14,0,20133661,0.0554171,24197,20157862,4,20133661,4,0
V,-,20115891,0.00337458,0.0,889,886,3,1,0,gene,Y113G7A.4,0,20115879,0.962506,7741,20123632,12,20115891,0,-12
V,-,20090224,0.00421941,0.0,237,236,1,1,2,gene,Y113G7A.15,0,20090198,0.464666,8175,20098399,26,20090475,-251,-277
V,-,20085961,0.00607903,0.0,329,327,2,2,0,gene,Y113G7A.9,1,20085960,0.998903,3505,20089466,1,20085960,1,0
V,-,20082951,0.808642,3.01962e-16,162,31,131,101,2,gene,Y113G7A.8,2,20082941,0.389982,117,20083068,10,20082941,10,0
V,-,20082941,0.978495,4.31968e-25,93,2,91,57,277,gene,Y113G7A.8,2,20082941,0.389982,127,20083068,0,20082941,0,0
V,-,20054980,0.0,6.10352e-05,14,14,0,0,1,gene,Y113G7A.6,0,20054909,0.300648,16177,20071157,71,20054974,6,-65
V,-,20054972,0.037037,2.01166e-07,27,26,1,0,27,gene,Y113G7A.6,0,20054909,0.300648,16185,20071157,63,20054972,0,-63
V,-,19999703,0.00643087,0.0,622,618,4,3,0,gene,Y60A3A.1,0,19999638,1.666,36442,20036145,65,19999703,0,-65
V,-,19989405,0.0,9.53674e-07,20,20,0,0,0,gene,Y60A3A.25,0,19989396,0.0283207,1799,19991204,9,19989407,-2,-11
V,-,19977100,0.0,3.72529e-09,28,28,0,0,1,gene,Y60A3A.24,0,19977094,0.0553487,1087,19978187,6,19977100,0,-6
V,-,19944311,0.0196078,2.26485e-14,51,50,1,1,0,gene,Y60A3A.9,1,19944308,3.86433,4183,19948494,3,19944308,3,0
V,-,19941847,0.91358,9.43873e-30,162,14,148,117,8,gene,Y60A3A.10,2,19941835,0.676892,110,19941957,12,19941847,0,-12
V,-,19941840,0.943182,1.26584e-19,88,5,83,61,343,gene,Y60A3A.10,2,19941835,0.676892,117,19941957,5,19941840,0,-5
V,-,19929539,0.868132,1.2743e-13,91,12,79,58,1,gene,Y60A3A.14,0,19929537,0.291569,437,19929976,2,19929537,2,0
V,-,19917818,0.111111,0.0175781,9,8,1,1,0,gene,Y60A3A.16,0,19917812,0.0205317,2855,19920673,6,19917812,6,0
V,-,19911199,0.0357143,1.04308e-07,28,27,1,0,1,gene,Y60A3A.12,1,19911191,0.0835292,5982,19917181,8,19911191,8,0
V,-,19902652,0.0,5.82077e-11,34,34,0,0,3,gene,Y60A3A.13,2,19902651,0.688346,1378,19904030,1,19902652,0,-1
V,-,19902591,0.153846,0.000222772,26,22,4,4,68,gene,Y60A3A.13,2,19902587,0.688346,1439,19904030,4,19902652,-61,-65
V,-,19901303,1.0,0.5,1,0,1,1,5,gene,Y60A3A.13,2,19901210,0.688346,2727,19904030,93,19901303,0,-93
V,-,19897456,0.0,0.25,2,2,0,0,1,gene,Y60A3A.13,2,19897407,0.688346,6574,19904030,49,19897456,0,-49
V,-,19896663,0.0,6.10352e-05,14,14,0,0,1,gene,Y60A3A.13,2,19896612,0.688346,7367,19904030,51,19896663,0,-51
V,-,19890568,0.21875,3.03532e-18,224,175,49,34,0,gene,Y116F11B.12,0,19890559,0.71362,2676,19893244,9,19890568,0,-9
V,-,19887885,0.0508475,5.63941e-14,59,56,3,2,1,gene,Y116F11B.12,0,19887880,0.71362,5359,19893244,5,19887885,0,-5
V,-,19841212,0.0212766,3.33955e-13,47,46,1,1,0,gene,Y116F11B.6,0,19841195,0.0244247,9189,19850401,17,19841195,17,0
V,-,19825317,0.0111111,0.0,270,267,3,2,1,gene,Y116F11B.3,0,19825308,0.26061,10992,19836309,9,19825317,0,-9
V,-,19825233,0.0,0.5,1,1,0,0,31,gene,Y116F11B.3,0,19825151,0.26061,11076,19836309,82,19825317,-84,-166
V,-,19770227,0.0,3.05176e-05,15,15,0,0,0,gene,M162.9,0,19770194,None,1070,19771297,33,19770194,33,0
V,-,19770078,0.0,0.5,1,1,0,0,0,gene,M162.9,0,19770034,None,1219,19771297,44,19770194,-116,-160
V,-,19766973,0.0,0.125,3,3,0,0,0,gene,M162.13,0,19766943,None,1579,19768552,30,19766517,456,426
V,-,19766929,0.025,3.63798e-11,40,39,1,1,0,gene,M162.13,0,19766924,None,1623,19768552,5,19766517,412,407
V,-,19692617,0.00174825,0.0,1716,1713,3,2,5,gene,Y43F8C.13,0,19692605,0.566499,12375,19704992,12,19692617,0,-12
V,-,19655044,0.0,0.0625,4,4,0,0,0,gene,Y43F8C.10,0,19655035,0.0177206,34073,19689117,9,19655044,0,-9
V,-,19643823,0.0139082,0.0,719,709,10,9,121,gene,Y43F8C.7,1,19643822,1.85904,6406,19650229,1,19643823,0,-1
V,-,19640701,0.910448,6.76242e-13,67,6,61,42,0,gene,Y43F8C.6,2,19640655,0.35344,380,19641081,46,19640701,0,-46
V,-,19640671,0.895522,1.56918e-22,134,14,120,82,28,gene,Y43F8C.6,2,19640655,0.35344,410,19641081,16,19640701,-30,-46
V,-,19549579,0.0142857,5.92923e-20,70,69,1,1,0,gene,Y43F8B.20,0,19549577,None,1215,19550794,2,19549577,2,0
V,-,19545991,0.0,0.0,316,316,0,0,0,gene,Y43F8B.1,0,19545961,2.94837,2006,19547997,30,19545961,30,0
V,-,19543868,0.00917431,1.67941e-31,109,108,1,0,1,gene,Y43F8B.1,0,19543829,2.94837,4129,19547997,39,19543868,0,-39
V,-,19539280,0.00625,0.0,800,795,5,4,2,gene,Y43F8B.1,0,19539275,2.94837,8717,19547997,5,19539275,5,0
V,-,19532889,0.0,0.0078125,7,7,0,0,5,gene,Y43F8B.2,0,19532792,7.15601,1799,19534688,97,19532903,-14,-111
V,-,19522688,0.0,0.25,2,2,0,0,3,gene,Y43F8B.2,0,19522560,7.15601,12000,19534688,128,19522540,148,20
V,-,19522515,0.0,6.77626e-21,67,67,0,0,680,gene,Y43F8B.2,0,19522458,7.15601,12173,19534688,57,19522540,-25,-82
V,-,19461912,0.0,0.0078125,7,7,0,0,0,gene,Y43F8B.15,0,19461896,None,2950,19464862,16,19461896,16,0
V,-,19448695,0.0,6.77626e-21,67,67,0,0,0,gene,M04C3.2,1,19448662,0.0487793,3280,19451975,33,19448695,0,-33
V,-,19444736,0.0,1.13687e-13,43,43,0,0,0,gene,M04C3.3,2,19444727,0.202314,931,19445667,9,19444736,0,-9
V,-,19432866,0.00157729,0.0,1268,1266,2,2,7,gene,C25F9.11,0,19432853,None,4869,19437735,13,19432952,-86,-99
V,-,19431063,0.0,0.25,2,2,0,0,5,gene,C25F9.1,0,19431052,0.186858,1176,19432239,11,19431052,11,0
V,-,19413708,0.0,3.46945e-18,58,58,0,0,0,gene,C25F9.4,0,19413675,0.12982,6787,19420495,33,19413675,33,0
V,-,19405135,0.0,0.5,1,1,0,0,0,gene,C25F9.6,0,19405135,0.264596,2377,19407512,0,19405118,17,17
V,-,19405118,0.0,9.86076e-32,103,103,0,0,0,gene,C25F9.6,0,19405105,0.264596,2394,19407512,13,19405118,0,-13
V,-,19402749,0.0,0.0,225,225,0,0,0,gene,C25F9.12,0,19402743,None,1820,19404569,6,19402743,6,0
V,-,19400507,0.0,0.0,184,184,0,0,0,gene,C25F9.7,0,19400506,0.00937679,1466,19401973,1,19400509,-2,-3
V,-,19389918,0.0555556,6.86646e-05,18,17,1,1,0,gene,Y43F8A.5,0,19389914,0.0843856,7702,19397620,4,19389914,4,0
V,-,19349287,0.0,2.27374e-13,42,42,0,0,0,gene,C14B4.2,0,19349281,0.184197,35410,19384697,6,19349281,6,0
V,-,19322286,0.0,1.42109e-14,46,46,0,0,0,gene,C43D7.4,0,19322281,0.185589,2050,19324336,5,19322281,5,0
V,-,19211689,0.0,1.35525e-20,66,66,0,0,2,gene,T26H2.9,0,19211682,0.174108,1776,19213465,7,19211682,7,0
V,-,19203401,0.000852919,0.0,10552,10543,9,8,4,gene,Y39B6A.1,0,19203391,9.37877,4077,19207478,10,19203401,0,-10
V,-,19148949,0.0,0.0078125,7,7,0,0,0,gene,Y39B6A.7,0,19148941,0.0312822,8510,19157459,8,19148941,8,0
V,-,19133395,0.00214133,0.0,467,466,1,1,0,gene,Y39B6A.10,0,19133368,0.193301,12068,19145463,27,19133368,27,0
V,-,19124703,0.0,0.0,208,208,0,0,0,gene,Y39B6A.12,0,19124701,0.529203,6622,19131325,2,19124701,2,0
V,-,19119027,0.0,0.5,1,1,0,0,44,gene,Y39B6A.13,1,19119011,0.277656,294,19119321,16,19119161,-134,-150
V,-,19118206,0.977273,6.88142e-35,132,3,129,89,0,gene,Y39B6A.14,2,19118198,0.479488,97,19118303,8,19118206,0,-8
V,-,19100916,0.829787,2.23435e-06,47,8,39,32,0,gene,Y39B6A.16,3,19100902,0.13128,1250,19102166,14,19100902,14,0
V,-,19050587,0.0,0.5,1,1,0,0,6,gene,Y39B6A.20,0,19050546,95.8446,17826,19068413,41,19050549,38,-3
V,-,19050549,0.00183536,0.0,40319,40245,74,66,5,gene,Y39B6A.20,0,19050546,95.8446,17864,19068413,3,19050549,0,-3
V,-,19042401,0.0,0.125,3,3,0,0,0,gene,Y39B6A.23,0,19042399,0.0813936,606,19043007,2,19042399,2,0
V,-,19037114,0.0,0.25,2,2,0,0,0,gene,Y39B6A.24,0,19037112,0.256108,1736,19038850,2,19037114,0,-2
V,-,19024575,0.0,4.76837e-07,21,21,0,0,0,gene,Y39B6A.29,0,19024559,0.0459871,10937,19035512,16,19024559,16,0
V,-,18990155,0.0,0.0625,4,4,0,0,159,gene,Y39B6A.38,0,18990125,0.27089,30126,19020281,30,18990203,-48,-78
V,-,18977770,0.25,0.25,4,3,1,1,0,gene,Y39B6A.41,0,18977770,0.0157597,1343,18979113,0,18977772,-2,-2
V,-,18969432,0.00232829,0.0,1718,1714,4,4,2,gene,Y39B6A.42,1,18969432,2.12571,906,18970338,0,18969411,21,21
V,-,18969320,0.0,0.5,1,1,0,0,0,gene,Y39B6A.42,1,18969313,2.12571,1018,18970338,7,18969320,0,-7
V,-,18960015,1.0,0.125,3,0,3,2,0,gene,Y39B6A.46,1,18959966,0.0675228,742,18960757,49,18959966,49,0
V,-,18959966,1.0,4.65661e-10,31,0,31,26,2,gene,Y39B6A.46,1,18959966,0.0675228,791,18960757,0,18959966,0,0
V,-,18957111,0.486034,0.0555577,179,92,87,68,0,gene,Y80D3A.9,2,18957100,0.235512,766,18957877,11,18957100,11,0
V,-,18931173,0.0,5.68434e-14,44,44,0,0,0,gene,Y80D3A.7,0,18931166,0.107252,21737,18952910,7,18931175,-2,-9
V,-,18931167,0.0,0.00390625,8,8,0,0,10,gene,Y80D3A.7,0,18931166,0.107252,21743,18952910,1,18931175,-8,-9
V,-,18900324,0.0,9.62965e-35,113,113,0,0,0,gene,Y80D3A.4,0,18900320,0.10099,18702,18919026,4,18900320,4,0
V,-,18894768,0.011583,0.0,259,256,3,2,0,gene,Y80D3A.2,1,18894762,0.942829,309,18895077,6,18894768,0,-6
V,-,18859015,0.929329,0.0,566,40,526,319,1,gene,Y80D3A.1,2,18858998,1.2704,1069,18860084,17,18859015,0,-17
V,-,18808462,0.0,0.0,433,433,0,0,1,gene,C54E10.6,0,18808455,0.617234,23657,18832119,7,18808455,7,0
V,-,18800614,0.0333333,2.79397e-08,30,29,1,0,0,gene,C54E10.5,0,18800613,0.0777075,572,18801186,1,18800616,-2,-3
V,-,18786589,0.0,0.125,3,3,0,0,1,gene,Y17D7B.3,0,18786582,0.00934426,9276,18795865,7,18786582,7,0
V,-,18780420,0.0,0.5,1,1,0,0,2,gene,Y17D7B.4,0,18780373,1.79253,4242,18784662,47,18780011,409,362
V,-,18779450,0.0,1.52588e-05,16,16,0,0,0,gene,Y17D7B.4,0,18779241,1.79253,808,18780258,209,18779450,0,-209
V,-,18750405,0.0,0.5,1,1,0,0,2,gene,F11D11.12,0,18750340,None,2888,18753293,65,18750371,34,-31
V,-,18689587,0.0,0.00195312,9,9,0,0,7,gene,Y69H2.6,0,18689552,0.262238,26123,18715710,35,18689638,-51,-86
V,-,18689557,0.0322581,1.44355e-08,31,30,1,1,5,gene,Y69H2.6,0,18689552,0.262238,26153,18715710,5,18689638,-81,-86
V,-,18663911,0.00362319,0.0,276,275,1,0,26,gene,Y69H2.3,0,18663891,3.29716,22207,18686118,20,18663911,0,-20
V,-,18626653,0.0,2.32831e-10,32,32,0,0,1,gene,Y69H2.15,0,18626647,None,1820,18628473,6,18626647,6,0
V,-,18622348,0.0,9.53674e-07,20,20,0,0,0,gene,Y69H2.1,0,18622337,0.0258026,650,18622998,11,18622337,11,0
V,-,18564681,0.0,7.62939e-06,17,17,0,0,0,gene,Y51A2D.12,0,18564676,0.0210881,8172,18572853,5,18564676,5,0
V,-,18461039,0.0,8.96831e-44,143,143,0,0,0,gene,ZK228.3,0,18461026,0.210242,6661,18467700,13,18461026,13,0
V,-,18359754,0.0,0.125,3,3,0,0,0,gene,C08E8.5,0,18359692,0.00114495,1071,18360825,62,18359783,-29,-91
V,-,18339700,0.0,0.0,952,952,0,0,3,gene,C08E8.10,0,18339683,None,14778,18354478,17,18339683,17,0
V,-,18330974,0.0,0.00012207,13,13,0,0,0,gene,B0462.4,0,18330972,0.149976,7836,18338810,2,18330974,0,-2
V,-,18323120,0.0,7.27596e-12,37,37,0,0,0,gene,B0462.5,0,18323106,None,5740,18328860,14,18323122,-2,-16
V,-,18269846,0.0,0.5,1,1,0,0,0,gene,Y37H2C.2,0,18269827,0.00451068,2777,18272623,19,18269780,66,47
V,-,18252113,0.0,0.00012207,13,13,0,0,0,gene,R10E8.1,0,18252090,0.218014,6964,18259077,23,18252113,0,-23
V,-,18243569,0.0,3.8147e-06,18,18,0,0,9,gene,R10E8.1,0,18243516,0.218014,3644,18247213,53,18243571,-2,-55
V,-,18240531,0.0,2.91038e-11,35,35,0,0,0,gene,R10E8.8,0,18240524,0.243896,1603,18242134,7,18240524,7,0
V,-,18236552,0.0,0.125,3,3,0,0,7,gene,R10E8.3,0,18236510,0.170422,1369,18237921,42,18236552,0,-42
V,-,18224242,0.00645161,2.8026e-45,155,154,1,0,0,gene,F16H6.10,0,18224204,0.411007,2780,18227022,38,18224242,0,-38
V,-,18178031,0.0,0.5,1,1,0,0,0,gene,C31G12.4,0,18177938,0.00588426,7828,18185859,93,18178031,0,-93
V,-,18137509,0.0,1.20371e-35,116,116,0,0,0,gene,Y37H2A.9,0,18137509,0.0370227,21937,18159446,0,18137509,0,0
V,-,18134278,0.0,0.000976562,10,10,0,0,0,gene,Y37H2A.7,0,18134273,0.0360199,2162,18136440,5,18134273,5,0
V,-,18130918,0.0,1.45519e-11,36,36,0,0,0,gene,Y37H2A.12,0,18130904,0.1383,428,18131346,14,18130904,14,0
V,-,18086121,0.0,0.125,3,3,0,0,9,gene,Y59A8B.12,0,18086013,1.07059,42846,18128967,108,18086232,-111,-219
V,-,18086018,0.00767263,0.0,782,776,6,6,3,gene,Y59A8B.12,0,18086013,1.07059,42949,18128967,5,18086232,-214,-219
V,-,18077255,0.00512821,0.0,1170,1164,6,6,0,gene,Y59A8B.10,0,18077250,2.11934,4946,18082201,5,18077255,0,-5
V,-,18066102,0.374101,6.68026e-06,278,174,104,73,3,gene,Y59A8B.8,0,18066100,0.804815,3712,18069814,2,18066102,0,-2
V,-,18001163,0.00240529,0.0,1663,1659,4,3,0,gene,Y59A8B.20,0,18001155,2.96601,8599,18009762,8,18001155,8,0
V,-,17979878,0.00414938,0.0,482,480,2,2,3,gene,Y59A8B.22,1,17979877,0.938529,15277,17995155,1,17979878,0,-1
V,-,17966644,0.876652,2.49159e-33,227,28,199,94,2,gene,Y59A8B.23,2,17966560,1.42435,1690,17968334,84,17966644,0,-84
V,-,17948979,0.103064,0.0,359,322,37,32,0,gene,Y59A8B.1,0,17948900,1.20419,4554,17953533,79,17948825,154,75
V,-,17896583,0.00137363,0.0,728,727,1,1,0,gene,C06H5.1,0,17896558,0.325934,3535,17900118,25,17896583,0,-25
V,-,17888781,0.0,3.05176e-05,15,15,0,0,4,gene,C06H5.6,0,17888760,0.324482,4821,17893602,21,17888781,0,-21
V,-,17888773,0.0,0.000488281,11,11,0,0,18,gene,C06H5.6,0,17888760,0.324482,4829,17893602,13,17888781,-8,-21
V,-,17888765,0.0,1.4013e-45,149,149,0,0,55,gene,C06H5.6,0,17888760,0.324482,4837,17893602,5,17888781,-16,-21
V,-,17870448,0.0,0.0,179,179,0,0,0,gene,Y59A8A.1,0,17870431,0.954843,9180,17879628,17,17870448,0,-17
V,-,17855786,0.00626741,0.0,1436,1427,9,9,4,gene,Y59A8A.3,0,17855783,2.16048,5376,17861162,3,17855783,3,0
V,-,17783437,0.0,3.8147e-06,18,18,0,0,0,gene,C47A10.6,0,17783436,0.0494346,12503,17795940,1,17783436,1,0
V,-,17777024,0.0,7.17465e-43,140,140,0,0,1,gene,C47A10.5,0,17777011,0.186761,3205,17780229,13,17777011,13,0
V,-,17714174,0.0,1.90735e-06,19,19,0,0,0,gene,W06D12.5,0,17714063,0.0576338,12420,17726594,111,17714176,-2,-113
V,-,17684750,0.0,0.03125,5,5,0,0,0,gene,F59A1.16,0,17684738,0.0119697,1228,17685978,12,17684765,-15,-27
V,-,17657995,0.0102041,3.09233e-28,98,97,1,1,1,gene,F59A1.7,0,17657960,0.1198,3559,17661554,35,17657960,35,0
V,-,17656489,0.0,0.00195312,9,9,0,0,4,gene,F59A1.8,1,17656451,0.042019,200,17656689,38,17656451,38,0
V,-,17655091,0.129032,1.4652e-05,31,27,4,4,0,gene,F59A1.9,2,17655078,0.0696022,212,17655303,13,17655078,13,0
V,-,17650324,0.484848,0.135834,33,17,16,11,0,gene,F57G4.8,4,17650319,0.062579,2991,17653315,5,17650319,5,0
V,-,17648518,0.0,1.19209e-07,23,23,0,0,0,gene,F57G4.7,5,17648511,None,4797,17653315,7,17648511,7,0
V,-,17639840,1.0,0.125,3,0,3,2,0,gene,F57G4.4,0,17639839,0.0207298,629,17640469,1,17639839,1,0
V,-,17616668,0.0,0.0625,4,4,0,0,8,gene,Y6G8.6,0,17616634,0.0121834,15548,17632216,34,17616718,-50,-84
V,-,17615514,0.0,0.25,2,2,0,0,1,gene,Y6G8.5,0,17615506,0.215413,754,17616268,8,17615506,8,0
V,-,17598457,0.0,0.25,2,2,0,0,0,gene,Y6G8.2,0,17598407,0.076977,11341,17609798,50,17598457,0,-50
V,-,17546782,0.0,1.90735e-06,19,19,0,0,1,gene,C18D4.8,0,17546771,0.0306244,4519,17551301,11,17546782,0,-11
V,-,17538170,0.0133333,7.83046e-42,150,148,2,2,2,gene,C18D4.6,0,17538152,0.13995,760,17538930,18,17538152,18,0
V,-,17531309,0.0,3.8147e-06,18,18,0,0,3,gene,C18D4.4,0,17531307,0.262747,839,17532148,2,17531307,2,0
V,-,17481655,0.0,0.5,1,1,0,0,0,gene,F08E10.5,0,17481652,None,11601,17493256,3,17481652,3,0
V,-,17469055,0.0,0.00390625,8,8,0,0,26,gene,F20E11.17,0,17469049,None,9106,17478161,6,17469049,6,0
V,-,17468588,0.0,0.25,2,2,0,0,2,gene,F20E11.17,0,17468514,None,9573,17478161,74,17469049,-461,-535
V,-,17462302,0.0,0.5,1,1,0,0,0,gene,F20E11.5,0,17462266,0.000137737,6144,17468446,36,17462230,72,36
V,-,17344722,0.0,3.55271e-15,48,48,0,0,6,gene,F47H4.8,0,17344700,0.075641,3098,17347820,22,17344724,-2,-24
V,-,17315602,0.0,0.25,2,2,0,0,1,gene,F31E9.6,0,17315421,0.102483,3738,17319340,181,17314923,679,498
V,-,17314930,0.0416667,1.43051e-06,24,23,1,1,4,gene,F31E9.6,0,17314910,0.102483,469,17315399,20,17314923,7,-13
V,-,17301273,0.0,0.0625,4,4,0,0,8,gene,K10G4.5,0,17301273,0.0308783,12097,17313370,0,17301336,-63,-63
V,-,17297164,0.0,7.62939e-06,17,17,0,0,0,gene,K10G4.13,0,17297157,None,973,17298137,7,17297157,7,0
V,-,17297157,0.142857,0.0546875,7,6,1,1,3,gene,K10G4.13,0,17297157,None,980,17298137,0,17297157,0,0
V,-,17264751,0.0,1.90735e-06,19,19,0,0,1,gene,K10G4.3,0,17264751,0.128351,13602,17278353,0,17265143,-392,-392
V,-,17207920,0.0,3.8147e-06,18,18,0,0,8578,gene,Y68A4A.13,0,17207914,12.8086,2592,17210512,6,17207914,6,0
V,-,17157054,0.0,9.31323e-10,30,30,0,0,0,gene,F40D4.13,0,17157053,0.0342015,1427,17158481,1,17157053,1,0
V,-,17155227,0.0,4.65661e-10,31,31,0,0,1,gene,F40D4.17,0,17155132,None,514,17155741,95,17154929,298,203
V,-,17089283,0.0,0.5,1,1,0,0,5,gene,T05E12.6,0,17089239,0.969568,8441,17097724,44,17089243,40,-4
V,-,17082802,0.0,0.5,1,1,0,0,0,gene,T05E12.9,0,17082786,None,1997,17084799,16,17082617,185,169
V,-,16965474,0.010846,0.0,461,456,5,2,0,gene,Y102A5C.18,0,16965472,0.819525,20735,16986209,2,16965480,-6,-8
V,-,16954610,0.0,0.5,1,1,0,0,0,gene,Y102A5C.15,0,16954602,0.000377474,3780,16958390,8,16954665,-55,-63
V,-,16947920,0.0,0.5,1,1,0,0,0,gene,Y102A5C.13,0,16947910,0,752,16948672,10,16947749,171,161
V,-,16946158,0.0,0.5,1,1,0,0,0,gene,Y102A5C.12,0,16946145,0,797,16946955,13,16946145,13,0
V,-,16925958,0.0,0.000976562,10,10,0,0,0,gene,Y102A5C.35,0,16925924,None,762,16926720,34,16925924,34,0
V,-,16921135,0.0,2.58494e-26,85,85,0,0,0,gene,Y102A5C.3,0,16921122,0.0479137,3613,16924748,13,16921122,13,0
V,-,16918277,0.0,2.11758e-22,72,72,0,0,0,gene,Y102A5C.1,0,16918273,0.196992,1237,16919514,4,16918277,0,-4
V,-,16879957,0.0,0.03125,5,5,0,0,5,gene,F09C6.3,0,16879954,0.00887411,1725,16881682,3,16879954,3,0
V,-,16834929,0.00301811,0.0,994,991,3,3,8,gene,T20B3.2,0,16834910,1.5321,4015,16838944,19,16834929,0,-19
V,-,16821121,0.00249221,0.0,1605,1601,4,1,289,gene,T20B3.14,0,16821117,2.71467,3968,16825089,4,16821121,0,-4
V,-,16794808,0.0,0.0,525,525,0,0,1,gene,W06H3.2,0,16794789,0.870605,25623,16820431,19,16794808,0,-19
V,-,16793057,0.0,6.93889e-18,57,57,0,0,3,gene,W06H3.2,0,16793057,0.870605,27374,16820431,0,16793057,0,0
V,-,16746059,0.00901481,0.0,1553,1539,14,14,2,gene,T25E12.5,0,16746050,2.00954,46499,16792558,9,16746059,0,-9
V,-,16723645,0.0,2.58494e-26,85,85,0,0,0,gene,Y70C5C.6,0,16723628,0.0727277,9423,16733068,17,16723645,0,-17
V,-,16648169,0.0,0.00012207,13,13,0,0,203,gene,W06G6.11,0,16648167,0.107102,724,16648893,2,16648169,0,-2
V,-,16646227,0.0,0.25,2,2,0,0,5,gene,W06G6.9,0,16646200,0.0145489,275,16646502,27,16646283,-56,-83
V,-,16637667,0.0,0.5,1,1,0,0,0,gene,W06G6.6,0,16637612,0.00128095,3966,16641633,55,16638106,-439,-494
V,-,16623015,0.0,0.0625,4,4,0,0,0,gene,Y70C5A.2,0,16623013,0.0959265,793,16623808,2,16623013,2,0
V,-,16620718,0.0,0.125,3,3,0,0,0,gene,Y70C5A.3,0,16620703,None,639,16621357,15,16620710,8,-7
V,-,16620710,0.05,1.90735e-05,20,19,1,1,8,gene,Y70C5A.3,0,16620703,None,647,16621357,7,16620710,0,-7
V,-,16595148,0.00154101,0.0,17521,17494,27,13,4,gene,T03E6.7,0,16595147,24.6174,3641,16598789,1,16595148,0,-1
V,-,16490323,0.0,0.5,1,1,0,0,0,gene,Y32B12A.2,0,16490229,None,3086,16493409,94,16490322,1,-93
V,-,16394878,0.0,0.0,187,187,0,0,0,gene,F13A7.11,0,16394869,0.156779,20759,16415637,9,16394880,-2,-11
V,-,16389689,0.0,2.58494e-26,85,85,0,0,0,gene,F13A7.9,0,16389668,0.0282972,2594,16392283,21,16389668,21,0
V,-,16269372,0.0,9.09495e-13,40,40,0,0,3,gene,T13F3.5,0,16269353,0.0733206,731,16270103,19,16269344,28,9
V,-,16229398,0.0,0.25,2,2,0,0,4,gene,F21H7.2,0,16229372,0.147605,1437,16230835,26,16229398,0,-26
V,-,16218406,0.0,0.25,2,2,0,0,16,gene,F11A5.15,0,16218383,0.207985,7408,16225814,23,16218383,23,0
V,-,16171435,0.0,0.125,3,3,0,0,0,gene,K05D4.9,0,16171432,0.000840316,2111,16173546,3,16171624,-189,-192
V,-,16159508,0.0,0.0,151,151,0,0,0,gene,F10A3.17,0,16159486,None,907,16160415,22,16159584,-76,-98
V,-,16159497,0.0,0.0,254,254,0,0,669,gene,F10A3.17,0,16159486,None,918,16160415,11,16159584,-87,-98
V,-,16142953,0.0,0.000976562,10,10,0,0,2,gene,F10A3.2,0,16142919,0.0201823,10703,16153656,34,16142919,34,0
V,-,16132666,0.0,6.10352e-05,14,14,0,0,3,gene,F44G3.8,0,16132616,0.010541,918,16133584,50,16133086,-420,-470
V,-,16128892,0.0,0.00012207,13,13,0,0,1,gene,F44G3.13,0,16128623,None,318,16129210,269,16128892,0,-269
V,-,16127298,0.285714,0.164062,7,5,2,0,0,gene,F44G3.14,0,16127297,0.0201615,568,16127866,1,16127297,1,0
V,-,16118638,0.0,0.0625,4,4,0,0,0,gene,F44G3.1,0,16118613,0.00194479,4218,16122856,25,16118504,134,109
V,-,16118350,0.0,0.5,1,1,0,0,1,gene,F44G3.1,0,16118208,0.00194479,4506,16122856,142,16118504,-154,-296
V,-,16075112,0.0,8.07794e-28,90,90,0,0,4,gene,F14H3.12,0,16075106,0.248868,22509,16097621,6,16075106,6,0
V,-,16058693,0.00252525,0.0,4356,4345,11,11,2,gene,F14H3.6,0,16058682,2.45024,889,16059582,11,16058695,-2,-13
V,-,16054875,0.00286533,0.0,349,348,1,1,0,gene,F14H3.4,0,16054858,0.250013,742,16055617,17,16054858,17,0
V,-,16053276,0.0,9.86076e-32,103,103,0,0,45,gene,F14H3.3,0,16053229,0.181674,425,16053701,47,16053256,20,-27
V,-,16004744,0.0,2.32831e-10,32,32,0,0,0,gene,C06C6.10,0,16004726,None,1361,16006105,18,16004744,0,-18
V,-,16000366,0.0,6.10352e-05,14,14,0,0,22,gene,C06C6.5,0,16000289,0.247055,4177,16004543,77,16000378,-12,-89
V,-,15999463,0.0,7.45058e-09,27,27,0,0,3,gene,C06C6.5,0,15999426,0.247055,5080,16004543,37,15999439,24,-13
V,-,15999439,0.0,0.000488281,11,11,0,0,82,gene,C06C6.5,0,15999426,0.247055,5104,16004543,13,15999439,0,-13
V,-,15982612,0.0,0.015625,6,6,0,0,26,gene,F36G9.14,0,15982594,0.043052,4669,15987281,18,15982657,-45,-63
V,-,15896569,0.047619,1.95769e-10,42,40,2,2,0,gene,T06C12.13,0,15896568,0.0831756,7392,15903961,1,15896571,-2,-3
V,-,15888655,0.00576369,0.0,347,345,2,2,0,gene,T06C12.10,0,15888649,0.272209,5594,15894249,6,15888655,0,-6
V,-,15879410,0.0,0.0,255,255,0,0,0,gene,T06C12.7,1,15879371,0.248386,2386,15881796,39,15879371,39,0
V,-,15876212,0.765957,0.000123756,47,11,36,16,2,gene,T06C12.6,2,15876211,0.120113,332,15876544,1,15876213,-1,-2
V,-,15833898,0.0,0.5,1,1,0,0,0,gene,F54B8.11,0,15833832,0.000531737,3296,15837194,66,15833526,372,306
V,-,15815501,0.0,3.05176e-05,15,15,0,0,13,gene,F54B8.3,0,15815492,0.277947,1711,15817212,9,15815665,-164,-173
V,-,15792311,0.0,0.000976562,10,10,0,0,0,gene,T26E4.4,0,15792288,0.0227912,6703,15799014,23,15792387,-76,-99
V,-,15776435,0.0,0.25,2,2,0,0,1,gene,F57A10.6,0,15776427,0.00609337,1088,15777523,8,15776435,0,-8
V,-,15773045,0.0,0.00195312,9,9,0,0,0,gene,F57A10.5,0,15773030,0.0561941,1703,15774748,15,15773030,15,0
V,-,15773036,0.0,3.72529e-09,28,28,0,0,17,gene,F57A10.5,0,15773030,0.0561941,1712,15774748,6,15773030,6,0
V,-,15765984,0.0,0.5,1,1,0,0,0,gene,F57A10.3,0,15765968,0.749543,4083,15770067,16,15765980,4,-12
V,-,15765976,0.00396825,0.0,504,502,2,1,0,gene,F57A10.3,0,15765968,0.749543,4091,15770067,8,15765976,0,-8
V,-,15718462,0.0,2.38419e-07,22,22,0,0,2,gene,Y6E2A.5,0,15718462,0.146142,6189,15724651,0,15718462,0,0
V,-,15718429,0.0,0.0625,4,4,0,0,5,gene,Y6E2A.5,0,15718429,0.146142,6222,15724651,0,15718462,-33,-33
V,-,15715452,0.0,1.42109e-14,46,46,0,0,1,gene,Y6E2A.4,0,15715448,0.227191,700,15716152,4,15715448,4,0
V,-,15702167,0.0,5.04871e-29,94,94,0,0,1,gene,K06B4.11,0,15702163,0.163479,7215,15709382,4,15702166,1,-3
V,-,15698462,0.0,0.5,1,1,0,0,0,gene,K06B4.9,0,15698435,0,1948,15700410,27,15698003,459,432
V,-,15658871,0.00380228,0.0,526,524,2,2,1,gene,F53E4.1,0,15658865,1.27105,14032,15672903,6,15658871,0,-6
V,-,15610186,0.0204082,8.70415e-14,49,48,1,0,3,gene,B0391.5,0,15610184,0.11059,7936,15618122,2,15610184,2,0
V,-,15605301,1.0,0.5,1,0,1,0,0,gene,B0391.6,0,15605301,0.000835368,174,15605475,0,15604959,342,342
V,-,15580652,0.0,0.00195312,9,9,0,0,2,gene,F28F8.7,1,15580650,0.138058,12612,15593264,2,15580650,2,0
V,-,15578402,0.477273,0.114404,44,23,21,15,2,gene,F28F8.9,2,15578290,0.515315,422,15578824,112,15578322,80,-32
V,-,15578209,0.025641,7.09406e-11,39,38,1,1,0,gene,F28F8.9,2,15578200,0.515315,615,15578824,9,15578207,2,-7
V,-,15577247,0.72,0.014326,25,7,18,12,0,gene,F28F8.6,3,15576975,0.746563,126,15577373,272,15576847,400,128
V,-,15576963,1.0,0.5,1,0,1,1,1,gene,F28F8.6,3,15576946,0.746563,410,15577373,17,15576847,116,99
V,-,15576691,0.466761,0.00629603,707,377,330,247,3,gene,F28F8.6,3,15576682,0.746563,682,15577373,9,15576691,0,-9
V,-,15575207,0.973171,0.0,410,11,399,287,1,gene,F28F8.5,4,15575200,1.14651,95,15575302,7,15575207,0,-7
V,-,15558951,0.0,0.00390625,8,8,0,0,0,gene,F28F8.1,0,15558951,0.0525028,6153,15565104,0,15558951,0,0
V,-,15544687,0.0,9.09495e-13,40,40,0,0,5,gene,F21A3.6,0,15544675,0.0838834,6272,15550959,12,15544675,12,0
V,-,15544679,0.0,5.42101e-20,64,64,0,0,44,gene,F21A3.6,0,15544675,0.0838834,6280,15550959,4,15544675,4,0
V,-,15534352,0.00934579,6.59438e-31,107,106,1,1,1,gene,F21A3.2,0,15534066,0.604393,8558,15542910,286,15533768,584,298
V,-,15533768,0.0,7.62939e-06,17,17,0,0,1,gene,F21A3.2,0,15533768,0.604393,9142,15542910,0,15533768,0,0
V,-,15521823,0.0,3.46945e-18,58,58,0,0,1,gene,F21A3.8,0,15521818,0.121303,8762,15530585,5,15521825,-2,-7
V,-,15444077,0.0,0.125,3,3,0,0,3,gene,T26H5.10,0,15444008,0.0998888,3283,15447360,69,15443613,464,395
V,-,15443611,0.0,2.77556e-17,55,55,0,0,3,gene,T26H5.10,0,15443599,0.0998888,171,15443782,12,15443613,-2,-14
V,-,15432526,0.0,0.25,2,2,0,0,1,gene,T26H5.8,0,15432477,0.0740778,6340,15438866,49,15432372,154,105
V,-,15432282,0.0,0.03125,5,5,0,0,0,gene,T26H5.8,0,15432243,0.0740778,6584,15438866,39,15432372,-90,-129
V,-,15424982,0.0,0.25,2,2,0,0,2,gene,Y36E3A.1,0,15424977,0.117857,1418,15426400,5,15424982,0,-5
V,-,15424726,0.0,0.5,1,1,0,0,0,gene,Y36E3A.1,0,15424673,0.117857,1674,15426400,53,15424726,0,-53
V,-,15399604,0.0,0.000976562,10,10,0,0,2,gene,T06E6.15,0,15399597,0.0216273,11633,15411237,7,15399597,7,0
V,-,15394761,0.0127389,6.72623e-44,157,155,2,2,1,gene,T06E6.1,0,15394756,0.814577,2391,15397152,5,15394761,0,-5
V,-,15360544,0.0,3.46945e-18,58,58,0,0,0,gene,C29F3.1,0,15360544,0.333648,3516,15364060,0,15360544,0,0
V,-,15265461,0.0,0.5,1,1,0,0,3,gene,T10H4.14,0,15265449,None,1288,15266749,12,15265461,0,-12
V,-,15262048,0.025,2.61389e-21,80,78,2,1,1,gene,M01B2.10,0,15262029,0.21205,761,15262809,19,15262272,-224,-243
V,-,15262040,0.0,0.125,3,3,0,0,101,gene,M01B2.10,0,15262029,0.21205,769,15262809,11,15262272,-232,-243
V,-,15187192,0.0166667,5.37154e-33,120,118,2,2,38,gene,Y75B12B.2,0,15187166,36.3102,6346,15193538,26,15187184,8,-18
V,-,15187184,0.00520715,0.0,13251,13182,69,60,149,gene,Y75B12B.2,0,15187166,36.3102,6354,15193538,18,15187184,0,-18
V,-,15166124,0.0,2.86986e-42,138,138,0,0,0,gene,T09F5.12,0,15166119,None,7836,15173960,5,15166126,-2,-7
V,-,15136607,0.0,0.0,1540,1540,0,0,11,gene,K08F9.2,0,15136606,1.457,470,15137077,1,15136607,0,-1
V,-,15132328,0.0,0.0625,4,4,0,0,0,gene,T01G5.5,0,15132322,0.00312795,1676,15134004,6,15132322,6,0
V,-,15119003,0.0,0.5,1,1,0,0,0,gene,T01G5.1,0,15118950,0.182191,2590,15121593,53,15118467,536,483
V,-,15085188,0.0113379,0.0,1323,1308,15,15,0,gene,C01G10.8,0,15085179,5.94949,1531,15086719,9,15085188,0,-9
V,-,15082024,0.0,0.0625,4,4,0,0,38,gene,C01G10.10,0,15081927,0.251335,1841,15083865,97,15082285,-261,-358
V,-,15063891,0.00597015,0.0,335,333,2,2,6,gene,C25D7.7,0,15063878,1.33089,9460,15073351,13,15063878,13,0
V,-,15059405,0.00829876,0.0,723,717,6,6,18,gene,C25D7.6,0,15059400,2.31452,1925,15061330,5,15059405,0,-5
V,-,15048013,0.027027,2.6921e-10,37,36,1,1,1,gene,C25D7.3,0,15047987,0.193592,2806,15050819,26,15047597,416,390
V,-,15047607,0.0,0.5,1,1,0,0,0,gene,C25D7.3,0,15047597,0.193592,3212,15050819,10,15047597,10,0
V,-,15014099,0.0,1.86265e-09,29,29,0,0,2,gene,F14H8.1,1,15014028,1.12645,4929,15019028,71,15014028,71,0
V,-,15014011,0.00952381,0.0,210,208,2,1,30,gene,F14H8.1,1,15013998,1.12645,5017,15019028,13,15014000,11,-2
V,-,15001952,0.0,0.0625,4,4,0,0,58,gene,T01C3.7,1,15001932,10.8427,4208,15006160,20,15002001,-49,-69
V,-,15001913,0.0,0.0,180,180,0,0,90,gene,T01C3.7,1,15001888,10.8427,4247,15006160,25,15002001,-88,-113
V,-,15001775,0.00277469,0.0,1802,1797,5,5,13,gene,T01C3.7,1,15001774,10.8427,4385,15006160,1,15001775,0,-1
V,-,15000347,0.709676,0.0,49214,14288,34926,22262,53,gene,T01C3.6,2,15000343,102.28,106,15000453,4,15000347,0,-4
V,-,14992483,0.00662252,0.0,1359,1350,9,8,0,gene,T01C3.3,0,14992478,1.28582,7337,14999820,5,14992483,0,-5
V,-,14990930,0.0,0.125,3,3,0,0,1,gene,T01C3.1,0,14990887,0.474051,578,14991508,43,14990830,100,57
V,-,14990725,0.0206186,0.0,291,285,6,5,0,gene,T01C3.1,0,14990718,0.474051,783,14991508,7,14990725,0,-7
V,-,14973787,0.0,0.0078125,7,7,0,0,0,gene,F02D8.1,0,14973765,0.0142577,13568,14987355,22,14973787,0,-22
V,-,14946938,0.0,0.0625,4,4,0,0,5,gene,C30G7.4,0,14946928,0.0765023,7886,14954824,10,14946938,0,-10
V,-,14921417,0.00621118,0.0,161,160,1,1,3,gene,W09D12.1,0,14921409,0.836048,1344,14922761,8,14921417,0,-8
V,-,14908955,0.0,1.11022e-16,53,53,0,0,21,gene,H12D21.9,0,14908927,0.167607,8589,14917544,28,14908927,28,0
V,-,14908930,0.0,2.52435e-29,95,95,0,0,88,gene,H12D21.9,0,14908927,0.167607,8614,14917544,3,14908927,3,0
V,-,14876465,0.00111607,0.0,896,895,1,1,0,gene,ZC412.10,0,14876460,None,2872,14879337,5,14876465,0,-5
V,-,14875270,0.0,0.0625,4,4,0,0,1,gene,ZC412.5,0,14875236,0.0849953,482,14875752,34,14875236,34,0
V,-,14871244,0.00223214,0.0,448,447,1,0,144,gene,ZC412.3,0,14871239,3.88577,409,14871653,5,14871244,0,-5
V,-,14871240,0.0,4.44089e-16,51,51,0,0,62,gene,ZC412.3,0,14871239,3.88577,413,14871653,1,14871240,0,-1
V,-,14858397,0.0,0.125,3,3,0,0,1,gene,ZC412.1,0,14858373,0.0302549,4577,14862974,24,14858373,24,0
V,-,14838180,0.00251889,0.0,1191,1188,3,2,1,gene,W06A7.3,0,14838117,12.6715,14453,14852633,63,14838180,0,-63
V,-,14836225,0.333333,0.375,3,2,1,0,4,gene,W06A7.3,0,14836137,12.6715,16408,14852633,88,14836225,0,-88
V,-,14834380,0.00408163,0.0,490,488,2,2,2,gene,W06A7.3,0,14834380,12.6715,18253,14852633,0,14834380,0,0
V,-,14831429,0.003615,0.0,2213,2205,8,3,6,gene,W06A7.3,0,14831395,12.6715,21204,14852633,34,14831429,0,-34
V,-,14814248,0.0122449,0.0,245,242,3,2,0,gene,C48G7.3,0,14814221,1.0268,12508,14826756,27,14814248,0,-27
V,-,14813117,0.0,0.015625,6,6,0,0,4,gene,C48G7.3,0,14813053,1.0268,13639,14826756,64,14813117,0,-64
V,-,14811318,0.0,1.90735e-06,19,19,0,0,0,gene,C48G7.3,0,14811256,1.0268,15438,14826756,62,14811318,0,-62
V,-,14810157,0.0,0.03125,5,5,0,0,0,gene,C48G7.3,0,14810133,1.0268,16599,14826756,24,14810157,0,-24
V,-,14804634,0.0,1.19209e-07,23,23,0,0,0,gene,C48G7.3,0,14804617,1.0268,22122,14826756,17,14804634,0,-17
V,-,14801985,0.0,0.5,1,1,0,0,1,gene,C48G7.3,0,14801798,1.0268,24771,14826756,187,14801985,0,-187
V,-,14801705,0.0,0.0078125,7,7,0,0,2,gene,C48G7.3,0,14801538,1.0268,25051,14826756,167,14801705,0,-167
V,-,14798875,0.0,0.25,2,2,0,0,0,gene,C48G7.3,0,14798865,1.0268,27881,14826756,10,14798875,0,-10
V,-,14797411,0.0,0.5,1,1,0,0,0,gene,C48G7.3,0,14797400,1.0268,29345,14826756,11,14797411,0,-11
V,-,14796282,0.0,0.03125,5,5,0,0,0,gene,C48G7.3,0,14796268,1.0268,30474,14826756,14,14796282,0,-14
V,-,14789507,0.0,1.2326e-32,106,106,0,0,1,gene,C48G7.3,0,14789025,1.0268,37249,14826756,482,14789507,0,-482
V,-,14787576,0.0,1.49012e-08,26,26,0,0,0,gene,C48G7.3,0,14787531,1.0268,39180,14826756,45,14787576,0,-45
V,-,14748900,0.0,0.0,208,208,0,0,3,gene,Y50E8A.7,0,14748895,0.0307914,1261,14750161,5,14748516,384,379
V,-,14733685,0.00289017,0.0,3806,3795,11,8,6,gene,Y50E8A.4,0,14733652,2.04574,771,14734456,33,14733685,0,-33
V,-,14696462,0.00137174,0.0,729,728,1,0,96,gene,C47E8.7,0,14696437,2.3635,17557,14714019,25,14696462,0,-25
V,-,14685293,0.0,0.0,541,541,0,0,0,gene,C47E8.4,0,14685285,0.849708,6365,14691658,8,14685360,-67,-75
V,-,14645609,0.0,5.68434e-14,44,44,0,0,0,gene,C54G10.2,0,14645553,1.01829,7646,14653255,56,14645609,0,-56
V,-,14637559,0.00662252,5.32493e-44,151,150,1,0,6,gene,F43D2.2,0,14637559,0.100539,909,14638468,0,14637559,0,0
V,-,14612043,0.0,0.125,3,3,0,0,0,gene,R11H6.5,0,14612039,1.15813,17100,14629143,4,14612030,13,9
V,-,14612030,0.0200445,0.0,449,440,9,8,5,gene,R11H6.5,0,14612023,1.15813,17113,14629143,7,14612030,0,-7
V,-,14596842,0.00593824,0.0,1684,1674,10,7,5,gene,R11H6.1,0,14596841,3.78904,13682,14610524,1,14596842,0,-1
V,-,14593425,0.0,0.000488281,11,11,0,0,0,gene,R11H6.6,0,14593416,None,1668,14595093,9,14593447,-22,-31
V,-,14579527,0.0,7.62939e-06,17,17,0,0,0,gene,Y40H4A.1,0,14579382,0.233295,3583,14583110,145,14579527,0,-145
V,-,14569802,0.0168067,1.0564e-32,119,117,2,2,0,gene,Y40H4A.1,0,14569783,0.233295,13308,14583110,19,14569802,0,-19
V,-,14555966,0.0,0.5,1,1,0,0,0,gene,C53A5.8,0,14555854,0.000828579,870,14556836,112,14556095,-129,-241
V,-,14545674,0.0165289,0.0,242,238,4,3,0,gene,C53A5.6,0,14545629,0.617549,9112,14554786,45,14545629,45,0
V,-,14536121,0.0,0.00195312,9,9,0,0,4,gene,C53A5.4,0,14536117,0.150725,7370,14543491,4,14536117,4,0
V,-,14523937,0.00312305,0.0,1601,1596,5,3,1,gene,C53A5.1,1,14523919,23.8492,10281,14534218,18,14523937,0,-18
V,-,14523929,0.00334569,0.0,11059,11022,37,35,2327,gene,C53A5.1,1,14523919,23.8492,10289,14534218,10,14523929,0,-10
V,-,14522422,0.933824,3.84216e-28,136,9,127,85,2,gene,C53A5.16,3,14522422,None,109,14522531,0,14522422,0,0
V,-,14520908,0.878788,1.4584e-15,99,12,87,56,0,gene,C53A5.17,4,14520893,None,108,14521016,15,14520908,0,-15
V,-,14519176,0.948187,1.24155e-42,193,10,183,134,4,gene,R02D5.8,5,14519176,None,99,14519275,0,14519176,0,0
V,-,14519145,0.5,0.375,4,2,2,2,140,gene,R02D5.8,5,14518966,None,130,14519275,179,14519176,-31,-210
V,-,14464487,0.0,0.5,1,1,0,0,0,gene,F08H9.4,0,14464464,0.626269,339,14464826,23,14464182,305,282
V,-,14456717,0.00995025,0.0,201,199,2,2,4,gene,F23B12.8,0,14456687,0.986713,5032,14461749,30,14456698,19,-11
V,-,14456669,0.0,0.25,2,2,0,0,0,gene,F23B12.8,0,14456654,0.986713,5080,14461749,15,14456698,-29,-44
V,-,14456535,0.010101,1.56194e-28,99,98,1,1,77,gene,F23B12.8,0,14456523,0.986713,5214,14461749,12,14456536,-1,-13
V,-,14447098,0.0113544,0.0,1233,1219,14,12,0,gene,F23B12.5,0,14447095,4.57457,6013,14453111,3,14447098,0,-3
V,-,14424815,0.00384739,0.0,3119,3107,12,10,1,gene,C15H11.9,1,14424811,2.66262,6302,14431117,4,14424815,0,-4
V,-,14423131,0.1,0.00976562,10,9,1,1,425,gene,C15H11.8,2,14423105,1.45097,458,14423589,26,14423111,20,-6
V,-,14423111,0.21978,0.0,1001,781,220,167,284,gene,C15H11.8,2,14423105,1.45097,478,14423589,6,14423111,0,-6
V,-,14422425,0.897418,0.0,1433,147,1286,901,1,gene,C15H11.7,3,14422425,4.57601,102,14422527,0,14422425,0,0
V,-,14421256,0.826087,3.70808e-06,46,8,38,26,9,gene,C15H11.4,4,14421234,3.06605,24,14421280,22,14421247,9,-13
V,-,14421247,0.760933,8.40779e-45,686,164,522,330,123,gene,C15H11.4,4,14421234,3.06605,33,14421280,13,14421247,0,-13
V,-,14417605,0.0333333,9.48996e-23,90,87,3,3,179,gene,C15H11.6,0,14417602,0.511932,2273,14419878,3,14417605,0,-3
V,-,14414821,0.0165877,0.0,422,415,7,6,1,gene,C15H11.3,0,14414819,2.00915,1101,14415922,2,14414821,0,-2
V,-,14378886,0.0,0.000488281,11,11,0,0,0,gene,F56A12.2,0,14378873,0.0476019,29983,14408869,13,14378873,13,0
V,-,14322689,0.0,0.0625,4,4,0,0,48,gene,F47B8.3,0,14322683,0.508025,667,14323356,6,14322730,-41,-47
V,-,14319540,0.0,0.25,2,2,0,0,2,gene,F47B8.13,0,14319538,4.08818,1638,14321178,2,14319538,2,0
V,-,14316432,0.000375375,0.0,2664,2663,1,0,2,gene,F47B8.2,0,14316431,1.43354,2258,14318690,1,14316431,1,0
V,-,14312596,0.0,0.000488281,11,11,0,0,0,gene,F14D7.8,0,14312595,0.0498159,968,14313564,1,14312595,1,0
V,-,14297946,0.0,3.8147e-06,18,18,0,0,0,gene,F14D7.4,0,14297939,None,1008,14298954,7,14297913,33,26
V,-,14293517,0.0,0.0,195,195,0,0,1,gene,F14D7.2,0,14293513,0.448379,2057,14295574,4,14293519,-2,-6
V,-,14270447,0.0,2.06795e-25,82,82,0,0,1,gene,F40G12.5,0,14270443,0.32337,492,14270939,4,14270453,-6,-10
V,-,14247884,0.0,3.72529e-09,28,28,0,0,38,gene,K02E11.4,0,14247882,0.506668,5412,14253296,2,14247882,2,0
V,-,14247850,0.0,9.53674e-07,20,20,0,0,432,gene,K02E11.4,0,14247807,0.506668,5446,14253296,43,14247882,-32,-75
V,-,14240958,0.000904977,0.0,1105,1104,1,0,2,gene,K02E11.10,0,14240958,1.13038,5088,14246046,0,14240958,0,0
V,-,14226274,0.0526316,3.62396e-05,19,18,1,0,0,gene,K02E11.11,0,14226252,None,5810,14232084,22,14226221,53,31
V,-,14220509,0.0,3.8147e-06,18,18,0,0,30,gene,T16A9.4,0,14220447,0.314755,5354,14225863,62,14220509,0,-62
V,-,14185294,0.0333333,2.79397e-08,30,29,1,1,0,gene,ZC376.5,0,14185276,0.865932,16089,14201383,18,14185294,0,-18
V,-,14167534,0.0,0.125,3,3,0,0,0,gene,T02B5.2,0,14167528,0.00585779,635,14168169,6,14167528,6,0
V,-,14145218,0.0,6.93889e-18,57,57,0,0,0,gene,AH10.3,0,14145174,0.0611633,12251,14157469,44,14145218,0,-44
V,-,14140943,0.0,3.8147e-06,18,18,0,0,9,gene,H39E23.1,0,14140926,2.70409,3901,14144844,17,14140926,17,0
V,-,14137671,0.0,1.16415e-10,33,33,0,0,0,gene,AH10.4,0,14137660,0.006214,7173,14144844,11,14137447,224,213
V,-,14129244,0.0,0.5,1,1,0,0,1,gene,H39E23.1,0,14129219,2.70409,7909,14137153,25,14128792,452,427
V,-,14128792,0.0,0.25,2,2,0,0,55,gene,H39E23.1,0,14128645,2.70409,8361,14137153,147,14128792,0,-147
V,-,14098418,0.0,1.52588e-05,16,16,0,0,203,gene,D1086.2,0,14098366,0.230164,13428,14111846,52,14098413,5,-47
V,-,14038179,0.00305188,0.0,983,980,3,2,3,gene,T08G5.5,0,14038156,0.888485,7072,14045251,23,14038179,0,-23
V,-,14011859,0.0,0.0,389,389,0,0,13,gene,F58E10.3,0,14011623,11.3767,3924,14015783,236,14011859,0,-236
V,-,14011783,0.0,6.77626e-21,67,67,0,0,64,gene,F58E10.3,0,14011623,11.3767,4000,14015783,160,14011748,35,-125
V,-,14011748,0.00136343,0.0,6601,6592,9,5,147,gene,F58E10.3,0,14011623,11.3767,4035,14015783,125,14011748,0,-125
V,-,14011728,0.0,0.015625,6,6,0,0,8603,gene,F58E10.3,0,14011623,11.3767,4055,14015783,105,14011728,0,-105
V,-,14011674,0.00713267,0.0,701,696,5,5,255,gene,F58E10.3,0,14011623,11.3767,4109,14015783,51,14011674,0,-51
V,-,14011671,0.0,1.35525e-20,66,66,0,0,266,gene,F58E10.3,0,14011623,11.3767,4112,14015783,48,14011672,-1,-49
V,-,14005886,0.320442,1.92615e-12,362,246,116,100,0,gene,F58E10.1,0,14005883,0.948647,1272,14007158,3,14005886,0,-3
V,-,13982793,0.0,0.000976562,10,10,0,0,4,gene,T26F2.2,0,13982778,0.466008,4183,13986976,15,13982778,15,0
V,-,13980544,0.0,0.0,172,172,0,0,271,gene,T26F2.3,0,13980519,None,734,13981278,25,13980714,-170,-195
V,-,13961784,0.00161031,0.0,621,620,1,1,0,gene,R10D12.12,0,13961762,0.907671,4282,13966066,22,13961784,0,-22
V,-,13934453,0.0,0.0,192,192,0,0,0,gene,R10D12.1,0,13934443,0.479724,5499,13939952,10,13934453,0,-10
V,-,13908775,0.0046875,0.0,1280,1274,6,4,9,gene,C06B3.6,0,13908766,2.72058,3129,13911904,9,13908775,0,-9
V,-,13826875,0.0,4.76837e-07,21,21,0,0,1,gene,F55B12.11,0,13826874,None,26551,13853426,1,13826859,16,15
V,-,13807045,0.00210084,0.0,952,950,2,2,1,gene,F53C11.8,1,13807019,1.29532,8135,13815180,26,13807045,0,-26
V,-,13804089,0.842623,4.38134e-36,305,48,257,146,9,gene,F53C11.7,2,13803943,1.30437,114,13804203,146,13804089,0,-146
V,-,13803538,0.0,2.91038e-11,35,35,0,0,1,gene,F53C11.7,2,13803532,1.30437,665,13804203,6,13803538,0,-6
V,-,13787940,0.0,0.03125,5,5,0,0,2,gene,F53C11.4,0,13787919,2.2683,12843,13800783,21,13787520,420,399
V,-,13787302,0.0,0.0,653,653,0,0,1,gene,F53C11.4,0,13787251,2.2683,13481,13800783,51,13787520,-218,-269
V,-,13786972,0.00178253,0.0,561,560,1,1,18,gene,F53C11.4,0,13786945,2.2683,151,13787123,27,13786972,0,-27
V,-,13786895,0.0,0.25,2,2,0,0,46,gene,F53C11.4,0,13786824,2.2683,228,13787123,71,13786972,-77,-148
V,-,13756530,0.0,7.62939e-06,17,17,0,0,0,gene,F20G2.2,0,13756450,1.59411,9204,13765734,80,13756218,312,232
V,-,13756218,0.0,0.0,844,844,0,0,1,gene,F20G2.2,0,13756202,1.59411,9516,13765734,16,13756218,0,-16
V,-,13756215,0.0,1.86265e-09,29,29,0,0,19,gene,F20G2.2,0,13756202,1.59411,9519,13765734,13,13756218,-3,-16
V,-,13753388,0.0,1.90735e-06,19,19,0,0,0,gene,F20G2.1,0,13753373,0.0530674,1426,13754814,15,13753373,15,0
V,-,13751728,0.0,0.00390625,8,8,0,0,7,gene,F35E12.8,0,13751700,0.333147,348,13752076,28,13751730,-2,-30
V,-,13744697,0.0,1.29247e-26,86,86,0,0,18,gene,F35E12.9,0,13744687,0.475682,808,13745505,10,13744690,7,-3
V,-,13738283,0.00361736,0.0,4976,4958,18,16,41,gene,F35E12.5,1,13738280,6.52042,2855,13741138,3,13738280,3,0
V,-,13735963,0.003386,0.0,886,883,3,1,0,gene,F35E12.6,2,13735960,3.38751,854,13736817,3,13735963,0,-3
V,-,13730585,0.00414938,0.0,241,240,1,1,6,gene,F35E12.7,0,13730582,0.477787,703,13731288,3,13730585,0,-3
V,-,13722439,0.0,0.25,2,2,0,0,0,gene,F35E12.2,0,13722419,0.00225489,974,13723413,20,13722439,0,-20
V,-,13715082,0.0,0.0,291,291,0,0,3,gene,T01D3.5,0,13715079,1.06029,6964,13722046,3,13715082,0,-3
V,-,13678397,0.00355872,0.0,281,280,1,1,2,gene,F58G11.5,0,13678392,0.511429,27381,13705778,5,13678397,0,-5
V,-,13671821,0.0,0.00012207,13,13,0,0,1,gene,F58G11.3,0,13671752,0.690047,3975,13675796,69,13671758,63,-6
V,-,13671766,0.0,0.0,547,547,0,0,15,gene,F58G11.3,0,13671752,0.690047,4030,13675796,14,13671758,8,-6
V,-,13653940,0.00288462,0.0,1040,1037,3,3,2,gene,H37A05.1,0,13653838,2.14608,15223,13669163,102,13653940,0,-102
V,-,13634058,0.0,4.65661e-10,31,31,0,0,0,gene,H37A05.2,0,13634031,0.0270532,5106,13639164,27,13634031,27,0
V,-,13625378,0.00814619,0.0,4542,4505,37,34,8,gene,F53F4.10,1,13625360,7.88858,4272,13629650,18,13625378,0,-18
V,-,13624332,0.955943,0.0,1203,53,1150,791,0,gene,F53F4.11,2,13624332,2.87091,99,13624431,0,13624332,0,0
V,-,13621631,0.828814,0.0,1180,202,978,686,1,gene,F53F4.16,3,13621631,2.31863,285,13621916,0,13621631,0,0
V,-,13606512,0.0,1.79366e-43,142,142,0,0,1,gene,F53F4.5,0,13606505,1.08875,4608,13611120,7,13606512,0,-7
V,-,13600786,0.0,4.44089e-16,51,51,0,0,17,gene,F53F4.6,0,13600595,0.136778,2349,13603135,191,13600793,-7,-198
V,-,13568439,0.0035461,0.0,282,281,1,1,118,gene,C50B8.3,0,13568438,0.48653,19957,13588396,1,13568438,1,0
V,-,13568419,0.0,0.015625,6,6,0,0,1577,gene,C50B8.3,0,13568016,0.48653,19977,13588396,403,13568438,-19,-422
V,-,13556202,0.0,0.0,374,374,0,0,3,gene,C56A3.6,0,13556195,0.846021,5584,13561786,7,13556202,0,-7
V,-,13551306,0.0,6.10352e-05,14,14,0,0,97,gene,C56A3.4,0,13551105,0.975901,1879,13553185,201,13551032,274,73
V,-,13535916,0.0,0.000488281,11,11,0,0,0,gene,C56A3.3,0,13535915,0.0511656,14409,13550325,1,13535915,1,0
V,-,13530554,0.00167504,0.0,1791,1788,3,2,30,gene,C56A3.2,0,13530550,4.50421,918,13531472,4,13530554,0,-4
V,-,13530544,0.0,0.015625,6,6,0,0,5833,gene,C56A3.2,0,13530514,4.50421,928,13531472,30,13530554,-10,-40
V,-,13502392,0.0,1.45519e-11,36,36,0,0,4,gene,R11G10.1,0,13502318,0.483717,9374,13511766,74,13502392,0,-74
V,-,13502389,0.0,2.91038e-11,35,35,0,0,2,gene,R11G10.1,0,13502318,0.483717,9377,13511766,71,13502392,-3,-74
V,-,13497182,0.0,0.0,323,323,0,0,11,gene,T10G3.5,0,13497177,0.455487,1409,13498591,5,13497182,0,-5
V,-,13490034,0.0,0.00390625,8,8,0,0,0,gene,T10G3.3,0,13489914,0.579681,843,13490877,120,13489436,598,478
V,-,13489436,0.00554017,0.0,361,359,2,2,0,gene,T10G3.3,0,13489436,0.579681,1441,13490877,0,13489436,0,0
V,-,13476190,0.0,0.015625,6,6,0,0,32,gene,T10G3.8,0,13476184,None,1002,13477192,6,13476184,6,0
V,-,13437355,0.00319489,0.0,313,312,1,1,1,gene,Y2H9A.1,0,13437323,0.66803,26331,13463686,32,13437355,0,-32
V,-,13428579,0.0,0.25,2,2,0,0,0,gene,F53F1.11,0,13428570,0.000127789,1880,13430459,9,13428570,9,0
V,-,13417422,0.0,3.9443e-31,101,101,0,0,0,gene,F53F1.6,0,13417415,0.165931,1603,13419025,7,13417415,7,0
V,-,13391204,0.0,0.0,654,654,0,0,0,gene,M04G12.4,0,13391196,1.62379,13181,13404385,8,13391204,0,-8
V,-,13389301,0.0,2.06795e-25,82,82,0,0,2,gene,M04G12.4,0,13389295,1.62379,15084,13404385,6,13389301,0,-6
V,-,13372598,0.0,4.1359e-25,81,81,0,0,18,gene,M04G12.1,0,13372598,1.0252,10232,13382830,0,13372598,0,0
V,-,13333204,0.0,8.27181e-25,80,80,0,0,2,gene,C50B6.8,1,13333197,0.089606,4596,13337800,7,13333204,0,-7
V,-,13330830,0.853659,2.04472e-06,41,6,35,14,0,gene,C50B6.14,2,13330822,0.0830869,96,13330926,8,13330822,8,0
V,-,13324788,0.0,0.0,216,216,0,0,0,gene,C50B6.7,0,13324784,0.589333,4214,13329002,4,13324781,7,3
V,-,13318076,0.0,0.25,2,2,0,0,0,gene,C50B6.4,0,13318075,2.96967,4100,13322176,1,13317821,255,254
V,-,13312071,0.00399493,0.0,10263,10222,41,38,5,gene,C50B6.2,0,13312056,5.53035,4768,13316839,15,13312071,0,-15
V,-,13292208,0.0,0.00390625,8,8,0,0,0,gene,F32F2.1,0,13292203,0.704704,17785,13309993,5,13292203,5,0
V,-,13283816,0.03125,1.09288e-16,64,62,2,1,0,gene,F32F2.1,0,13283792,0.704704,26177,13309993,24,13283816,0,-24
V,-,13259121,0.0,5.96046e-08,24,24,0,0,2,gene,C34D1.4,0,13259102,0.37991,9691,13268812,19,13259102,19,0
V,-,13259115,0.0,0.0,262,262,0,0,6,gene,C34D1.4,0,13259102,0.37991,9697,13268812,13,13259102,13,0
V,-,13249346,0.0,1.49012e-08,26,26,0,0,0,gene,C34D1.3,0,13249344,0.151689,7398,13256744,2,13249344,2,0
V,-,13236415,0.0,1.11022e-16,53,53,0,0,5,gene,C34D1.2,0,13236414,0.0956983,9751,13246166,1,13236414,1,0
V,-,13225753,0.0,0.0,223,223,0,0,4,gene,C34D1.1,0,13225751,0.452582,10226,13235979,2,13225751,2,0
V,-,13201909,0.0,0.015625,6,6,0,0,2,gene,F57B1.4,0,13201909,4.61463,20054,13221963,0,13201909,0,0
V,-,13199125,0.0,0.25,2,2,0,0,10,gene,F57B1.3,0,13199125,4.29167,1665,13200790,0,13199125,0,0
V,-,13193348,0.00224048,0.0,1339,1336,3,2,0,gene,F57B1.2,0,13193337,0.841998,393,13193741,11,13193348,0,-11
V,-,13137926,0.0,0.125,3,3,0,0,0,gene,B0365.6,0,13137903,2.23844,43462,13181388,23,13137895,31,8
V,-,13129804,0.00330033,0.0,4242,4228,14,10,3,gene,B0365.3,0,13129796,14.4584,1932,13131736,8,13129804,0,-8
V,-,13110146,0.0340909,3.54576e-22,88,85,3,0,0,gene,C34B4.1,0,13110144,0.296032,10566,13120712,2,13110146,0,-2
V,-,13103486,0.0,1.81899e-12,39,39,0,0,3,gene,C34B4.1,0,13103426,0.296032,17226,13120712,60,13103486,0,-60
V,-,13053634,0.0,0.0625,4,4,0,0,4,gene,W07G4.6,0,13053544,0.105973,12876,13066510,90,13053719,-85,-175
V,-,13052282,0.0,0.5,1,1,0,0,0,gene,W07G4.6,0,13052282,0.105973,14228,13066510,0,13052042,240,240
V,-,13052042,0.0,3.05176e-05,15,15,0,0,1,gene,W07G4.6,0,13052028,0.105973,14468,13066510,14,13052042,0,-14
V,-,13041532,0.0,0.0,190,190,0,0,30,gene,W07G4.3,0,13041530,1.27859,7267,13048799,2,13041530,2,0
V,-,13008734,0.00337268,0.0,1779,1773,6,4,5,gene,F15B9.10,0,13008727,None,1357,13010091,7,13008734,0,-7
V,-,12976149,0.0,4.65661e-10,31,31,0,0,0,gene,R186.5,0,12976139,0.117418,16415,12992564,10,12976151,-2,-12
V,-,12967632,0.00317965,0.0,1258,1254,4,4,12,gene,R186.8,1,12967601,1.40916,5564,12973196,31,12967632,0,-31
V,-,12967519,0.0,0.5,1,1,0,0,68,gene,R186.8,1,12967487,1.40916,5677,12973196,32,12967632,-113,-145
V,-,12967018,0.922948,0.0,597,46,551,342,8,gene,R186.3,2,12967016,1.23096,98,12967116,2,12967018,0,-2
V,-,12960943,0.0,5.42101e-20,64,64,0,0,1,gene,R186.6,0,12960937,0.168706,404,12961347,6,12960957,-14,-20
V,-,12950468,0.0,1.50463e-36,119,119,0,0,0,gene,T16G1.9,0,12950464,0.911805,4563,12955031,4,12950466,2,-2
V,-,12934854,0.0,0.0625,4,4,0,0,49,gene,T16G1.7,0,12934826,0.484067,494,12935348,28,12934860,-6,-34
V,-,12903904,0.5,0.5,2,1,1,0,6,gene,R90.2,0,12903891,0.615251,117,12904021,13,12903906,-2,-15
V,-,12895680,0.0,0.0,195,195,0,0,0,gene,R90.1,0,12895678,1.1563,7679,12903359,2,12895680,0,-2
V,-,12885768,0.0,0.0,179,179,0,0,17,gene,R90.5,0,12885762,0.28647,5555,12891323,6,12885768,0,-6
V,-,12869843,0.00431965,0.0,463,461,2,1,64,gene,T07F10.3,0,12869840,0.761992,11999,12881842,3,12869843,0,-3
V,-,12849671,0.0,1.13687e-13,43,43,0,0,12,gene,C44H9.5,0,12849619,0.182398,3040,12852711,52,12849605,66,14
V,-,12845137,0.0,0.015625,6,6,0,0,2,gene,C44H9.6,0,12845130,0.15068,759,12845896,7,12845137,0,-7
V,-,12844642,0.0,4.65661e-10,31,31,0,0,4,gene,C44H9.6,0,12844612,0.15068,1254,12845896,30,12844642,0,-30
V,-,12818845,0.0,0.00195312,9,9,0,0,78,gene,ZC443.4,0,12818770,0.393236,23455,12842300,75,12819116,-271,-346
V,-,12813929,0.0,0.0,327,327,0,0,0,gene,ZC443.3,0,12813927,1.05834,2795,12816724,2,12813929,0,-2
V,-,12810998,0.0144928,1.16891e-19,69,68,1,0,1,gene,ZC443.2,0,12810965,0.168477,1096,12812094,33,12810965,33,0
V,-,12797815,0.0,0.25,2,2,0,0,57,gene,ZC455.4,0,12797800,0.539721,309,12798124,15,12797962,-147,-162
V,-,12790388,1.0,0.5,1,0,1,1,0,gene,ZC455.8,0,12790367,2.51579e-05,117,12790505,21,12790326,62,41
V,-,12763183,0.0,0.0,806,806,0,0,6,gene,F18E2.2,0,12763168,1.34233,19845,12783028,15,12763183,0,-15
V,-,12759568,0.0,0.0,337,337,0,0,0,gene,F18E2.1,0,12759568,0.533838,1083,12760651,0,12759568,0,0
V,-,12759528,0.0,0.00195312,9,9,0,0,115,gene,F18E2.1,0,12759521,0.533838,1123,12760651,7,12759568,-40,-47
V,-,12754736,0.0,0.00390625,8,8,0,0,0,gene,F18E2.5,0,12754719,0.0249902,2683,12757419,17,12754701,35,18
V,-,12751347,0.0,6.10352e-05,14,14,0,0,1,gene,C15C8.6,0,12751332,0.0405274,64,12751411,15,12751403,-56,-71
V,-,12747271,0.00680272,0.0,441,438,3,2,1,gene,C15C8.4,1,12747271,0.741857,2513,12749784,0,12747271,0,0
V,-,12744858,0.599686,1.93907e-13,1274,510,764,534,4,gene,C15C8.7,2,12744858,2.9144,150,12745008,0,12744858,0,0
V,-,12727920,0.00244624,0.0,72356,72179,177,168,1,gene,R11D1.8,0,12727915,83.5606,3660,12731580,5,12727920,0,-5
V,-,12695063,0.0192308,2.64071e-28,104,102,2,2,0,gene,K10C8.1,0,12695062,0.188816,11183,12706246,1,12695062,1,0
V,-,12660138,0.00175747,0.0,1707,1704,3,3,1,gene,W05B10.1,1,12660134,3.46691,937,12661075,4,12660138,0,-4
V,-,12659297,0.758621,2.63874e-39,609,147,462,406,0,gene,W05B10.2,2,12659289,0.507125,214,12659511,8,12659297,0,-8
V,-,12598958,0.00692042,0.0,289,287,2,1,0,gene,C14C10.3,1,12598920,1.68326,1417,12600375,38,12598958,0,-38
V,-,12596103,0.947805,0.0,843,44,799,595,0,gene,C14C10.4,2,12596103,0.937219,93,12596196,0,12596103,0,0
V,-,12592284,0.968085,6.76749e-24,94,3,91,67,0,gene,C14C10.2,3,12592283,0.172435,91,12592375,1,12592284,0,-1
V,-,12590470,0.0,0.25,2,2,0,0,68,gene,C14C10.7,0,12590462,0.332305,313,12590783,8,12590462,8,0
V,-,12576702,0.000997258,0.0,4011,4007,4,2,1,gene,E02A10.2,0,12576701,18.6878,12737,12589439,1,12576701,1,0
V,-,12567765,0.0,0.5,1,1,0,0,0,gene,E02A10.4,0,12567732,0.620067,7235,12575000,33,12567757,8,-25
V,-,12567755,0.0026738,0.0,374,373,1,1,3,gene,E02A10.4,0,12567732,0.620067,7245,12575000,23,12567757,-2,-25
V,-,12552997,0.0,7.10543e-15,47,47,0,0,4141,gene,F45D3.4,0,12552972,7.03593,12825,12565822,25,12552997,0,-25
V,-,12550179,0.0,0.5,1,1,0,0,4,gene,F45D3.3,0,12550095,3.21584,1836,12552015,84,12550161,18,-66
V,-,12550118,0.0,0.125,3,3,0,0,1004,gene,F45D3.3,0,12550095,3.21584,1897,12552015,23,12550161,-43,-66
V,-,12525414,0.0,1.77636e-15,49,49,0,0,9,gene,C13C12.2,0,12525280,0.302653,23606,12549020,134,12525462,-48,-182
V,-,12525142,0.0,0.0078125,7,7,0,0,4,gene,C13C12.2,0,12525132,0.302653,237,12525379,10,12525142,0,-10
V,-,12515484,0.00487805,0.0,205,204,1,1,1,gene,C13C12.1,0,12515466,0.746644,7960,12523444,18,12515471,13,-5
V,-,12511834,0.0,1.90735e-06,19,19,0,0,71,gene,T28H10.2,0,12511805,0.297766,2918,12514752,29,12512007,-173,-202
V,-,12506064,0.0,0.0,222,222,0,0,1,gene,T28H10.4,0,12506056,0.374439,4390,12510454,8,12506056,8,0
V,-,12497561,0.00165837,0.0,603,602,1,1,11,gene,W04D2.4,1,12497560,0.847136,7508,12505069,1,12497561,0,-1
V,-,12494428,0.964799,0.0,2159,76,2083,1126,6,gene,W04D2.5,2,12494428,2.31125,106,12494534,0,12494428,0,0
V,-,12462814,0.00598802,0.0,167,166,1,1,7,gene,F28C1.2,0,12462743,0.304996,30239,12493053,71,12462814,0,-71
V,-,12449808,0.00833333,9.0278e-35,120,119,1,1,0,gene,C54D10.10,0,12449803,1.03786,3296,12453104,5,12449810,-2,-7
V,-,12443597,0.0,1.90735e-06,19,19,0,0,34,gene,C54D10.7,1,12443568,0.331754,1370,12444967,29,12443641,-44,-73
V,-,12441324,0.661538,0.00329206,65,22,43,20,0,gene,C54D10.14,2,12441253,None,183,12441507,71,12441072,252,181
V,-,12436792,0.8,0.15625,5,1,4,3,0,gene,C54D10.12,3,12436758,0.0423809,452,12437244,34,12436758,34,0
V,-,12417183,0.0,0.03125,5,5,0,0,0,gene,C54D10.2,0,12417183,0.0393799,2010,12419193,0,12417183,0,0
V,-,12415515,0.00348432,0.0,287,286,1,1,5,gene,C54D10.1,0,12415510,0.657583,625,12416140,5,12415510,5,0
V,-,12413505,0.00468384,0.0,854,850,4,2,2,gene,K01D12.12,0,12413504,1.3944,924,12414429,1,12413504,1,0
V,-,12410292,0.0,0.125,3,3,0,0,125,gene,K01D12.14,0,12410287,0.0786386,453,12410745,5,12410319,-27,-32
V,-,12408396,0.0,0.0,829,829,0,0,3,gene,K01D12.11,0,12408374,0.990215,779,12409175,22,12408374,22,0
V,-,12400819,1.0,0.5,1,0,1,0,1,gene,K01D12.6,0,12400620,0.543589,138,12400957,199,12400663,156,-43
V,-,12390436,0.0,0.5,1,1,0,0,7,gene,K01D12.4,0,12390436,0.0505776,8129,12398565,0,12390436,0,0
V,-,12369346,0.0,0.5,1,1,0,0,0,gene,F23H12.6,0,12369343,0.00155932,4123,12373469,3,12369343,3,0
V,-,12345714,0.00513699,0.0,584,581,3,1,0,gene,F23H12.1,1,12345713,1.09034,15320,12361034,1,12345714,0,-1
V,-,12343275,0.00309461,0.0,2262,2255,7,7,1,gene,F23H12.2,2,12343273,4.25882,719,12343994,2,12343276,-1,-3
V,-,12331995,0.0,1.81899e-12,39,39,0,0,0,gene,R04F11.4,0,12331978,0.319648,10121,12342116,17,12331923,72,55
V,-,12328531,0.0,2.22045e-16,52,52,0,0,2,gene,R04F11.4,0,12328464,0.319648,13585,12342116,67,12328236,295,228
V,-,12317825,0.0,0.0,157,157,0,0,0,gene,R04F11.5,1,12317825,0.76665,2157,12319982,0,12317825,0,0
V,-,12316986,0.928571,0.0,630,45,585,450,2,gene,R04F11.3,2,12316986,1.18936,94,12317080,0,12316986,0,0
V,-,12310160,0.0,0.00012207,13,13,0,0,5,gene,R04F11.1,0,12310148,0.072658,4357,12314517,12,12310148,12,0
V,-,12291464,0.0163934,0.0,488,480,8,6,0,gene,F55C5.8,1,12291460,2.04767,17090,12308554,4,12291464,0,-4
V,-,12288421,0.750656,8.11848e-24,381,95,286,196,1,gene,F55C5.7,2,12288415,0.708293,305,12288726,6,12288420,1,-5
V,-,12271357,0.0,0.0,487,487,0,0,11,gene,F55C5.5,0,12271355,1.24779,4008,12275365,2,12271355,2,0
V,-,12271344,0.0,0.25,2,2,0,0,1158,gene,F55C5.5,0,12271207,1.24779,4021,12275365,137,12271355,-11,-148
V,-,12269588,1.0,0.5,1,0,1,1,0,gene,F55C5.3,0,12269588,0.151678,489,12270077,0,12269238,350,350
V,-,12269124,0.0,7.45058e-09,27,27,0,0,0,gene,F55C5.3,0,12269116,0.151678,953,12270077,8,12269116,8,0
V,-,12263651,0.0,0.5,1,1,0,0,92,gene,F55C5.1,0,12263629,2.61566,1862,12265513,22,12263651,0,-22
V,-,12244850,0.000859107,0.0,1164,1163,1,1,10,gene,T04H1.2,0,12244836,2.00824,18456,12263306,14,12244850,0,-14
V,-,12234149,0.00606061,0.0,165,164,1,0,0,gene,K12F2.1,0,12234106,2.28312,7621,12241770,43,12234149,0,-43
V,-,12195745,0.0,9.09495e-13,40,40,0,0,0,gene,ZK836.3,0,12195636,0.587665,1492,12197237,109,12195636,109,0
V,-,12187320,0.0168067,1.0564e-32,119,117,2,2,0,gene,ZK863.8,0,12187201,0.799103,7050,12194370,119,12187222,98,-21
V,-,12184000,0.00309598,0.0,646,644,2,2,0,gene,ZK863.4,1,12183989,1.3533,2137,12186137,11,12184000,0,-11
V,-,12183991,0.0,7.45058e-09,27,27,0,0,533,gene,ZK863.4,1,12183989,1.3533,2146,12186137,2,12183991,0,-2
V,-,12181216,0.953988,0.0,326,15,311,183,0,gene,ZK863.3,2,12181216,0.765258,88,12181304,0,12181216,0,0
V,-,12170018,0.0,1.19209e-07,23,23,0,0,0,gene,ZK863.1,0,12170014,0.0220293,6833,12176851,4,12170014,4,0
V,-,12167561,0.00140404,0.0,18518,18492,26,18,2,gene,ZK863.2,0,12167559,36.1813,323,12167884,2,12167559,2,0
V,-,12110792,0.0,1.11022e-16,53,53,0,0,2,gene,C13C4.4,0,12110783,0.244585,7712,12118504,9,12110784,8,-1
V,-,12083421,0.0,0.00390625,8,8,0,0,10,gene,R07B7.8,0,12083392,0.158082,25553,12108974,29,12083421,0,-29
V,-,12083408,0.0,0.25,2,2,0,0,44,gene,R07B7.8,0,12083392,0.158082,25566,12108974,16,12083421,-13,-29
V,-,12074792,0.0,1.11022e-16,53,53,0,0,0,gene,R07B7.6,0,12074790,0.225248,2863,12077655,2,12074792,0,-2
V,-,12070325,0.0,1.26218e-29,96,96,0,0,1,gene,R07B7.5,1,12070325,0.384632,2345,12072670,0,12070325,0,0
V,-,12067701,1.0,0.5,1,0,1,1,6,gene,R07B7.4,2,12067692,0.114337,836,12068537,9,12067701,0,-9
V,-,12065197,0.00343474,0.0,2038,2031,7,6,5,gene,R07B7.3,1,12065165,5.2005,569,12065766,32,12065197,0,-32
V,-,12063174,0.951456,0.0,206,10,196,143,0,gene,R07B7.1,2,12063174,0.304514,64,12063238,0,12063174,0,0
V,-,12059553,0.025641,1.5656e-30,117,114,3,2,0,gene,R07B7.2,0,12059553,0.368527,487,12060040,0,12059553,0,0
V,-,12040679,0.00451807,0.0,664,661,3,3,0,gene,F10C2.2,1,12040672,1.15215,15688,12056367,7,12040679,0,-7
V,-,12023966,0.00947867,0.0,211,209,2,2,2,gene,F57F5.5,2,12023958,1.30659,7764,12031730,8,12023966,0,-8
V,-,12013230,0.0,7.27596e-12,37,37,0,0,0,gene,F57F5.4,0,12013212,1.08493,962,12014192,18,12013230,0,-18
V,-,12011571,0.010582,0.0,189,187,2,2,7,gene,F57F5.4,0,12011508,1.08493,2621,12014192,63,12011571,0,-63
V,-,12006399,0.0,0.0,201,201,0,0,23,gene,F57F5.3,0,12006349,0.0894005,2944,12009343,50,12006411,-12,-62
V,-,11993529,0.00308166,0.0,649,647,2,2,2,gene,C52E4.6,0,11993501,1.69329,2082,11995611,28,11993501,28,0
V,-,11985290,0.0131579,0.0,228,225,3,2,0,gene,C52E4.5,0,11985286,0.831209,5525,11990815,4,11985290,0,-4
V,-,11985133,0.0,0.25,2,2,0,0,92,gene,C52E4.5,0,11985127,0.831209,5682,11990815,6,11985290,-157,-163
V,-,11982203,0.00811359,0.0,3451,3423,28,21,164,gene,C52E4.4,0,11982200,4.01693,501,11982704,3,11982203,0,-3
V,-,11979529,0.00361376,0.0,6918,6893,25,23,9,gene,C52E4.3,1,11979502,8.25618,757,11980286,27,11979529,0,-27
V,-,11978061,0.360521,2.25555e-27,1459,933,526,281,8,gene,C52E4.2,2,11978052,3.13548,53,11978114,9,11978063,-2,-11
V,-,11964627,0.0,0.0,2103,2103,0,0,4,gene,F58H1.7,0,11964614,1.23761,11957,11976584,13,11964614,13,0
V,-,11937609,0.0,2.1684e-19,62,62,0,0,0,gene,F58H1.4,0,11937594,0.215626,25204,11962813,15,11937591,18,3
V,-,11933052,0.00990099,0.0,202,200,2,2,2,gene,F58H1.1,0,11933048,0.961147,3276,11936328,4,11933033,19,15
V,-,11868041,0.0,0.00195312,9,9,0,0,0,gene,R13H4.7,0,11868040,0.0372653,21466,11889507,1,11868040,1,0
V,-,11826873,0.00302115,0.0,331,330,1,0,1,gene,D2023.5,1,11826868,0.910111,4134,11831007,5,11826873,0,-5
V,-,11825568,0.87931,1.49012e-34,232,28,204,154,92,gene,D2023.4,2,11825525,1.23648,127,11825695,43,11825568,0,-43
V,-,11825526,0.846154,1.43701e-10,78,12,66,44,149,gene,D2023.4,2,11825525,1.23648,169,11825695,1,11825568,-42,-43
V,-,11822171,0.335092,1.07797e-29,1137,756,381,304,3,gene,D2023.2,0,11822158,3.57891,2665,11824836,13,11822171,0,-13
V,-,11787249,0.00432277,0.0,694,691,3,2,0,gene,F55A11.7,0,11787249,0.81645,14390,11801639,0,11787249,0,0
V,-,11764204,0.0,0.000488281,11,11,0,0,10,gene,F55A11.1,0,11764185,3.87852,20180,11784384,19,11764185,19,0
V,-,11764187,0.00662461,0.0,3170,3149,21,17,65,gene,F55A11.1,0,11764185,3.87852,20197,11784384,2,11764185,2,0
V,-,11733279,0.0171233,0.0,292,287,5,4,1,gene,B0240.4,0,11733277,1.15012,71,11733350,2,11733279,0,-2
V,-,11729967,0.0,1.73472e-18,59,59,0,0,0,gene,B0240.1,0,11729966,0.177684,959,11730926,1,11729967,0,-1
V,-,11725880,0.0,0.03125,5,5,0,0,1,gene,B0240.3,0,11725794,0.0287526,1827,11727707,86,11725459,421,335
V,-,11725876,0.0,0.0078125,7,7,0,0,1,gene,B0240.3,0,11725794,0.0287526,1831,11727707,82,11725459,417,335
V,-,11715710,0.0,2.71051e-20,65,65,0,0,0,gene,W05E10.4,0,11715638,0.560817,2184,11717894,72,11715710,0,-72
V,-,11715698,0.0,0.000976562,10,10,0,0,372,gene,W05E10.4,0,11715638,0.560817,2196,11717894,60,11715710,-12,-72
V,-,11705207,0.00196464,0.0,509,508,1,1,0,gene,W05E10.3,0,11705180,1.22377,4375,11709582,27,11705207,0,-27
V,-,11695497,0.0,3.30872e-24,78,78,0,0,0,gene,W05E10.5,0,11695432,0.193672,6072,11701569,65,11695432,65,0
V,-,11691498,0.0,0.000976562,10,10,0,0,3,gene,W05E10.1,0,11691449,0.133888,1409,11692907,49,11691503,-5,-54
V,-,11672274,0.0,0.5,1,1,0,0,28,gene,F46F3.2,0,11672254,0.178608,16944,11689218,20,11672389,-115,-135
V,-,11664505,0.00409836,0.0,244,243,1,1,6,gene,F46F3.1,0,11664504,0.480726,4646,11669151,1,11664504,1,0
V,-,11650436,0.0,0.25,2,2,0,0,57,gene,T27F2.4,0,11650316,0.462266,10942,11661378,120,11650605,-169,-289
V,-,11637096,0.0021692,0.0,461,460,1,1,0,gene,T27F2.2,0,11637026,0.705929,12789,11649885,70,11637016,80,10
V,-,11629129,0.0,0.0,236,236,0,0,7,gene,F35B12.10,0,11629114,0.37932,2114,11631243,15,11629129,0,-15
V,-,11618074,0.0243902,1.86446e-11,41,40,1,1,0,gene,F35B12.8,0,11618073,0.109803,7633,11625707,1,11618073,1,0
V,-,11604014,0.0,8.67362e-19,60,60,0,0,12,gene,F35B12.2,0,11604014,0.345192,240,11604254,0,11604014,0,0
V,-,11520245,0.0,0.00390625,8,8,0,0,101,gene,C55A6.7,1,11520240,0.472069,46366,11566611,5,11520291,-46,-51
V,-,11518509,0.0,0.5,1,1,0,0,0,gene,C55A6.8,2,11518439,0.000328158,635,11519144,70,11518509,0,-70
V,-,11517570,0.0,1.77636e-15,49,49,0,0,18,gene,C55A6.4,0,11517568,0.328947,437,11518007,2,11517692,-122,-124
V,-,11515998,0.00763359,4.81218e-38,131,130,1,0,0,gene,C55A6.5,1,11515985,0.498226,254,11516252,13,11515985,13,0
V,-,11514552,0.285714,0.0610962,14,10,4,1,2,gene,C55A6.6,2,11514537,0.379958,339,11514891,15,11514544,8,-7
V,-,11514544,0.421875,0.0458963,64,37,27,11,30,gene,C55A6.6,2,11514537,0.379958,347,11514891,7,11514544,0,-7
V,-,11513235,0.0769231,0.00158691,13,12,1,1,4,gene,C55A6.3,0,11513228,0.245906,278,11513513,7,11513228,7,0
V,-,11504548,0.00331565,0.0,1508,1503,5,3,154,gene,C55A6.1,0,11504520,1.04388,3167,11507715,28,11504548,0,-28
V,-,11502932,0.00759494,0.0,395,392,3,2,5,gene,C55A6.12,0,11502932,1.97721,695,11503627,0,11502932,0,0
V,-,11496184,0.0,6.77626e-21,67,67,0,0,1,gene,T11F9.12,0,11496178,0.548466,4994,11501178,6,11496180,4,-2
V,-,11490134,0.00454545,0.0,220,219,1,1,2,gene,T11F9.11,0,11490131,1.14759,3230,11493364,3,11490167,-33,-36
V,-,11472115,0.0,3.63798e-12,38,38,0,0,3,gene,T11F9.3,0,11472101,0.289035,6114,11478229,14,11472117,-2,-16
V,-,11468984,0.0,1.0842e-19,63,63,0,0,0,gene,T11F9.4,0,11468970,0.213159,1747,11470731,14,11468984,0,-14
V,-,11443290,0.0,8.27181e-25,80,80,0,0,0,gene,F57B7.2,0,11443286,0.386358,5737,11449027,4,11443286,4,0
V,-,11420099,0.0,6.46235e-27,87,87,0,0,2,gene,T26H10.1,1,11420022,0.194205,3268,11423367,77,11420098,1,-76
V,-,11419569,0.0,0.03125,5,5,0,0,4,gene,T26H10.1,1,11419518,0.194205,3798,11423367,51,11419569,0,-51
V,-,11414965,0.891892,7.97877e-13,74,8,66,8,4,gene,K03B8.9,2,11414960,0.148498,113,11415078,5,11414965,0,-5
V,-,11389679,0.0,0.0625,4,4,0,0,14,gene,F55C10.3,0,11389662,1.42139,400,11390079,17,11389681,-2,-19
V,-,11366027,0.0,6.61744e-24,77,77,0,0,0,gene,T02E9.3,0,11366011,0.144988,22629,11388656,16,11366027,0,-16
V,-,11352799,0.04,7.45058e-07,25,24,1,0,0,gene,T02E9.1,0,11352799,0.140343,9461,11362260,0,11352799,0,0
V,-,11346818,0.0,0.0,1150,1150,0,0,2,gene,T02E9.2,0,11346817,2.26144,2309,11349127,1,11346818,0,-1
V,-,11326770,0.00294985,0.0,2034,2028,6,4,2,gene,F47G9.1,0,11326752,4.94215,5992,11332762,18,11326770,0,-18
V,-,11308252,0.0,1.57772e-30,99,99,0,0,0,gene,T03F7.1,0,11308246,0.409096,4924,11313176,6,11308252,0,-6
V,-,11300512,0.0,0.5,1,1,0,0,0,gene,T03F7.4,0,11300445,0.000515263,899,11301411,67,11300445,67,0
V,-,11238765,0.0,0.0,194,194,0,0,16,gene,T19B10.6,0,11238709,0.940658,12622,11251387,56,11238765,0,-56
V,-,11228509,0.00631845,0.0,2374,2359,15,13,2,gene,T19B10.4,0,11228496,6.60958,8740,11237249,13,11228509,0,-13
V,-,11225817,0.0,5.96046e-08,24,24,0,0,41,gene,T19B10.3,0,11225817,1.12695,285,11226102,0,11225817,0,0
V,-,11195808,0.0,0.0,1048,1048,0,0,5,gene,K10D6.2,0,11195805,2.50053,8490,11204298,3,11195805,3,0
V,-,11177365,0.0,0.00390625,8,8,0,0,0,gene,T19C4.6,0,11177365,0.0604124,16173,11193538,0,11177365,0,0
V,-,11176529,0.0,0.0078125,7,7,0,0,2,gene,T19C4.6,0,11176491,0.0604124,17009,11193538,38,11176529,0,-38
V,-,11164391,0.5,0.5,2,1,1,1,1,gene,T19C4.4,0,11164381,0.00327979,1589,11165980,10,11164381,10,0
V,-,11144592,0.0,0.00012207,13,13,0,0,11,gene,C06H2.7,0,11144568,0.33399,2354,11146946,24,11144227,365,341
V,-,11123673,0.0109752,0.0,3189,3154,35,30,3,gene,C06H2.1,1,11123671,19.9743,19192,11142865,2,11123673,0,-2
V,-,11122299,0.407692,0.000583721,260,154,106,83,15,gene,H19N07.4,2,11122280,1.17624,262,11122561,19,11122299,0,-19
V,-,11119511,0.905077,0.0,453,43,410,230,12,gene,H19N07.3,3,11119511,1.22345,104,11119615,0,11119511,0,0
V,-,11112897,0.00423729,0.0,2124,2115,9,8,351,gene,H19N07.1,1,11112876,2.60792,5553,11118450,21,11112897,0,-21
V,-,11109553,0.983333,5.20417e-17,60,1,59,39,8,gene,Y42A5A.5,3,11109551,0.15764,350,11109903,2,11109503,50,48
V,-,11095779,0.0,7.10543e-15,47,47,0,0,2,gene,Y42A5A.3,0,11095772,0.368697,11562,11107341,7,11095904,-125,-132
V,-,11093258,0.0,0.000976562,10,10,0,0,18,gene,Y42A5A.2,0,11093254,0.330753,1997,11095255,4,11093420,-162,-166
V,-,11078150,0.0,2.98023e-08,25,25,0,0,0,gene,T04C12.5,0,11078145,21.2816,12677,11090827,5,11077960,190,185
V,-,11077960,0.0041156,0.0,10934,10889,45,42,2,gene,T04C12.5,0,11077933,21.2816,12867,11090827,27,11077960,0,-27
V,-,11073070,0.0517529,0.0,1198,1136,62,51,1,gene,T04C12.4,0,11073049,45.3804,3470,11076540,21,11073070,0,-21
V,-,11069162,0.0143149,0.0,489,482,7,3,8,gene,T04C12.8,0,11069142,0.558351,2150,11071312,20,11069142,20,0
V,-,11065419,0.0,0.0,324,324,0,0,24,gene,T04C12.3,0,11065417,1.52599,2386,11067805,2,11065419,0,-2
V,-,11060093,0.00204201,0.0,3428,3421,7,3,4,gene,T04C12.11,0,11060081,None,2073,11062166,12,11060081,12,0
V,-,11059327,0.285714,0.164062,7,5,2,0,0,gene,T04C12.1,0,11059295,3.57494,95,11059422,32,11059066,261,229
V,-,11059068,0.00512295,0.0,976,971,5,4,50,gene,T04C12.1,0,11059066,3.57494,258,11059326,2,11059066,2,0
V,-,11046639,0.0,0.03125,5,5,0,0,320,gene,C45B11.3,0,11046625,1.07432,395,11047034,14,11046639,0,-14
V,-,11039229,0.0114943,0.0,348,344,4,4,3,gene,C45B11.1,0,11039221,0.866542,6220,11045449,8,11039229,0,-8
V,-,11030651,0.0,0.0625,4,4,0,0,1,gene,C13G3.3,0,11030630,1.46614,5614,11036265,21,11030651,0,-21
V,-,11029193,0.00384246,0.0,1041,1037,4,3,530,gene,C13G3.3,0,11029188,1.46614,7072,11036265,5,11029193,0,-5
V,-,11029175,0.0,0.125,3,3,0,0,3169,gene,C13G3.3,0,11029175,1.46614,7090,11036265,0,11029193,-18,-18
V,-,11022740,0.0,2.86986e-42,138,138,0,0,9,gene,C13G3.2,0,11022722,0.366137,4245,11026985,18,11022679,61,43
V,-,11000504,0.0103397,0.0,677,670,7,6,2,gene,F53B7.3,0,11000485,1.29333,256,11000760,19,11000504,0,-19
V,-,10981016,0.0,0.015625,6,6,0,0,0,gene,F53B7.5,0,10980960,0.110058,18446,10999462,56,10980579,437,381
V,-,10965344,0.00813008,1.15669e-35,123,122,1,1,12,gene,F17C11.10,1,10965344,0.905099,2380,10967724,0,10965344,0,0
V,-,10960474,0.395221,2.07704e-07,544,329,215,184,10,gene,F17C11.8,2,10960465,1.18905,527,10961001,9,10960474,0,-9
V,-,10958626,0.941748,8.54792e-44,206,12,194,139,3,gene,F17C11.7,3,10958624,0.713209,109,10958735,2,10958626,0,-2
V,-,10954204,0.0,9.53674e-07,20,20,0,0,2969,gene,F17C11.5,0,10954125,0.876441,2506,10956710,79,10954239,-35,-114
V,-,10936361,0.4,0.3125,5,3,2,0,0,gene,F17C11.12,0,10936344,0.387052,1078,10937439,17,10936361,0,-17
V,-,10908984,0.0,5.96046e-08,24,24,0,0,0,gene,F32D8.10,0,10908957,0.19062,8469,10917453,27,10908976,8,-19
V,-,10908976,0.0,1.35525e-20,66,66,0,0,8,gene,F32D8.10,0,10908957,0.19062,8477,10917453,19,10908976,0,-19
V,-,10896948,0.00419019,0.0,17183,17111,72,65,7,gene,F32D8.6,1,10896940,33.9508,3327,10900275,8,10896950,-2,-10
V,-,10896363,1.0,0.015625,6,0,6,3,3,gene,F32D8.13,2,10896342,0.280201,95,10896458,21,10896348,15,-6
V,-,10896346,0.844444,1.28977e-06,45,7,38,23,19,gene,F32D8.13,2,10896342,0.280201,112,10896458,4,10896348,-2,-6
V,-,10893365,0.994505,0.0,182,1,181,129,6,gene,F32D8.4,2,10893365,0.417902,88,10893453,0,10893365,0,0
V,-,10890801,0.018315,0.0,546,536,10,7,780,gene,F32D8.12,0,10890798,1.40413,165,10890966,3,10890798,3,0
V,-,10865597,0.00246914,0.0,405,404,1,0,0,gene,F53H10.2,0,10865565,1.35616,22059,10887656,32,10865597,0,-32
V,-,10860684,0.0175439,3.95517e-16,57,56,1,0,1,gene,F53H10.2,0,10860662,1.35616,26972,10887656,22,10860684,0,-22
V,-,10859585,0.0,2.77556e-17,55,55,0,0,1,gene,F53H10.2,0,10859585,1.35616,28071,10887656,0,10859585,0,0
V,-,10855525,0.0,0.00195312,9,9,0,0,3,gene,F53H10.2,0,10855488,1.35616,32131,10887656,37,10855138,387,350
V,-,10855136,0.0,0.0,187,187,0,0,33,gene,F53H10.2,0,10855045,1.35616,32520,10887656,91,10855136,0,-91
V,-,10813194,0.0,0.0,383,383,0,0,113,gene,C29A12.1,0,10813193,0.88197,39128,10852322,1,10813208,-14,-15
V,-,10810688,0.0,0.0625,4,4,0,0,2,gene,C29A12.2,0,10810384,None,1462,10812150,304,10810880,-192,-496
V,-,10807716,0.0,3.05176e-05,15,15,0,0,10,gene,D1054.15,1,10807699,1.96802,1400,10809116,17,10807716,0,-17
V,-,10807703,0.00518135,0.0,2702,2688,14,10,22,gene,D1054.15,1,10807699,1.96802,1413,10809116,4,10807703,0,-4
V,-,10805838,0.932203,0.0,885,60,825,581,7,gene,D1054.14,2,10805838,1.23428,95,10805933,0,10805838,0,0
V,-,10804033,0.904762,7.36667e-12,63,6,57,42,0,gene,D1054.13,3,10804028,0.234431,492,10804525,5,10804033,0,-5
V,-,10799137,0.0,0.5,1,1,0,0,0,gene,D1054.16,0,10799061,None,1307,10800444,76,10799279,-142,-218
V,-,10776362,0.0,3.63798e-12,38,38,0,0,2,gene,D1054.5,0,10776358,0.202986,1833,10778195,4,10776382,-20,-24
V,-,10769816,0.0103093,6.12156e-28,97,96,1,1,7,gene,D1054.1,0,10769798,0.607428,2097,10771913,18,10769812,4,-14
V,-,10762596,0.0,0.0625,4,4,0,0,0,gene,F28H7.9,0,10762593,0.0299585,5673,10768269,3,10762593,3,0
V,-,10736474,0.0078125,0.0,256,254,2,2,1,gene,ZC302.1,0,10736470,0.506198,2604,10739078,4,10736474,0,-4
V,-,10732225,0.0204082,0.0,196,192,4,3,0,gene,T28B11.1,0,10732049,2.08364,1509,10733734,176,10732225,0,-176
V,-,10715051,0.0119522,0.0,251,248,3,1,0,gene,T28B11.1,0,10715019,2.08364,18683,10733734,32,10715051,0,-32
V,-,10661269,0.0167598,0.0,716,704,12,11,0,gene,F29F11.1,0,10661267,1.5513,50694,10711963,2,10661269,0,-2
V,-,10646943,0.0,0.25,2,2,0,0,1,gene,C32C4.3,0,10646935,0.0684085,5195,10652138,8,10646765,178,170
V,-,10615391,0.0,3.8147e-06,18,18,0,0,0,gene,H09F14.1,0,10615391,0.0990122,29568,10644959,0,10615313,78,78
V,-,10594709,0.0,6.61744e-24,77,77,0,0,0,gene,T21C9.11,0,10594706,0.0550925,18008,10612717,3,10594706,3,0
V,-,10592379,0.0,2.64698e-23,75,75,0,0,22,gene,T21C9.9,0,10592376,0.307161,1415,10593794,3,10592379,0,-3
V,-,10578122,0.883954,0.0,1396,162,1234,954,4,gene,T21C9.1,2,10578121,1.14144,105,10578227,1,10578121,1,0
V,-,10576219,0.894737,3.22777e-28,171,18,153,98,1,gene,T21C9.2,3,10576217,0.473082,91,10576310,2,10576219,0,-2
V,-,10535764,0.00593472,0.0,674,670,4,3,88,gene,F25D1.1,0,10535607,2.92577,9776,10545540,157,10535764,0,-157
V,-,10535109,0.00344828,0.0,580,578,2,2,1,gene,F25D1.1,0,10535008,2.92577,10431,10545540,101,10535109,0,-101
V,-,10525707,0.00849858,0.0,706,700,6,5,20,gene,C35A5.8,0,10525669,1.50213,4731,10530438,38,10525707,0,-38
V,-,10514170,0.0,0.000488281,11,11,0,0,0,gene,C35A5.7,0,10514147,0.119569,7070,10521240,23,10514170,0,-23
V,-,10501195,0.0,2.32831e-10,32,32,0,0,4,gene,C35A5.3,0,10501195,0.31631,716,10501911,0,10501197,-2,-2
V,-,10489892,0.0,0.125,3,3,0,0,1,gene,Y32F6B.2,0,10489890,0.0201171,9291,10499183,2,10489848,44,42
V,-,10484540,0.0,3.58732e-43,141,141,0,0,0,gene,Y32F6B.1,0,10484481,0.57662,1509,10486049,59,10484540,0,-59
V,-,10463047,0.0,0.0625,4,4,0,0,2,gene,F22E12.3,0,10462755,0.0799594,17662,10480709,292,10463070,-23,-315
V,-,10457147,0.0,1.13687e-13,43,43,0,0,0,gene,F22E12.1,0,10457122,0.421891,1845,10458992,25,10457147,0,-25
V,-,10453405,0.0060241,0.0,664,660,4,3,19,gene,Y32F6A.5,0,10453405,1.67136,253,10453658,0,10453405,0,0
V,-,10433404,0.0,2.01948e-28,92,92,0,0,1,gene,Y32F6A.4,0,10433385,0.800808,4742,10438146,19,10433404,0,-19
V,-,10426060,0.0,0.25,2,2,0,0,0,gene,F15H10.3,0,10426023,0.452927,311,10426371,37,10426060,0,-37
V,-,10426055,0.0,5.96046e-08,24,24,0,0,1,gene,F15H10.3,0,10426023,0.452927,316,10426371,32,10426055,0,-32
V,-,10424814,0.0,0.0625,4,4,0,0,19,gene,F15H10.1,0,10424810,2.05784,349,10425163,4,10424814,0,-4
V,-,10421692,0.00406268,0.0,1723,1716,7,4,162,gene,F15H10.2,0,10421692,0,2007,10423699,0,10421692,0,0
V,-,10406211,0.0,0.03125,5,5,0,0,0,gene,F15H10.7,0,10406185,0.0428321,3292,10409503,26,10406224,-13,-39
V,-,10355623,0.00821918,0.0,365,362,3,3,0,gene,K07C5.6,0,10355615,1.06946,460,10356083,8,10355623,0,-8
V,-,10352778,0.0125184,0.0,1358,1341,17,16,1,gene,K07C5.4,0,10352767,6.64132,606,10353384,11,10352778,0,-11
V,-,10349952,0.0,0.0,256,256,0,0,0,gene,K07C5.9,0,10349922,0.448184,314,10350266,30,10349952,0,-30
V,-,10338155,0.00844391,0.0,829,822,7,5,13,gene,K07C5.1,0,10338150,2.04599,8295,10346450,5,10338155,0,-5
V,-,10331910,0.0108696,1.85793e-26,92,91,1,1,0,gene,B0024.14,0,10331858,0.601765,2829,10334739,52,10331910,0,-52
V,-,10329055,0.0,7.45058e-09,27,27,0,0,1,gene,B0024.14,0,10329048,0.601765,5684,10334739,7,10329048,7,0
V,-,10319956,0.0,1.46937e-39,129,129,0,0,7,gene,B0024.12,1,10319949,0.381861,2129,10322085,7,10319956,0,-7
V,-,10319332,0.00582363,0.0,1202,1195,7,7,1,gene,B0024.11,2,10319332,0.694247,120,10319452,0,10319332,0,0
V,-,10317209,1.0,0.25,2,0,2,1,4,gene,B0024.10,3,10317192,0.659699,79,10317288,17,10317192,17,0
V,-,10317192,0.896422,0.0,531,55,476,345,4,gene,B0024.10,3,10317192,0.659699,96,10317288,0,10317192,0,0
V,-,10307175,0.0,0.0625,4,4,0,0,2,gene,B0024.8,0,10307152,0.0770693,912,10308087,23,10307152,23,0
V,-,10281342,0.0,0.03125,5,5,0,0,18,gene,Y22F5A.5,0,10281243,5.80382,556,10281898,99,10281269,73,-26
V,-,10270113,0.00597015,0.0,335,333,2,1,0,gene,Y22F5A.3,0,10270083,2.38541,5103,10275216,30,10270113,0,-30
V,-,10262542,0.0,1.92593e-34,112,112,0,0,10,gene,Y22F5A.3,0,10262462,2.38541,12674,10275216,80,10262462,80,0
V,-,10254854,0.00746269,0.0,536,532,4,3,1,gene,C12D8.11,0,10254846,1.42227,3606,10258460,8,10254854,0,-8
V,-,10242944,0.0,6.10352e-05,14,14,0,0,194,gene,C12D8.9,0,10242896,0.528298,9689,10252633,48,10242977,-33,-81
V,-,10240987,0.0,0.00390625,8,8,0,0,1,gene,C12D8.6,0,10240987,0.0283234,1599,10242586,0,10240987,0,0
V,-,10240748,0.0,0.03125,5,5,0,0,0,gene,C12D8.6,0,10240716,0.0283234,1838,10242586,32,10240987,-239,-271
V,-,10237910,0.142857,3.36022e-10,70,60,10,6,59,gene,C12D8.1,0,10237860,3.35543,1476,10239386,50,10237910,0,-50
V,-,10225464,0.0,0.125,3,3,0,0,32,gene,C12D8.5,0,10225457,0.333311,1158,10226622,7,10225520,-56,-63
V,-,10211925,0.0,0.0,161,161,0,0,2,gene,ZK856.9,1,10211921,0.855593,7326,10219251,4,10211925,0,-4
V,-,10210142,0.933333,4.56852e-16,75,5,70,48,0,gene,ZK856.13,2,10210138,0.648748,99,10210241,4,10210143,-1,-5
V,-,10206400,0.971429,2.66247e-44,175,5,170,124,2,gene,ZK856.10,3,10206399,0.6857,21,10206421,1,10206399,1,0
V,-,10205396,0.909091,0.00537109,11,1,10,9,10,gene,ZK856.16,4,10205395,None,82,10205478,1,10205381,15,14
V,-,10205385,0.976359,0.0,1269,30,1239,933,31,gene,ZK856.16,4,10205381,None,93,10205478,4,10205381,4,0
V,-,10205341,0.857143,0.0546875,7,1,6,4,190,gene,ZK856.16,4,10205206,None,137,10205478,135,10205381,-40,-175
V,-,10204734,0.258621,6.3556e-08,116,86,30,25,3,gene,ZK856.11,5,10204711,1.44596,304,10205038,23,10204881,-147,-170
V,-,10203283,0.418235,2.37843e-12,1700,989,711,500,44,gene,ZK856.8,6,10203274,2.44439,118,10203401,9,10203283,0,-9
V,-,10189929,0.0,0.0,179,179,0,0,2,gene,ZK856.5,0,10189916,0.170748,11697,10201626,13,10189929,0,-13
V,-,10173551,0.00219974,0.0,2273,2268,5,2,0,gene,C51E3.7,0,10173549,6.83847,10938,10184489,2,10173551,0,-2
V,-,10166259,0.15,0.00108719,20,17,3,1,2,gene,C51E3.6,0,10166255,0.239775,2718,10168977,4,10166255,4,0
V,-,10160927,0.0,4.76837e-07,21,21,0,0,4,gene,C51E3.10,0,10160795,0.884318,3008,10163935,132,10160914,13,-119
V,-,10133947,0.00473934,0.0,422,420,2,2,1,gene,C08B6.7,1,10133911,1.16625,26289,10160236,36,10133947,0,-36
V,-,10133912,0.0,0.25,2,2,0,0,150,gene,C08B6.7,1,10133911,1.16625,26324,10160236,1,10133947,-35,-36
V,-,10133762,0.0,3.05176e-05,15,15,0,0,5,gene,C08B6.7,1,10133748,1.16625,26474,10160236,14,10133762,0,-14
V,-,10130094,0.87372,0.0,586,74,512,356,2,gene,C08B6.9,2,10130093,1.43067,110,10130204,1,10130094,0,-1
V,-,10112086,0.0,9.53674e-07,20,20,0,0,5,gene,C08B6.3,0,10112086,0.178343,7350,10119436,0,10112086,0,0
V,-,10083842,0.0277778,5.23869e-10,36,35,1,1,0,gene,R04B5.4,0,10083821,0.174173,5112,10088954,21,10083821,21,0
V,-,10054713,0.00370066,0.0,2432,2423,9,5,9,gene,F57A8.2,0,10054707,1.19491,14453,10069166,6,10054713,0,-6
V,-,10054707,0.0,1.52588e-05,16,16,0,0,190,gene,F57A8.2,0,10054707,1.19491,14459,10069166,0,10054713,-6,-6
V,-,10030892,0.0,0.0,185,185,0,0,0,gene,T06E8.1,0,10030882,1.02613,18103,10048995,10,10030892,0,-10
V,-,9995684,0.0,3.8147e-06,18,18,0,0,1,gene,K08H10.6,0,9995683,0.0549367,11145,10006829,1,9995683,1,0
V,-,9992765,0.0,0.5,1,1,0,0,0,gene,K08H10.11,0,9992758,None,751,9993516,7,9992851,-86,-93
V,-,9991442,0.00124688,0.0,802,801,1,1,4,gene,K08H10.7,1,9991421,0.563995,2074,9993516,21,9991442,0,-21
V,-,9987588,0.903479,0.0,891,86,805,591,1,gene,C27H6.8,2,9987552,2.17672,128,9987716,36,9987588,0,-36
V,-,9986085,1.0,0.000976562,10,0,10,9,19,gene,C27H6.4,0,9986077,5.19887,67,9986152,8,9986038,47,39
V,-,9986077,0.870968,7.33159e-10,62,8,54,40,42,gene,C27H6.4,0,9986077,5.19887,75,9986152,0,9986038,39,39
V,-,9985195,0.714286,0.164062,7,2,5,4,5,gene,C27H6.4,0,9985075,5.19887,148,9985343,120,9985195,0,-120
V,-,9984615,0.00430622,0.0,2090,2081,9,6,84,gene,C27H6.4,0,9984594,5.19887,728,9985343,21,9984615,0,-21
V,-,9976031,0.0666667,0.000457764,15,14,1,1,0,gene,C27H6.1,0,9976026,0.241576,2558,9978589,5,9975918,113,108
V,-,9975941,0.0,0.0625,4,4,0,0,9,gene,C27H6.1,0,9975927,0.241576,2648,9978589,14,9975918,23,9
V,-,9962292,0.0,6.77626e-21,67,67,0,0,0,gene,T07C12.11,0,9962274,0.193427,3895,9966187,18,9962274,18,0
V,-,9958131,0.000952381,0.0,1050,1049,1,1,4,gene,T07C12.9,0,9958100,2.00986,1664,9959795,31,9958131,0,-31
V,-,9930908,1.0,0.5,1,0,1,1,2565,gene,T07C12.12,0,9930894,0.19371,1693,9932601,14,9930575,333,319
V,-,9885766,0.0,9.31323e-10,30,30,0,0,1,gene,T11A5.6,0,9885760,0.0936161,19885,9905651,6,9885760,6,0
V,-,9878620,0.0,0.5,1,1,0,0,0,gene,T11A5.7,0,9878565,0.00257153,3219,9881839,55,9878601,19,-36
V,-,9878586,0.0,0.5,1,1,0,0,0,gene,T11A5.7,0,9878565,0.00257153,3253,9881839,21,9878601,-15,-36
V,-,9875711,1.0,0.5,1,0,1,0,0,gene,T11A5.4,0,9875699,None,774,9876485,12,9875699,12,0
V,-,9859763,0.0,0.5,1,1,0,0,0,gene,T11A5.1,0,9859753,0.0260432,6663,9866426,10,9859763,0,-10
V,-,9853541,0.0119048,0.0,168,166,2,2,2,gene,R07B5.8,0,9853323,0.563038,12885,9866426,218,9853541,0,-218
V,-,9789507,0.00496894,0.0,805,801,4,4,1,gene,F46B6.7,1,9789443,11.271,9183,9798690,64,9789507,0,-64
V,-,9789501,0.00396969,0.0,2771,2760,11,8,98,gene,F46B6.7,1,9789443,11.271,9189,9798690,58,9789501,0,-58
V,-,9786668,0.828313,8.66454e-36,332,57,275,195,1,gene,F46B6.6,2,9786639,0.668612,93,9786761,29,9786668,0,-29
V,-,9782862,0.956693,0.0,254,11,243,191,3,gene,F46B6.5,3,9782843,1.09936,104,9782966,19,9782862,0,-19
V,-,9779318,0.975806,1.4582e-32,124,3,121,90,0,gene,F46B6.4,4,9779317,0.420934,23,9779341,1,9779317,1,0
V,-,9777543,0.919315,0.0,409,33,376,270,0,gene,F46B6.3,5,9777542,0.918912,118,9777661,1,9777543,0,-1
V,-,9775634,0.965909,0.0,616,21,595,354,10,gene,F46B6.12,6,9775600,1.68746,101,9775735,34,9775634,0,-34
V,-,9757784,0.0,1.05879e-22,73,73,0,0,0,gene,F58E6.11,0,9757773,0.185685,6550,9764334,11,9757786,-2,-13
V,-,9729309,0.0,0.0,1585,1585,0,0,2,gene,F40F9.6,0,9729307,3.68876,20363,9749672,2,9729307,2,0
V,-,9723777,0.00540541,0.0,185,184,1,1,4,gene,F40F9.5,0,9723775,0.445392,1971,9725748,2,9723783,-6,-8
V,-,9713431,0.016129,1.34441e-17,62,61,1,1,1,gene,F40F9.10,0,9713376,0.149183,6111,9719542,55,9713431,0,-55
V,-,9709737,0.0,0.03125,5,5,0,0,1,gene,F40F9.2,0,9709605,1.20671,1509,9711246,132,9709613,124,-8
V,-,9709623,0.0,9.09495e-13,40,40,0,0,33,gene,F40F9.2,0,9709605,1.20671,1623,9711246,18,9709613,10,-8
V,-,9709613,0.00426136,0.0,704,701,3,2,133,gene,F40F9.2,0,9709605,1.20671,1633,9711246,8,9709613,0,-8
V,-,9709606,0.0,0.000488281,11,11,0,0,627,gene,F40F9.2,0,9709605,1.20671,1640,9711246,1,9709613,-7,-8
V,-,9691959,0.0,0.0,150,150,0,0,2,gene,ZK287.6,0,9691936,0.364229,15446,9707405,23,9691936,23,0
V,-,9690322,0.00851517,0.0,5637,5589,48,36,1,gene,ZK287.5,0,9690320,9.02038,517,9690839,2,9690322,0,-2
V,-,9685501,0.0,0.015625,6,6,0,0,0,gene,ZK287.4,0,9685470,0.1715,3981,9689482,31,9685459,42,11
V,-,9673371,0.0,5.82077e-11,34,34,0,0,21,gene,ZK287.2,0,9673363,0.330635,6561,9679932,8,9673371,0,-8
V,-,9672782,0.0,2.84217e-14,45,45,0,0,1,gene,ZK287.2,0,9672726,0.330635,7150,9679932,56,9672782,0,-56
V,-,9661415,0.0,2.91038e-11,35,35,0,0,0,gene,B0331.2,0,9661414,0.0272134,8414,9669829,1,9661415,0,-1
V,-,9645265,0.0,3.05176e-05,15,15,0,0,49,gene,T06E4.3,0,9645255,0.307818,11207,9656472,10,9645255,10,0
V,-,9634375,1.0,0.015625,6,0,6,5,0,gene,T06E4.13,0,9634375,None,285,9634660,0,9634365,10,10
V,-,9582445,0.00526316,0.0,760,756,4,4,6,gene,F25B3.6,0,9582428,1.86549,35590,9618035,17,9582445,0,-17
V,-,9570092,0.0,6.93889e-18,57,57,0,0,1,gene,F25B3.5,0,9570092,0.102204,9750,9579842,0,9570092,0,0
V,-,9561473,0.0172414,2.01228e-16,58,57,1,0,6,gene,F25B3.3,0,9561409,0.116066,3886,9565359,64,9561409,64,0
V,-,9545089,0.125,0.0,992,868,124,101,36,gene,C50F4.13,1,9545084,7.53303,1975,9547064,5,9545089,0,-5
V,-,9544027,0.0393258,0.0,356,342,14,11,0,gene,C50F4.11,2,9544025,0.93048,380,9544407,2,9544027,0,-2
V,-,9541407,0.964912,3.21287e-28,114,4,110,64,1,gene,C50F4.16,3,9541407,0.651092,176,9541583,0,9541407,0,0
V,-,9541400,1.0,0.5,1,0,1,0,152,gene,C50F4.16,3,9541385,0.651092,183,9541583,15,9541407,-7,-22
V,-,9539539,0.914773,2.08157e-32,176,15,161,125,1,gene,C50F4.12,4,9539536,0.228324,106,9539645,3,9539536,3,0
V,-,9524000,0.0,2.46519e-32,105,105,0,0,0,gene,C50F4.9,0,9524000,0.371474,5806,9529806,0,9524000,0,0
V,-,9518740,0.0,2.71051e-20,65,65,0,0,5,gene,C50F4.8,0,9518710,1.4138,4258,9522998,30,9518676,64,34
V,-,9491291,0.00161307,0.0,29137,29090,47,40,45,gene,K06A4.7,0,9491286,38.179,25497,9516788,5,9491293,-2,-7
V,-,9489435,1.0,0.25,2,0,2,2,1,gene,K06A4.10,0,9489360,None,299,9489734,75,9489432,3,-72
V,-,9421303,0.00271248,0.0,1106,1103,3,3,0,gene,F36D4.5,0,9421251,2.65904,5348,9426651,52,9421303,0,-52
V,-,9414415,0.0,0.015625,6,6,0,0,1,gene,F36D4.7,0,9414314,0.00582637,4678,9419093,101,9414314,101,0
V,-,9370812,1.0,0.5,1,0,1,1,4,gene,E02C12.6,0,9370692,0.0334627,647,9371459,120,9370887,-75,-195
V,-,9359575,0.0136986,7.72918e-21,73,72,1,1,0,gene,E02C12.5,0,9359551,0.143117,9721,9369296,24,9359551,24,0
V,-,9355272,0.768116,3.24111e-06,69,16,53,34,0,gene,E02C12.4,2,9355267,0.186156,22,9355294,5,9355272,0,-5
V,-,9343930,0.00136407,0.0,7331,7321,10,7,253,gene,K07B1.6,0,9343930,5.98945,925,9344855,0,9343930,0,0
V,-,9332863,0.004329,0.0,693,690,3,3,17,gene,K07B1.5,0,9332828,1.26132,7612,9340475,35,9332863,0,-35
V,-,9291964,0.0,6.31089e-30,97,97,0,0,0,gene,ZK682.7,0,9291964,0.087974,34982,9326946,0,9291919,45,45
V,-,9287362,0.00684932,1.63672e-42,146,145,1,0,4,gene,ZK682.5,0,9287357,0.511025,2999,9290361,5,9287362,0,-5
V,-,9266301,0.0,3.08149e-33,108,108,0,0,1,gene,ZK682.2,0,9266210,0.718477,14096,9280397,91,9266301,0,-91
V,-,9266243,0.0,0.0,196,196,0,0,12,gene,ZK682.2,0,9266210,0.718477,14154,9280397,33,9266243,0,-33
V,-,9260998,0.0,1.16415e-10,33,33,0,0,8,gene,F07C3.10,0,9260944,0.0980754,2603,9263601,54,9260926,72,18
V,-,9254432,0.001485,0.0,3367,3362,5,3,5,gene,F07C3.9,0,9254429,6.99772,1056,9255488,3,9254429,3,0
V,-,9249108,0.0,0.5,1,1,0,0,0,gene,F07C3.8,0,9249108,0.0116306,4971,9254079,0,9249108,0,0
V,-,9246162,0.00512821,0.0,195,194,1,1,47,gene,F07C3.7,0,9246154,0.451235,1624,9247786,8,9246162,0,-8
V,-,9242893,0.0,7.70372e-34,110,110,0,0,2,gene,F07C3.4,0,9242746,0.405999,1311,9244204,147,9242966,-73,-220
V,-,9217043,0.00722022,0.0,277,275,2,0,1,gene,T18H9.7,1,9217017,0.892464,10410,9227453,26,9217044,-1,-27
V,-,9212145,0.0,3.15544e-30,98,98,0,0,2,gene,T18H9.6,2,9212100,0.907469,1421,9213566,45,9212145,0,-45
V,-,9207269,0.0344828,5.735e-15,58,56,2,2,0,gene,T18H9.5,0,9207266,0.266456,1991,9209260,3,9207269,0,-3
V,-,9181521,0.0,1.32349e-23,76,76,0,0,4,gene,C24B5.3,0,9181498,0.405108,14097,9195618,23,9181521,0,-23
V,-,9172803,0.0,7.27596e-12,37,37,0,0,0,gene,B0222.9,0,9172803,0.263111,5043,9177846,0,9172826,-23,-23
V,-,9165179,0.0,0.03125,5,5,0,0,2,gene,B0222.8,0,9165092,25.7829,451,9165630,87,9165109,70,-17
V,-,9146702,0.0,2.98023e-08,25,25,0,0,0,gene,B0222.4,0,9146696,0.0787164,5424,9152126,6,9146702,0,-6
V,-,9141200,0.0,1.73472e-18,59,59,0,0,0,gene,B0222.3,0,9141198,0.0881564,3222,9144422,2,9141200,0,-2
V,-,9137523,0.0,0.015625,6,6,0,0,0,gene,B0222.2,0,9137521,0.00346616,1231,9138754,2,9137521,2,0
V,-,9100956,0.0,0.000244141,12,12,0,0,0,gene,F21C10.12,0,9100937,0.0319004,34501,9135457,19,9100937,19,0
V,-,9076181,0.0,0.5,1,1,0,0,4,gene,T27E4.7,0,9076166,2.26623,10780,9086961,15,9076126,55,40
V,-,9076126,0.00174216,0.0,574,573,1,0,6,gene,T27E4.7,0,9076083,2.26623,10835,9086961,43,9076126,0,-43
V,-,9062245,0.0106383,0.0,188,186,2,1,1,gene,C25E10.12,0,9062244,0.847033,6020,9068265,1,9062244,1,0
V,-,9054705,0.0,0.5,1,1,0,0,21,gene,C25E10.9,0,9054636,3.25441,425,9055130,69,9054636,69,0
V,-,9050993,0.0,2.77556e-17,55,55,0,0,1,gene,C25E10.7,0,9050876,0.0613918,2128,9053121,117,9050783,210,93
V,-,8987575,0.0,0.0625,4,4,0,0,0,gene,F59E11.16,0,8987573,0.00461853,24426,9012001,2,8987768,-193,-195
V,-,8977269,0.0,1.13687e-13,43,43,0,0,19,gene,F59E11.12,1,8977268,0.221053,2054,8979323,1,8977241,28,27
V,-,8974740,0.0743802,4.2494e-24,121,112,9,2,0,gene,F59E11.11,2,8974730,0.180238,547,8975287,10,8974730,10,0
V,-,8972172,0.193548,0.000342858,31,25,6,3,0,gene,F59E11.10,1,8972167,0.0479112,649,8972821,5,8971806,366,361
V,-,8970058,0.3,0.117188,10,7,3,3,0,gene,F59E11.8,2,8970053,0.0485541,490,8970548,5,8969758,300,295
V,-,8963903,0.0,1.0842e-19,63,63,0,0,2,gene,T19A5.4,0,8963903,0.259794,610,8964513,0,8963903,0,0
V,-,8943867,0.00238663,0.0,419,418,1,1,0,gene,T19A5.3,0,8943826,0.899744,17816,8961683,41,8943867,0,-41
V,-,8928743,0.00416667,0.0,240,239,1,0,33,gene,H14N18.4,0,8928742,0.866728,10653,8939396,1,8928742,1,0
V,-,8913837,0.0,1.19209e-07,23,23,0,0,0,gene,K06C4.6,0,8913814,0.0748405,9823,8923660,23,8913837,0,-23
V,-,8800826,0.0,7.62939e-06,17,17,0,0,1,gene,C01B7.5,0,8800800,0.0591961,4433,8805259,26,8800800,26,0
V,-,8795371,0.0,0.0,224,224,0,0,1,gene,C01B7.4,0,8795348,0.351089,9888,8805259,23,8795371,0,-23
V,-,8762757,0.00503778,0.0,397,395,2,1,3,gene,B0507.8,1,8762740,1.60864,1935,8764692,17,8762765,-8,-25
V,-,8760318,0.90625,0.0,416,39,377,191,2,gene,B0507.10,2,8760295,1.29604,112,8760430,23,8760320,-2,-25
V,-,8758522,0.89011,2.5958e-15,91,10,81,48,0,gene,B0507.7,3,8758512,0.0506619,102,8758624,10,8758522,0,-10
V,-,8642998,0.0,0.0,1057,1057,0,0,90,gene,F28A12.4,1,8642995,3.4863,28876,8671874,3,8642998,0,-3
V,-,8636876,1.0,0.25,2,0,2,2,0,gene,F28A12.2,0,8636866,0.0585313,90,8636966,10,8636793,83,73
V,-,8634653,0.0,0.0078125,7,7,0,0,0,gene,F41E6.14,0,8634640,0.0354059,986,8635639,13,8634640,13,0
V,-,8631130,0.00113593,0.0,2641,2638,3,3,1,gene,F41E6.13,0,8631130,3.16701,546,8631676,0,8631130,0,0
V,-,8628873,0.00931677,0.0,322,319,3,2,50,gene,F41E6.12,0,8628873,0.580199,155,8629028,0,8628911,-38,-38
V,-,8605931,0.00181653,0.0,1101,1099,2,2,33,gene,F41E6.9,0,8605930,2.85654,13799,8619730,1,8605930,1,0
V,-,8602622,0.0,2.38419e-07,22,22,0,0,2,gene,F41E6.15,0,8602541,0.296251,2271,8604893,81,8602637,-15,-96
V,-,8601170,0.0,1.81899e-12,39,39,0,0,9,gene,F41E6.8,0,8601081,0.0313585,717,8601887,89,8601217,-47,-136
V,-,8599095,0.0,7.10543e-15,47,47,0,0,1,gene,F41E6.7,0,8599058,0.194889,1244,8600339,37,8598694,401,364
V,-,8584335,0.0042735,0.0,234,233,1,1,0,gene,C10B5.3,0,8584331,1.31915,12975,8597310,4,8584331,4,0
V,-,8569783,0.0,0.00390625,8,8,0,0,203,gene,F25G6.9,1,8569760,0.467789,13577,8583360,23,8569825,-42,-65
V,-,8564980,0.94855,0.0,1827,94,1733,1120,2,gene,F25G6.8,2,8564976,1.95511,97,8565077,4,8564980,0,-4
V,-,8564977,0.9,0.000181198,20,2,18,10,2,gene,F25G6.8,2,8564976,1.95511,100,8565077,1,8564980,-3,-4
V,-,8564911,0.5,0.5,2,1,1,0,260,gene,F25G6.8,2,8564879,1.95511,166,8565077,32,8564980,-69,-101
V,-,8545282,0.0,0.0625,4,4,0,0,10,gene,F25G6.7,0,8545205,0.139815,18791,8564073,77,8545371,-89,-166
V,-,8520700,0.0122807,0.0,570,563,7,6,1,gene,F45F2.11,1,8520690,0.839503,11821,8532521,10,8520568,132,122
V,-,8518570,0.882353,2.69944e-06,34,4,30,22,6,gene,F45F2.10,2,8518506,0.938226,162,8518732,64,8518120,450,386
V,-,8518153,0.178947,6.47397e-11,95,78,17,15,7,gene,F45F2.10,2,8518116,0.938226,579,8518732,37,8518120,33,-4
V,-,8518125,0.745763,6.92078e-05,59,15,44,39,184,gene,F45F2.10,2,8518116,0.938226,607,8518732,9,8518120,5,-4
V,-,8513267,0.957839,0.0,759,32,727,480,3,gene,F45F2.9,3,8513267,0.974159,113,8513380,0,8513267,0,0
V,-,8504421,0.0,1.52588e-05,16,16,0,0,0,gene,ZK994.6,0,8504387,0.0724817,8074,8512495,34,8504387,34,0
V,-,8470258,0.25,0.25,4,3,1,0,1,gene,T23B12.8,0,8470235,0.609325,13796,8484054,23,8470258,0,-23
V,-,8461920,0.015015,0.0,333,328,5,4,6,gene,T23B12.7,1,8461913,1.04238,7902,8469822,7,8462000,-80,-87
V,-,8460796,0.791667,0.00253344,24,5,19,10,13,gene,T23B12.6,2,8460675,0.538459,40,8460836,121,8460225,571,450
V,-,8460225,0.436207,0.00029365,580,327,253,205,4,gene,T23B12.6,2,8460221,0.538459,611,8460836,4,8460225,0,-4
V,-,8447831,0.0,7.62939e-06,17,17,0,0,0,gene,T23B12.5,0,8447796,0.0838075,9586,8457417,35,8447709,122,87
V,-,8444605,0.0,2.35099e-38,125,125,0,0,1,gene,F52E1.13,0,8444576,2.96903,1809,8446414,29,8444579,26,-3
V,-,8438285,0.0,2.27374e-13,42,42,0,0,0,gene,F52E1.13,0,8438275,2.96903,8129,8446414,10,8438265,20,10
V,-,8428424,0.0483871,8.20091e-15,62,59,3,3,2,gene,F52E1.13,0,8428057,2.96903,17990,8446414,367,8428424,0,-367
V,-,8422543,0.00195542,0.0,2557,2552,5,3,12,gene,F52E1.13,0,8422522,2.96903,23871,8446414,21,8422543,0,-21
V,-,8413289,0.0584416,4.63297e-33,154,145,9,9,23,gene,F52E1.10,0,8413282,0.42249,2173,8415462,7,8413289,0,-7
V,-,8399155,0.0,1.17549e-38,126,126,0,0,2,gene,F52E1.9,0,8399144,0.654703,12426,8411581,11,8399155,0,-11
V,-,8394194,0.0714286,1.40816e-06,28,26,2,2,4,gene,F52E1.8,0,8394190,0.154129,3758,8397952,4,8394127,67,63
V,-,8385734,0.00200133,0.0,1499,1496,3,2,55,gene,F52E1.7,0,8385721,4.55332,6338,8392072,13,8385721,13,0
V,-,8358970,0.0015625,0.0,1280,1278,2,2,0,gene,F38E1.9,0,8358969,1.78011,14797,8373767,1,8358970,0,-1
V,-,8326505,0.0,0.00012207,13,13,0,0,0,gene,W02D7.9,0,8326494,0.00285289,877,8327382,11,8326321,184,173
V,-,8306267,0.015873,6.83047e-18,63,62,1,0,0,gene,W02D7.8,0,8306267,0.148219,18188,8324455,0,8306267,0,0
V,-,8304312,0.00152439,0.0,656,655,1,1,0,gene,W02D7.11,1,8304276,0.726923,625,8304937,36,8304276,36,0
V,-,8302387,0.00904977,0.0,3536,3504,32,22,87,gene,W02D7.7,2,8302372,5.14723,277,8302664,15,8302387,0,-15
V,-,8300988,0.621622,0.0104381,74,28,46,40,62,gene,W02D7.6,3,8300934,0.654588,298,8301286,54,8301136,-148,-202
V,-,8299046,0.118644,1.57008e-18,118,104,14,13,10,gene,W02D7.5,4,8299040,0.145662,547,8299593,6,8299053,-7,-13
V,-,8294708,0.0,8.96831e-44,143,143,0,0,9,gene,W02D7.3,0,8294687,0.191427,1657,8296365,21,8294687,21,0
V,-,8284743,0.0,0.5,1,1,0,0,0,gene,F21F8.11,0,8284692,0.185918,8821,8293564,51,8284692,51,0
V,-,8284707,0.0,6.61744e-24,77,77,0,0,1,gene,F21F8.11,0,8284692,0.185918,8857,8293564,15,8284692,15,0
V,-,8280687,0.0,0.5,1,1,0,0,1,gene,F21F8.10,0,8280677,0.00147295,1493,8282180,10,8280687,0,-10
V,-,8268744,0.00339629,0.0,12072,12031,41,31,16,gene,F21F8.7,0,8268742,51.4496,7264,8276008,2,8268744,0,-2
V,-,8250102,0.0,1.19209e-07,23,23,0,0,0,gene,C16D9.6,0,8250096,0.157988,6534,8256636,6,8250096,6,0
V,-,8245059,0.0,0.015625,6,6,0,0,4,gene,C16D9.5,0,8245048,0.0741135,2859,8247918,11,8245048,11,0
V,-,8242705,0.0,1.29247e-26,86,86,0,0,2,gene,C16D9.4,0,8242694,0.202422,801,8243506,11,8243008,-303,-314
V,-,8226718,0.0,3.05176e-05,15,15,0,0,1,gene,K07C11.10,0,8226660,0.127077,1364,8228082,58,8226660,58,0
V,-,8217511,0.016129,1.34441e-17,62,61,1,1,135,gene,K07C11.8,1,8217508,0.882395,578,8218089,3,8217511,0,-3
V,-,8213776,0.121951,6.59412e-19,123,108,15,7,1,gene,K07C11.7,2,8213714,2.94484,1550,8215326,62,8213776,0,-62
V,-,8209458,0.00515464,0.0,194,193,1,0,2,gene,K07C11.7,2,8209442,2.94484,5868,8215326,16,8209458,0,-16
V,-,8198902,0.00442478,0.0,226,225,1,0,4,gene,F20D6.11,0,8198892,0.436015,8722,8207624,10,8198902,0,-10
V,-,8195743,0.0,1.73472e-18,59,59,0,0,0,gene,F20D6.10,0,8195713,0.190976,839,8196582,30,8195610,133,103
V,-,8168077,0.0,6.16298e-33,107,107,0,0,2,gene,F20D6.8,0,8168028,0.196989,8824,8176901,49,8168077,0,-49
V,-,8168048,0.0,1.50463e-36,119,119,0,0,70,gene,F20D6.8,0,8168028,0.196989,8853,8176901,20,8168077,-29,-49
V,-,8129160,0.0,0.0,355,355,0,0,3,gene,D1014.8,0,8129157,0.432487,22757,8151917,3,8129160,0,-3
V,-,8069491,0.0,0.5,1,1,0,0,0,gene,C09H5.4,0,8069407,0.0133322,960,8070451,84,8069537,-46,-130
V,-,8040195,0.00522069,0.0,2107,2096,11,8,12,gene,ZC513.7,0,8040180,None,9347,8049542,15,8040195,0,-15
V,-,8039814,0.0,0.03125,5,5,0,0,8,gene,ZC513.7,0,8039744,None,9728,8049542,70,8040195,-381,-451
V,-,8024814,0.0,0.0625,4,4,0,0,0,gene,F43H9.3,0,8024805,0.301008,10254,8035068,9,8024731,83,74
V,-,8013759,0.0154321,0.0,324,319,5,3,2,gene,Y97E10AR.6,1,8013756,1.86746,9221,8022980,3,8013990,-231,-234
V,-,8012100,0.968182,0.0,1100,35,1065,739,2,gene,Y97E10AR.5,2,8012096,1.78851,104,8012204,4,8012153,-53,-57
V,-,8010914,0.885486,0.0,1502,172,1330,866,3,gene,Y97E10AR.7,3,8010914,2.85684,107,8011021,0,8010914,0,0
V,-,8009863,0.00343643,0.0,291,290,1,0,0,gene,Y97E10AR.4,1,8009860,0.392394,398,8010261,3,8010251,-388,-391
V,-,8007318,0.449814,0.0125714,269,148,121,110,5,gene,Y97E10AR.3,2,8007292,0.688747,511,8007829,26,8007292,26,0
V,-,7983239,0.000427168,0.0,2341,2340,1,1,0,gene,Y97E10AL.3,0,7983225,1.48509,10280,7993519,14,7983239,0,-14
V,-,7977871,0.0,0.0625,4,4,0,0,2,gene,F26D11.11,0,7977725,1.16714,4591,7982462,146,7977582,289,143
V,-,7977582,0.0,0.0,1467,1467,0,0,43,gene,F26D11.11,0,7977436,1.16714,4880,7982462,146,7977582,0,-146
V,-,7965452,0.0,0.03125,5,5,0,0,2,gene,F26D11.10,0,7965371,0.0803941,7277,7972729,81,7965637,-185,-266
V,-,7940206,0.0,0.25,2,2,0,0,0,gene,Y97E10B.10,0,7940191,0.0115111,7293,7947499,15,7940191,15,0
V,-,7932832,0.0,0.25,2,2,0,0,0,gene,Y97E10B.7,0,7932830,0.0149729,1398,7934230,2,7932830,2,0
V,-,7915552,0.0,0.125,3,3,0,0,3,gene,Y97E10B.6,0,7915536,None,14729,7930281,16,7915536,16,0
V,-,7899671,0.0285714,1.01863e-09,35,34,1,0,1,gene,F40A3.7,0,7899669,0.0870396,30610,7930281,2,7899669,2,0
V,-,7893670,0.00779727,0.0,513,509,4,4,1,gene,F40A3.6,0,7893670,1.28544,1768,7895438,0,7893672,-2,-2
V,-,7864570,0.0909091,0.00537109,11,10,1,0,0,gene,C37C3.11,0,7864548,0.0799536,3707,7868277,22,7864540,30,8
V,-,7853617,0.0,0.0078125,7,7,0,0,917,gene,C37C3.9,0,7853605,1.16021,6921,7860538,12,7853711,-94,-106
V,-,7846973,0.00378072,0.0,529,527,2,1,8,gene,C37C3.8,0,7846777,1.63082,5130,7852103,196,7846973,0,-196
V,-,7846700,0.0,0.5,1,1,0,0,6,gene,C37C3.8,0,7846673,1.63082,5403,7852103,27,7846422,278,251
V,-,7845977,0.0,0.25,2,2,0,0,11,gene,C37C3.8,0,7845876,1.63082,6126,7852103,101,7845977,0,-101
V,-,7845552,0.0,0.5,1,1,0,0,5,gene,C37C3.8,0,7845536,1.63082,6551,7852103,16,7845552,0,-16
V,-,7839394,0.0113636,2.84343e-25,88,87,1,1,14,gene,C37C3.12,1,7839390,0.257296,4758,7844152,4,7839394,0,-4
V,-,7837718,0.0235294,9.22823e-23,85,83,2,1,490,gene,C37C3.13,2,7837709,1.80602,679,7838397,9,7837744,-26,-35
V,-,7836740,0.0,0.125,3,3,0,0,18,gene,C37C3.7,0,7836737,0.167266,140,7836880,3,7836879,-139,-142
V,-,7814693,0.00166945,0.0,599,598,1,0,3,gene,ZK742.6,0,7814667,None,20338,7835031,26,7814754,-61,-87
V,-,7811592,0.0,2.01948e-28,92,92,0,0,1,gene,ZK742.4,0,7811568,0.23784,2724,7814316,24,7811594,-2,-26
V,-,7775888,0.00579377,0.0,191585,190475,1110,1036,26,gene,C26F1.9,0,7775885,574.686,25437,7801325,3,7775895,-7,-10
V,-,7775870,0.0,7.45058e-09,27,27,0,0,821194,gene,C26F1.9,0,7775819,574.686,25455,7801325,51,7775895,-25,-76
V,-,7754020,0.0,0.5,1,1,0,0,2,gene,T05B11.4,0,7753990,0.0714328,21518,7775538,30,7753948,72,42
V,-,7734720,0.00236967,0.0,1688,1684,4,3,0,gene,T05B11.3,0,7734694,4.57841,16988,7751708,26,7734720,0,-26
V,-,7733304,1.0,1.19209e-07,23,0,23,5,7,gene,T05B11.7,0,7733304,0.0748888,106,7733410,0,7733304,0,0
V,-,7701733,0.0,0.25,2,2,0,0,0,gene,ZK105.4,0,7701666,0.00285647,5415,7707148,67,7702056,-323,-390
V,-,7621870,0.00543478,0.0,184,183,1,0,0,gene,C50E3.12,0,7621838,0.212096,325,7622195,32,7621838,32,0
V,-,7609554,0.0,0.00195312,9,9,0,0,0,gene,C50E3.16,0,7609547,0.00410879,10759,7620313,7,7609547,7,0
V,-,7603295,0.0,0.0,481,481,0,0,3,gene,C50E3.11,0,7603281,0.181104,346,7603641,14,7603303,-8,-22
V,-,7590459,0.0,0.25,2,2,0,0,5,gene,C50E3.6,0,7590447,0.172992,4302,7594761,12,7590329,130,118
V,-,7587507,0.0125,8.40779e-45,160,158,2,2,0,gene,F19F10.11,0,7587446,0.324663,832,7588339,61,7587407,100,39
V,-,7558600,0.0,9.09495e-13,40,40,0,0,0,gene,F19F10.5,0,7558592,0.0648203,1380,7559980,8,7558592,8,0
V,-,7553559,0.015748,4.70257e-35,127,125,2,1,1,gene,F19F10.4,0,7553471,0.640625,3719,7557278,88,7553545,14,-74
V,-,7553545,0.0,0.00012207,13,13,0,0,484,gene,F19F10.4,0,7553471,0.640625,3733,7557278,74,7553545,0,-74
V,-,7544647,0.0,9.53674e-07,20,20,0,0,0,gene,C54F6.13,0,7544647,0.241689,1629,7546276,0,7544647,0,0
V,-,7522070,0.0,0.25,2,2,0,0,101,gene,C54F6.15,0,7522054,0.772889,14621,7536691,16,7522173,-103,-119
V,-,7435109,0.0,0.0078125,7,7,0,0,19,gene,F18E3.7,0,7434996,1.13576,113,7435222,113,7434841,268,155
V,-,7435089,0.0,2.98023e-08,25,25,0,0,35,gene,F18E3.7,0,7434996,1.13576,133,7435222,93,7434841,248,155
V,-,7434841,0.0,0.0,399,399,0,0,4,gene,F18E3.7,0,7434835,1.13576,381,7435222,6,7434841,0,-6
V,-,7430531,1.0,0.5,1,0,1,1,0,gene,F18E3.6,0,7430527,0.00566853,2662,7433193,4,7430821,-290,-294
V,-,7391836,0.0,5.42101e-20,64,64,0,0,10,gene,C02H6.2,0,7391834,0.143734,1521,7393357,2,7391896,-60,-62
V,-,7385981,0.0,0.00195312,9,9,0,0,3,gene,C03G6.19,0,7385880,0.208424,2216,7388197,101,7386116,-135,-236
V,-,7380888,0.0,0.0625,4,4,0,0,10,gene,C03G6.17,1,7380860,0.220997,941,7381829,28,7380894,-6,-34
V,-,7380872,0.0,9.09495e-13,40,40,0,0,105,gene,C03G6.17,1,7380860,0.220997,957,7381829,12,7380894,-22,-34
V,-,7247125,0.0,0.25,2,2,0,0,10,gene,C05C8.7,0,7246827,2.12878,4927,7252052,298,7247107,18,-280
V,-,7247097,0.0,8.67362e-19,60,60,0,0,14,gene,C05C8.7,0,7246827,2.12878,4955,7252052,270,7247097,0,-270
V,-,7246967,0.0,3.46945e-18,58,58,0,0,53,gene,C05C8.7,0,7246827,2.12878,5085,7252052,140,7246967,0,-140
V,-,7246860,0.0,0.0,529,529,0,0,150,gene,C05C8.7,0,7246827,2.12878,5192,7252052,33,7246860,0,-33
V,-,7236940,0.015625,2.3886e-35,128,126,2,2,1,gene,C05C8.6,1,7236936,0.921907,5785,7242725,4,7236940,0,-4
V,-,7234636,0.961538,0.0,234,9,225,159,2,gene,C05C8.5,2,7234623,0.535647,98,7234734,13,7234636,0,-13
V,-,7230658,0.0,0.0,838,838,0,0,6,gene,C05C8.4,1,7230655,0.731273,1845,7232503,3,7230658,0,-3
V,-,7223062,0.413793,4.13707e-14,1798,1054,744,529,279,gene,C13F10.7,2,7223062,1.51359,2522,7225584,0,7223062,0,0
V,-,7220849,0.60989,0.000720043,182,71,111,86,2,gene,C13F10.6,3,7220843,0.598473,1010,7221859,6,7220789,60,54
V,-,7218812,0.890071,2.52234e-44,282,31,251,173,19,gene,C13F10.5,4,7218799,0.681781,112,7218924,13,7218850,-38,-51
V,-,7214710,0.811688,8.12816e-16,154,29,125,79,0,gene,C13F10.4,5,7214697,0.798696,111,7214821,13,7214697,13,0
V,-,7195946,0.00521027,0.0,2687,2673,14,13,1,gene,F09G2.9,1,7195944,4.41327,9489,7205435,2,7195946,0,-2
V,-,7193478,0.866142,3.1344e-18,127,17,110,88,2,gene,F09G2.8,2,7193467,0.798518,95,7193573,11,7193471,7,-4
V,-,7193471,0.963612,0.0,742,27,715,613,435,gene,F09G2.8,2,7193467,0.798518,102,7193573,4,7193471,0,-4
V,-,7152955,0.020202,7.65353e-27,99,97,2,2,0,gene,F10D2.9,0,7152940,0.317269,1354,7154309,15,7152955,0,-15
V,-,7138233,0.0,0.03125,5,5,0,0,0,gene,F10D2.4,0,7138226,0.0118508,1057,7139290,7,7138226,7,0
V,-,7093540,0.0122699,1.4013e-45,163,161,2,1,44,gene,VC5.5,1,7093540,0.192349,23657,7117197,0,7093562,-22,-22
V,-,7091382,0.928571,1.40816e-06,28,2,26,14,9,gene,VC5.6,2,7091350,0.0844683,143,7091525,32,7091350,32,0
V,-,7084472,0.0,0.0,542,542,0,0,2,gene,VC5.4,0,7084463,0.93074,4885,7089357,9,7084472,0,-9
V,-,7065130,0.00094697,0.0,1056,1055,1,0,7,gene,Y57E12AR.1,0,7065130,1.23209,16224,7081354,0,7065132,-2,-2
V,-,7060168,0.00392071,0.0,4591,4573,18,14,0,gene,Y57E12AL.6,1,7060168,5.957,3336,7063504,0,7060170,-2,-2
V,-,7059434,0.854195,0.0,727,106,621,486,0,gene,Y57E12AL.5,2,7059429,0.983564,64,7059498,5,7059429,5,0
V,-,7053010,0.00109709,0.0,5469,5463,6,4,2,gene,F20A1.10,0,7053007,7.34998,5347,7058357,3,7053012,-2,-5
V,-,7047416,0.0078125,3.76158e-37,128,127,1,1,1,gene,F20A1.8,0,7047414,0.401653,1826,7049242,2,7047414,2,0
V,-,7026893,0.00078064,0.0,1281,1280,1,1,30,gene,F20A1.6,0,7026890,1.9377,1249,7028142,3,7026890,3,0
V,-,7021687,0.0,0.000488281,11,11,0,0,0,gene,F20A1.4,0,7021579,0.0333697,2788,7024475,108,7021613,74,-34
V,-,6996908,0.0,1.13687e-13,43,43,0,0,1,gene,C33G8.11,0,6996879,0.231421,10410,7007318,29,6996901,7,-22
V,-,6996901,0.0,1.52588e-05,16,16,0,0,24,gene,C33G8.11,0,6996879,0.231421,10417,7007318,22,6996901,0,-22
V,-,6991671,0.0,0.0078125,7,7,0,0,0,gene,C33G8.10,1,6991671,0.0318087,3353,6995024,0,6991671,0,0
V,-,6989486,0.611111,0.0552434,36,14,22,11,3,gene,C33G8.9,2,6989470,0.0709617,470,6989956,16,6989486,0,-16
V,-,6987581,1.0,0.00012207,13,0,13,6,2,gene,C33G8.8,3,6987565,0.0572843,92,6987673,16,6987565,16,0
V,-,6987576,1.0,0.25,2,0,2,2,1,gene,C33G8.8,3,6987565,0.0572843,97,6987673,11,6987565,11,0
V,-,6985843,1.0,0.03125,5,0,5,1,0,gene,C33G8.12,4,6985820,0.0645657,105,6985948,23,6985853,-10,-33
V,-,6985837,1.0,7.62939e-06,17,0,17,14,0,gene,C33G8.12,4,6985820,0.0645657,111,6985948,17,6985853,-16,-33
V,-,6981979,0.0,9.53674e-07,20,20,0,0,0,gene,C33G8.7,0,6981968,0.110309,1206,6983185,11,6981979,0,-11
V,-,6978950,0.0,0.125,3,3,0,0,0,gene,T07H8.7,0,6978926,0.000907737,1460,6980410,24,6978926,24,0
V,-,6969810,0.0,0.00012207,13,13,0,0,5,gene,T07H8.6,0,6969796,0.118439,7752,6977562,14,6969937,-127,-141
V,-,6928848,0.0,0.0,301,301,0,0,0,gene,K11C4.5,0,6928848,0.555661,2437,6931285,0,6928848,0,0
V,-,6900033,0.000972763,0.0,1028,1027,1,1,4,gene,K11C4.4,0,6899766,2.92168,1465,6901498,267,6900033,0,-267
V,-,6854620,0.0,0.125,3,3,0,0,0,gene,C55H1.2,0,6854614,0.0205074,43726,6898346,6,6854614,6,0
V,-,6838470,0.166667,0.09375,6,5,1,1,0,gene,T15B7.15,0,6838443,0.0320497,1561,6840031,27,6838441,29,2
V,-,6792476,0.0110701,0.0,271,268,3,3,0,gene,ZC404.9,0,6792471,0.88513,5483,6797959,5,6792476,0,-5
V,-,6784714,0.00313316,0.0,5745,5727,18,18,3,gene,ZC404.8,0,6784713,6.24443,3506,6788220,1,6784714,0,-1
V,-,6732899,0.0,1.52588e-05,16,16,0,0,3,gene,ZC487.5,0,6732887,0.0877854,27352,6760251,12,6732887,12,0
V,-,6718141,0.0,0.5,1,1,0,0,3,gene,W02F12.7,0,6718108,0.0121288,2065,6720206,33,6718108,33,0
V,-,6708912,0.38879,1.62713e-14,1124,687,437,313,0,gene,W02F12.5,2,6708901,5.66233,477,6709389,11,6708912,0,-11
V,-,6706741,0.918639,0.0,676,55,621,496,6,gene,W02F12.4,3,6706710,0.913518,129,6706870,31,6706743,-2,-33
V,-,6697463,0.0165289,2.73091e-33,121,119,2,1,13,gene,W02F12.2,0,6697462,0.557221,6916,6704379,1,6697463,0,-1
V,-,6688303,0.0,7.10543e-15,47,47,0,0,6,gene,K11G9.5,0,6688296,0.209859,2877,6691180,7,6688358,-55,-62
V,-,6681384,0.0,4.59177e-41,134,134,0,0,4,gene,K11G9.4,0,6681378,1.16978,4196,6685580,6,6681384,0,-6
V,-,6665624,0.0,0.0,359,359,0,0,4,gene,T10H9.5,0,6665619,1.05158,1577,6667201,5,6665624,0,-5
V,-,6656312,0.0048651,0.0,2261,2250,11,10,1,gene,T10H9.4,1,6656282,6.77833,5685,6661997,30,6656312,0,-30
V,-,6655278,0.0,0.25,2,2,0,0,1,gene,T10H9.3,2,6655259,0.651188,91,6655369,19,6655259,19,0
V,-,6655260,0.89166,0.0,1283,139,1144,863,4,gene,T10H9.3,2,6655259,0.651188,109,6655369,1,6655259,1,0
V,-,6610969,0.0342857,7.63708e-43,175,169,6,6,0,gene,F44C4.4,0,6610969,0.929904,13547,6624516,0,6610969,0,0
V,-,6605186,0.0,0.0,274,274,0,0,1,gene,ZK1055.7,1,6605184,0.602389,1064,6606250,2,6605186,0,-2
V,-,6602415,0.904762,2.25382e-15,84,8,76,43,0,gene,ZK1055.6,2,6602415,0.184781,124,6602539,0,6602415,0,0
V,-,6537873,0.0022831,0.0,876,874,2,1,0,gene,K04A8.6,0,6537745,1.32415,15937,6553810,128,6537873,0,-128
V,-,6533154,0.0,4.76837e-07,21,21,0,0,1,gene,F46E10.11,0,6533086,0.693352,269,6533423,68,6532886,268,200
V,-,6516337,0.00400534,0.0,4494,4476,18,13,2,gene,F46E10.10,1,6516336,15.2936,15505,6531842,1,6516337,0,-1
V,-,6515912,1.0,0.0625,4,0,4,4,3,gene,F46E10.10,1,6515881,15.2936,15930,6531842,31,6515912,0,-31
V,-,6513157,0.108706,0.0,2171,1935,236,176,8,gene,F46E10.9,2,6513156,4.82728,1931,6515088,1,6513157,0,-1
V,-,6511220,0.184049,1.66319e-32,326,266,60,52,1,gene,F46E10.8,3,6511199,0.627676,175,6511395,21,6511220,0,-21
V,-,6509621,0.88,1.48738e-26,175,21,154,106,56,gene,Y40G12A.2,4,6509621,0.720655,100,6509721,0,6509695,-74,-74
V,-,6508614,0.957672,0.0,567,24,543,353,1,gene,Y40G12A.1,5,6508614,1.37177,68,6508682,0,6508614,0,0
V,-,6505200,0.0,4.65661e-10,31,31,0,0,20,gene,W01A11.7,1,6505187,1.17211,1365,6506565,13,6505190,10,-3
V,-,6505190,0.00341297,0.0,293,292,1,0,90,gene,W01A11.7,1,6505187,1.17211,1375,6506565,3,6505190,0,-3
V,-,6503992,0.786364,2.1765e-35,440,94,346,140,0,gene,W01A11.6,2,6503950,1.16495,362,6504354,42,6503992,0,-42
V,-,6493732,0.00862069,0.0,232,230,2,1,3,gene,W01A11.5,0,6493732,0.516126,8447,6502179,0,6493732,0,0
V,-,6488929,0.0,1.81899e-12,39,39,0,0,5,gene,W01A11.4,0,6488912,14.2678,968,6489897,17,6488861,68,51
V,-,6441522,0.04,7.45058e-07,25,24,1,1,0,gene,T05H4.15,0,6441509,0.0713468,46492,6488014,13,6441522,0,-13
V,-,6433307,0.0114286,0.0,350,346,4,2,0,gene,T05H4.14,1,6433298,1.07079,6743,6440050,9,6433307,0,-9
V,-,6429725,0.288647,2.12214e-35,828,589,239,170,4,gene,T05H4.13,2,6429723,2.92622,1387,6431112,2,6429725,0,-2
V,-,6427482,0.9,0.00976562,10,1,9,8,61,gene,T05H4.12,3,6427449,19.9996,145,6427627,33,6427488,-6,-39
V,-,6426923,0.193824,0.0,14962,12062,2900,2139,1,gene,T05H4.12,3,6426921,19.9996,98,6427021,2,6426923,0,-2
V,-,6426016,0.666667,0.375,3,1,2,1,7,gene,T05H4.11,4,6425990,2.18778,2,6426018,26,6425763,253,227
V,-,6425763,0.726636,6.70943e-22,428,117,311,229,49,gene,T05H4.11,4,6425746,2.18778,233,6425996,17,6425763,0,-17
V,-,6423966,0.874214,1.72369e-23,159,20,139,98,1,gene,T05H4.10,5,6423966,0.556726,93,6424059,0,6423966,0,0
V,-,6408594,0.0,9.31323e-10,30,30,0,0,0,gene,F57F4.4,0,6408594,3.45013,8712,6417306,0,6408594,0,0
V,-,6400026,0.0,0.0078125,7,7,0,0,0,gene,F57F4.3,0,6399914,3.91313,1159,6401185,112,6399732,294,182
V,-,6399732,0.0,2.32831e-10,32,32,0,0,0,gene,F57F4.3,0,6399732,3.91313,1453,6401185,0,6399732,0,0
V,-,6374749,0.0,1.32349e-23,76,76,0,0,0,gene,F13H6.5,0,6374744,0.153035,17602,6392351,5,6374744,5,0
V,-,6368347,0.0,0.03125,5,5,0,0,0,gene,F13H6.4,0,6368344,0.00952026,3578,6371925,3,6368320,27,24
V,-,6365482,0.00833333,9.0278e-35,120,119,1,1,18,gene,F13H6.3,0,6365479,0.578733,760,6366242,3,6365482,0,-3
V,-,6311819,0.0,2.38419e-07,22,22,0,0,1,gene,K12B6.8,0,6311812,0.0330687,22005,6333824,7,6311821,-2,-9
V,-,6267006,0.00338983,0.0,295,294,1,1,7,gene,K08B12.5,0,6267002,1.11248,13133,6280139,4,6267002,4,0
V,-,6226821,0.00389484,0.0,1027,1023,4,4,3,gene,W06H8.6,0,6226792,4.31007,20814,6247635,29,6226821,0,-29
V,-,6202437,0.0,4.76837e-07,21,21,0,0,1,gene,W06H8.8,0,6202344,0.217159,2240,6204677,93,6202437,0,-93
V,-,6120017,0.00406504,0.0,492,490,2,2,2,gene,F17A9.6,0,6120012,0.260735,1066,6121083,5,6120012,5,0
V,-,6100353,0.00571895,0.0,9792,9736,56,51,4,gene,Y38A10A.5,0,6100320,53.4509,1301,6101654,33,6100353,0,-33
V,-,6060022,0.0,0.5,1,1,0,0,1,gene,Y38A10A.2,0,6060010,0.203257,5294,6065316,12,6060010,12,0
V,-,6053047,0.00192493,0.0,1039,1037,2,2,22,gene,R01B10.6,1,6053016,0.704884,4130,6057177,31,6053011,36,5
V,-,6051070,0.943182,6.32397e-38,176,10,166,102,1,gene,R01B10.5,2,6051064,0.814173,115,6051185,6,6051070,0,-6
V,-,6051065,0.692308,0.0872803,13,4,9,5,8,gene,R01B10.5,2,6051064,0.814173,120,6051185,1,6051070,-5,-6
V,-,6047723,0.868421,1.26331e-11,76,10,66,38,7,gene,R01B10.4,3,6047719,0.353483,34,6047757,4,6047719,4,0
V,-,6044855,0.0,7.10543e-15,47,47,0,0,903,gene,R01B10.3,0,6044854,2.21057,596,6045451,1,6044888,-33,-34
V,-,6030203,0.00664452,0.0,301,299,2,1,2,gene,F29G9.6,0,6030186,0.369394,4951,6035154,17,6030186,17,0
V,-,6017480,0.00562475,0.0,2489,2475,14,12,2,gene,F29G9.5,0,6017479,3.69922,8685,6026165,1,6017480,0,-1
V,-,5990063,0.0,5.55112e-17,54,54,0,0,0,gene,C10F3.6,0,5990041,0.425823,4101,5994164,22,5990063,0,-22
V,-,5963643,0.0,5.68434e-14,44,44,0,0,121,gene,C10F3.5,0,5963578,0.705449,21609,5985252,65,5963647,-4,-69
V,-,5963563,0.0,0.5,1,1,0,0,154,gene,C10F3.5,0,5963515,0.705449,21689,5985252,48,5963647,-84,-132
V,-,5954652,0.0142857,5.92923e-20,70,69,1,1,0,gene,M03F8.6,0,5954651,0.178932,5744,5960396,1,5954651,1,0
V,-,5919485,0.0,0.25,2,2,0,0,0,gene,C04E6.12,0,5919463,0.0576487,13697,5933182,22,5919564,-79,-101
V,-,5917640,0.0,0.015625,6,6,0,0,112,gene,C04E6.11,0,5917626,0.26607,233,5917873,14,5917659,-19,-33
V,-,5883646,0.0,7.88861e-31,100,100,0,0,4,gene,C04E6.8,0,5883615,0.142003,14703,5898349,31,5883615,31,0
V,-,5883316,0.0,0.25,2,2,0,0,4,gene,C04E6.8,0,5883294,0.142003,15033,5898349,22,5883615,-299,-321
V,-,5867763,0.0,0.0,465,465,0,0,3,gene,F26F12.4,0,5867732,0.465527,14610,5882373,31,5867763,0,-31
V,-,5864980,0.0,7.45058e-09,27,27,0,0,9,gene,F26F12.5,0,5864960,0.13065,967,5865947,20,5864960,20,0
V,-,5864972,0.0,1.19209e-07,23,23,0,0,44,gene,F26F12.5,0,5864960,0.13065,975,5865947,12,5864960,12,0
V,-,5855133,0.0,0.00390625,8,8,0,0,2,gene,F26F12.8,0,5855133,0.650468,8715,5863848,0,5855133,0,0
V,-,5845530,0.00165426,0.0,1209,1207,2,1,1,gene,F26F12.3,1,5845486,4.42214,9069,5854599,44,5845530,0,-44
V,-,5844043,0.0,5.96046e-08,24,24,0,0,1,gene,F26F12.3,1,5843963,4.42214,10556,5854599,80,5844043,0,-80
V,-,5842541,0.0,7.27596e-12,37,37,0,0,3,gene,F26F12.3,1,5842529,4.42214,12058,5854599,12,5842541,0,-12
V,-,5812898,0.0,1.45519e-11,36,36,0,0,868,gene,ZC250.4,0,5812877,None,22762,5835660,21,5812968,-70,-91
V,-,5790071,0.0,0.125,3,3,0,0,7,gene,F44E7.8,0,5789935,0.0875384,4537,5794608,136,5790175,-104,-240
V,-,5789266,0.0,3.63798e-12,38,38,0,0,0,gene,F44E7.8,0,5789251,0.0875384,5342,5794608,15,5789297,-31,-46
V,-,5780610,0.00338983,0.0,295,294,1,1,108,gene,F44E7.5,1,5780587,1.32284,490,5781100,23,5780652,-42,-65
V,-,5776762,0.145658,4.2039e-45,357,305,52,39,16,gene,F44E7.4,2,5776753,2.15967,1866,5778628,9,5776762,0,-9
V,-,5776466,0.152778,3.86992e-35,288,244,44,32,3,gene,F44E7.4,2,5776396,2.15967,2162,5778628,70,5776466,0,-70
V,-,5760041,0.0,0.125,3,3,0,0,0,gene,C53A3.1,0,5760041,0.00903411,2308,5762349,0,5760043,-2,-2
V,-,5735799,0.0666667,0.000457764,15,14,1,1,2,gene,K09H11.6,0,5735756,0.140845,16474,5752273,43,5735756,43,0
V,-,5691380,0.0,1.50463e-36,119,119,0,0,0,gene,F25B4.8,0,5691368,0.714785,20850,5712230,12,5691382,-2,-14
V,-,5687038,0.0,0.0,855,855,0,0,5,gene,F25B4.7,0,5686982,0.893371,2875,5689913,56,5687193,-155,-211
V,-,5684401,0.0084507,0.0,355,352,3,3,7,gene,F25B4.6,1,5684399,0.679255,677,5685078,2,5684401,0,-2
V,-,5682442,0.919105,0.0,581,47,534,378,5,gene,F25B4.5,2,5682442,1.28192,90,5682532,0,5682442,0,0
V,-,5675923,0.0,5.55112e-17,54,54,0,0,0,gene,C14C11.8,0,5675894,1.3045,2485,5678408,29,5675899,24,-5
V,-,5675899,0.0,5.29396e-23,74,74,0,0,77,gene,C14C11.8,0,5675894,1.3045,2509,5678408,5,5675899,0,-5
V,-,5665892,0.00525624,0.0,1522,1514,8,8,1,gene,C14C11.7,0,5665877,3.21689,3531,5669423,15,5666275,-383,-398
V,-,5660516,0.00490196,0.0,204,203,1,1,0,gene,C14C11.6,0,5660516,0.197703,4535,5665051,0,5660518,-2,-2
V,-,5630704,0.0,0.000244141,12,12,0,0,0,gene,T01C2.1,0,5630690,0.102472,27821,5658525,14,5630704,0,-14
V,-,5619013,0.00795229,0.0,503,499,4,4,1,gene,M03E7.5,0,5619008,1.1779,5524,5624537,5,5619013,0,-5
V,-,5601167,0.027027,1.4299e-19,74,72,2,2,0,gene,CD4.8,0,5601141,0.257481,7950,5609117,26,5601141,26,0
V,-,5596229,0.0,5.82077e-11,34,34,0,0,130,gene,CD4.7,0,5596197,0.657306,2214,5598443,32,5596336,-107,-139
V,-,5584164,0.0,6.61744e-24,77,77,0,0,0,gene,CD4.6,0,5584146,5.88978,11301,5595465,18,5584160,4,-14
V,-,5584155,0.00947522,0.0,1372,1359,13,11,142,gene,CD4.6,0,5584146,5.88978,11310,5595465,9,5584155,0,-9
V,-,5581215,0.0416667,1.43051e-06,24,23,1,1,20,gene,C18C4.10,0,5581153,1.99394,1758,5582973,62,5581215,0,-62
V,-,5579341,0.00497512,0.0,603,600,3,2,3,gene,C18C4.10,0,5579316,1.99394,3632,5582973,25,5579341,0,-25
V,-,5570345,0.0222222,1.27898e-12,45,44,1,0,0,gene,C18C4.9,0,5570325,0.0815491,4875,5575220,20,5570345,0,-20
V,-,5567031,0.0,0.00195312,9,9,0,0,1,gene,C18C4.7,0,5567024,0.0531537,966,5567997,7,5567031,0,-7
V,-,5557115,0.00446429,0.0,224,223,1,1,3,gene,C18C4.5,0,5557093,0.78733,7003,5564118,22,5557093,22,0
V,-,5555835,0.0,0.00390625,8,8,0,0,8,gene,C18C4.5,0,5555831,0.78733,8283,5564118,4,5555831,4,0
V,-,5547874,0.00505051,0.0,198,197,1,1,0,gene,C18C4.3,0,5547866,0.381633,2257,5550131,8,5547885,-11,-19
V,-,5536055,0.0248447,9.22475e-42,161,157,4,3,2,gene,C24G6.8,0,5536032,2.50699,9408,5545463,23,5536055,0,-23
V,-,5535791,0.00462606,0.0,1297,1291,6,6,0,gene,C24G6.8,0,5535542,2.50699,75,5535866,249,5535791,0,-249
V,-,5513722,0.0,0.5,1,1,0,0,1,gene,C24G6.6,0,5513570,2.05795,16962,5530684,152,5513518,204,52
V,-,5512442,0.0,0.125,3,3,0,0,26,gene,C24G6.6,0,5512313,2.05795,18242,5530684,129,5512412,30,-99
V,-,5512412,0.00152207,0.0,657,656,1,1,511,gene,C24G6.6,0,5512313,2.05795,18272,5530684,99,5512412,0,-99
V,-,5512362,0.0,0.5,1,1,0,0,427,gene,C24G6.6,0,5512313,2.05795,18322,5530684,49,5512412,-50,-99
V,-,5504662,0.0167866,0.0,1251,1230,21,20,1,gene,T05C3.5,0,5504657,4.85679,5078,5509740,5,5504662,0,-5
V,-,5470785,0.0,0.0625,4,4,0,0,0,gene,ZC317.7,0,5470755,0.0843541,9985,5480770,30,5470809,-24,-54
V,-,5468398,0.5,0.5,2,1,1,0,0,gene,ZC317.6,0,5468364,0.0665972,140,5468538,34,5468421,-23,-57
V,-,5453527,0.0,0.000488281,11,11,0,0,0,gene,ZC317.3,0,5453482,0.039534,10074,5463601,45,5453527,0,-45
V,-,5438978,0.0,2.38419e-07,22,22,0,0,0,gene,F08F3.9,0,5438973,0.102944,10119,5449097,5,5438973,5,0
V,-,5392836,0.0,9.53674e-07,20,20,0,0,1,gene,C35A11.4,0,5392828,0.172991,16965,5409801,8,5392836,0,-8
V,-,5328226,0.00192308,0.0,520,519,1,1,21,gene,C10G8.8,0,5328218,1.44935,13723,5341949,8,5328195,31,23
V,-,5326963,0.0,0.00195312,9,9,0,0,0,gene,C10G8.8,0,5326798,1.44935,14986,5341949,165,5326963,0,-165
V,-,5277913,0.004329,0.0,462,460,2,2,0,gene,B0238.9,0,5277874,0.685473,8243,5286156,39,5277913,0,-39
V,-,5233691,0.0,0.03125,5,5,0,0,25,gene,C52A10.1,0,5233666,0.395289,922,5234613,25,5233700,-9,-34
V,-,5198152,0.00378788,0.0,264,263,1,1,3,gene,Y47A7.2,0,5198139,0.643389,32134,5230286,13,5198144,8,-5
V,-,5192360,0.0,0.5,1,1,0,0,1,gene,C03A7.13,0,5192357,0.0464084,445,5192805,3,5192343,17,14
V,-,5192348,0.0,0.25,2,2,0,0,3,gene,C03A7.13,0,5192343,0.0464084,457,5192805,5,5192343,5,0
V,-,5177073,0.0,2.27374e-13,42,42,0,0,5,gene,C03A7.11,0,5177068,0.234507,1078,5178151,5,5177068,5,0
V,-,5143630,0.0,0.25,2,2,0,0,19,gene,F14F9.7,0,5143629,0.00986768,2309,5145939,1,5143611,19,18
V,-,5118977,0.0,2.11758e-22,72,72,0,0,2,gene,C04F5.9,1,5118969,0.260287,23134,5142111,8,5119022,-45,-53
V,-,5118970,0.0,5.55112e-17,54,54,0,0,8,gene,C04F5.9,1,5118969,0.260287,23141,5142111,1,5119022,-52,-53
V,-,5113567,0.932773,0.0,357,24,333,258,3,gene,C04F5.8,2,5113566,1.0609,987,5114554,1,5113567,0,-1
V,-,5101948,0.0,0.125,3,3,0,0,0,gene,C04F5.4,0,5101930,0.000674842,905,5102853,18,5101930,18,0
V,-,5089354,0.0,9.09495e-13,40,40,0,0,1,gene,Y58A7A.6,0,5089290,0.134715,4172,5093526,64,5089290,64,0
V,-,5086780,0.0,4.54747e-13,41,41,0,0,0,gene,Y58A7A.5,0,5086766,0.116958,634,5087414,14,5086934,-154,-168
V,-,5084834,0.0,3.05176e-05,15,15,0,0,0,gene,Y58A7A.4,0,5084820,0.0396315,867,5085701,14,5084820,14,0
V,-,5080716,0.00502513,0.0,199,198,1,1,0,gene,Y58A7A.3,0,5080637,0.345084,1097,5081813,79,5080709,7,-72
V,-,5080709,0.0,0.0078125,7,7,0,0,50,gene,Y58A7A.3,0,5080637,0.345084,1104,5081813,72,5080709,0,-72
V,-,5071875,0.0,5.55112e-17,54,54,0,0,137,gene,Y58A7A.2,0,5071867,0.290092,5790,5077665,8,5072044,-169,-177
V,-,5068484,0.0,3.8147e-06,18,18,0,0,0,gene,Y58A7A.1,0,5068446,1.16182,3027,5071511,38,5068428,56,18
V,-,5064616,0.0017452,0.0,573,572,1,1,2,gene,K11D12.10,0,5064590,0.41942,2772,5067388,26,5064616,0,-26
V,-,5046016,0.0,0.03125,5,5,0,0,2,gene,K11D12.9,0,5045981,0.159609,10175,5056191,35,5046016,0,-35
V,-,5040808,0.0,5.82077e-11,34,34,0,0,52,gene,K11D12.8,0,5040808,0.133412,1385,5042193,0,5040808,0,0
V,-,5038266,0.00714286,1.00445e-40,140,139,1,1,1,gene,K11D12.11,1,5038227,0.584191,914,5039180,39,5037826,440,401
V,-,5037961,0.5,0.5,2,1,1,1,4,gene,K11D12.11,1,5037826,0.584191,1219,5039180,135,5037826,135,0
V,-,5036277,0.936667,0.0,900,57,843,440,1,gene,K11D12.7,2,5036277,3.6104,108,5036385,0,5036277,0,0
V,-,5030622,0.00474684,0.0,632,629,3,3,3,gene,K11D12.5,0,5030620,1.64951,3717,5034339,2,5030621,1,-1
V,-,5027536,0.0,0.0,166,166,0,0,0,gene,K11D12.4,0,5027529,0.562223,1597,5029133,7,5027538,-2,-9
V,-,5000294,0.0,0.25,2,2,0,0,7,gene,C13D9.9,0,5000286,0.0537909,23226,5023520,8,5000381,-87,-95
V,-,4962910,0.016,1.82202e-34,125,123,2,2,3,gene,F26G5.9,0,4962808,3.07531,8672,4971582,102,4962900,10,-92
V,-,4914802,0.0,1.19209e-07,23,23,0,0,6,gene,H23N18.6,0,4914799,0.0787565,3163,4917965,3,4914893,-91,-94
V,-,4912195,0.00345168,0.0,2028,2021,7,5,3,gene,H23N18.5,0,4912194,4.77746,711,4912906,1,4912194,1,0
V,-,4860338,0.00381679,0.0,524,522,2,0,0,gene,C37H5.13,0,4860281,1.23209,13805,4874143,57,4860281,57,0
V,-,4826574,0.00777935,0.0,2828,2806,22,19,2,gene,C37H5.8,1,4826569,7.70923,5257,4831831,5,4826574,0,-5
V,-,4821766,0.394408,0.0,4721,2859,1862,1096,3,gene,C37H5.6,2,4821766,7.60421,2008,4823774,0,4821766,0,0
V,-,4818477,0.872727,4.08981e-24,165,21,144,113,2,gene,R02F11.4,3,4818476,0.555206,41,4818518,1,4818477,0,-1
V,-,4805761,0.00446429,0.0,224,223,1,1,0,gene,R02F11.3,0,4805753,0.399522,4980,4810741,8,4805761,0,-8
V,-,4729998,0.0,0.00195312,9,9,0,0,76,gene,F39G3.8,0,4729934,0.311888,29287,4759285,64,4729983,15,-49
V,-,4700103,0.0,8.88178e-16,50,50,0,0,1,gene,ZC266.1,0,4700103,0.0338033,15099,4715202,0,4700293,-190,-190
V,-,4692245,0.00209518,0.0,3341,3334,7,7,2,gene,K03B4.7,0,4692225,4.78642,2543,4694788,20,4692247,-2,-22
V,-,4648055,0.00128546,0.0,59123,59047,76,65,10,gene,F41F3.3,0,4648053,49.9423,4620,4652675,2,4648055,0,-2
V,-,4636982,0.0,3.55271e-15,48,48,0,0,0,gene,F54D11.3,0,4636958,0.0476243,385,4637367,24,4636828,154,130
V,-,4615631,0.00694444,6.45718e-42,144,143,1,1,0,gene,Y61A9LA.10,1,4615622,0.686258,12759,4628390,9,4615631,0,-9
V,-,4606740,0.953153,0.0,555,26,529,415,1,gene,Y61A9LA.11,2,4606727,0.341939,118,4606858,13,4606740,0,-13
V,-,4569857,0.00222717,0.0,449,448,1,1,8,gene,Y61A9LA.8,0,4569841,1.34964,3090,4572947,16,4569857,0,-16
V,-,4549105,0.00225734,0.0,443,442,1,1,0,gene,T28F12.3,0,4549105,0.709552,8964,4558069,0,4549105,0,0
V,-,4454635,0.0,0.125,3,3,0,0,0,gene,H22D07.1,0,4454544,0.121641,22787,4477422,91,4454548,87,-4
V,-,4454548,0.0,4.76837e-07,21,21,0,0,1,gene,H22D07.1,0,4454544,0.121641,22874,4477422,4,4454548,0,-4
V,-,4450369,0.0194553,0.0,257,252,5,4,2,gene,Y47D7A.14,0,4450363,0.502299,490,4450859,6,4450369,0,-6
V,-,4446029,0.0,0.0625,4,4,0,0,1,gene,Y47D7A.16,0,4446020,0.152756,4830,4450859,9,4446029,0,-9
V,-,4444392,0.0,0.25,2,2,0,0,0,gene,Y47D7A.16,0,4444282,0.152756,6467,4450859,110,4444392,0,-110
V,-,4435742,0.00221852,0.0,3606,3598,8,6,1,gene,Y47D7A.13,0,4435741,7.08079,3109,4438851,1,4435741,1,0
V,-,4423769,0.0,0.125,3,3,0,0,0,gene,Y47D7A.9,0,4423761,0.0210351,3816,4427585,8,4423761,8,0
V,-,4399344,0.0,4.1359e-25,81,81,0,0,1,gene,F13A2.4,0,4399317,0.0793594,1766,4401110,27,4399317,27,0
V,-,4387320,0.0,0.000976562,10,10,0,0,1,gene,F13A2.9,0,4387316,0.0120078,6276,4393596,4,4387316,4,0
V,-,4384214,0.0,0.25,2,2,0,0,0,gene,F13A2.2,0,4384054,0.0196241,87,4384301,160,4384054,160,0
V,-,4382220,1.0,0.5,1,0,1,0,0,gene,F13A2.1,0,4382196,0.00403616,367,4382587,24,4382196,24,0
V,-,4382210,1.0,0.25,2,0,2,0,0,gene,F13A2.1,0,4382196,0.00403616,377,4382587,14,4382196,14,0
V,-,4377546,0.6,0.3125,5,2,3,3,0,gene,F32D1.8,0,4377536,0.00588032,2556,4380102,10,4377536,10,0
V,-,4375998,0.0,7.62939e-06,17,17,0,0,0,gene,F32D1.7,1,4375981,1.88612,433,4376431,17,4375993,5,-12
V,-,4375987,0.00680272,0.0,1029,1022,7,6,11,gene,F32D1.7,1,4375981,1.88612,444,4376431,6,4375993,-6,-12
V,-,4374688,0.862712,0.0,590,81,509,415,67,gene,F32D1.6,2,4374660,0.955732,100,4374788,28,4374572,116,88
V,-,4374581,0.0,5.96046e-08,24,24,0,0,1,gene,F32D1.6,2,4374572,0.955732,207,4374788,9,4374572,9,0
V,-,4371197,0.0,0.015625,6,6,0,0,1,gene,F32D1.5,0,4371156,10.1068,2330,4373527,41,4371174,23,-18
V,-,4371174,0.00336215,0.0,4164,4150,14,12,83,gene,F32D1.5,0,4371156,10.1068,2353,4373527,18,4371174,0,-18
V,-,4366297,0.00573066,0.0,349,347,2,2,3,gene,F32D1.11,0,4366276,0.693828,2868,4369165,21,4366276,21,0
V,-,4366288,0.0,0.25,2,2,0,0,194,gene,F32D1.11,0,4366276,0.693828,2877,4369165,12,4366276,12,0
V,-,4346237,0.00415701,0.0,12509,12457,52,50,5,gene,F32D1.2,1,4346234,32.9856,3350,4349587,3,4346237,0,-3
V,-,4345813,0.985646,0.0,209,3,206,133,2,gene,F32D1.1,2,4345810,0.483935,87,4345900,3,4345864,-51,-54
V,-,4341122,0.866959,0.0,684,91,593,429,50,gene,D2063.3,3,4341121,1.49261,122,4341244,1,4341122,0,-1
V,-,4268138,0.0,0.5,1,1,0,0,0,gene,F47D2.5,0,4268127,0,1160,4269298,11,4268127,11,0
V,-,4249963,0.0,0.015625,6,6,0,0,6,gene,ZC142.1,0,4249961,0.00777547,3351,4253314,2,4249961,2,0
V,-,4191329,0.00296296,0.0,675,673,2,0,1,gene,Y45G5AM.9,0,4191322,0.937403,49435,4240764,7,4191329,0,-7
V,-,4184889,0.0,2.38419e-07,22,22,0,0,0,gene,Y45G5AM.9,0,4184859,0.937403,4626,4189515,30,4184889,0,-30
V,-,4175452,0.0,1.12104e-44,146,146,0,0,3,gene,Y45G5AM.8,1,4175439,0.199607,5541,4180993,13,4175439,13,0
V,-,4169589,0.318182,0.0406609,22,15,7,3,313,gene,Y45G5AM.7,2,4169564,0.806626,145,4169734,25,4169649,-60,-85
V,-,4152108,0.00634921,0.0,315,313,2,1,0,gene,Y45G5AM.6,0,4152059,0.582555,14502,4166610,49,4152085,23,-26
V,-,4071082,0.0,0.00390625,8,8,0,0,2,gene,D1065.4,0,4071075,0.0124364,6790,4077872,7,4071355,-273,-280
V,-,4054936,0.0,0.0,227,227,0,0,1,gene,C49G7.11,0,4054922,0.366892,1006,4055942,14,4054922,14,0
V,-,4054931,0.0,4.48416e-44,144,144,0,0,0,gene,C49G7.11,0,4054922,0.366892,1011,4055942,9,4054922,9,0
V,-,3978945,0.000813386,0.0,8606,8599,7,3,9,gene,B0213.17,0,3978941,13.8947,13497,3992442,4,3978947,-2,-6
V,-,3968505,0.0,0.00390625,8,8,0,0,0,gene,B0213.15,0,3968457,0.525922,2018,3970523,48,3968457,48,0
V,-,3967629,0.0,1.90735e-06,19,19,0,0,18,gene,B0213.14,0,3967622,0.210975,320,3967949,7,3967684,-55,-62
V,-,3891824,0.00132275,0.0,2268,2265,3,3,0,gene,C17E7.12,1,3891819,1.40788,7235,3899059,5,3891839,-15,-20
V,-,3890674,0.954545,1.20254e-30,132,6,126,99,1,gene,C17E7.9,2,3890674,0.196579,107,3890781,0,3890674,0,0
V,-,3886017,0.0,3.8147e-06,18,18,0,0,0,gene,C17E7.8,0,3886013,0.0197735,1515,3887532,4,3886017,0,-4
V,-,3873029,0.0,3.05176e-05,15,15,0,0,1,gene,C17E7.6,0,3873001,0.0289968,2029,3875058,28,3873029,0,-28
V,-,3851612,0.0,6.10352e-05,14,14,0,0,0,gene,F47C10.2,0,3851609,0.0840769,485,3852097,3,3851612,0,-3
V,-,3850812,0.0,0.000976562,10,10,0,0,1,gene,F47C10.2,0,3850775,0.0840769,1285,3852097,37,3850812,0,-37
V,-,3820007,0.0,0.0625,4,4,0,0,2,gene,H10D18.5,0,3819988,0.389913,19038,3839045,19,3820028,-21,-40
V,-,3775950,0.0,0.0,180,180,0,0,2,gene,R08E5.2,0,3775947,0.817668,1174,3777124,3,3775947,3,0
V,-,3759283,0.00421941,0.0,474,472,2,2,1,gene,Y39H10A.7,0,3759277,0.846826,10339,3769622,6,3759283,0,-6
V,-,3756722,0.0909091,5.50747e-05,22,20,2,2,45,gene,Y39H10A.6,0,3756587,0.644174,48,3756770,135,3756758,-36,-171
V,-,3755611,0.333333,0.375,3,2,1,1,0,gene,Y39H10A.6,0,3755610,0.644174,1159,3756770,1,3755611,0,-1
V,-,3715784,0.00865052,0.0,578,573,5,4,0,gene,T27C4.1,0,3715778,2.64052,11287,3727071,6,3715784,0,-6
V,-,3659323,0.0,2.98023e-08,25,25,0,0,2,gene,F59B1.9,0,3659314,0.047953,5361,3664684,9,3659314,9,0
V,-,3647775,0.0,1.90735e-06,19,19,0,0,0,gene,F59B1.10,0,3647769,0.0117597,3698,3651473,6,3647769,6,0
V,-,3644058,0.00641026,1.4013e-45,156,155,1,1,0,gene,F59B1.8,0,3644052,0.173625,500,3644558,6,3644058,0,-6
V,-,3627383,0.0,0.25,2,2,0,0,0,gene,F59B1.4,0,3627326,0.00294547,1877,3629260,57,3626859,524,467
V,-,3614366,0.0,2.98023e-08,25,25,0,0,0,gene,T22F3.11,0,3614330,0.69149,3512,3617878,36,3614330,36,0
V,-,3605164,0.0,0.0078125,7,7,0,0,5,gene,T22F3.8,0,3605147,0.0147869,1456,3606620,17,3605240,-76,-93
V,-,3600472,0.0,0.015625,6,6,0,0,0,gene,T22F3.7,0,3600457,0.0260846,1393,3601865,15,3600407,65,50
V,-,3596775,0.0,0.5,1,1,0,0,1,gene,T22F3.6,0,3596671,0.00984868,791,3597566,104,3596967,-192,-296
V,-,3585889,0.00703849,0.0,11224,11145,79,77,2,gene,T22F3.4,0,3585883,24.1826,2942,3588831,6,3585889,0,-6
V,-,3505522,0.0,1.97215e-31,102,102,0,0,4,gene,C07G3.9,0,3505509,0.465172,27313,3532835,13,3505522,0,-13
V,-,3482448,0.0,0.0078125,7,7,0,0,1,gene,C02A12.4,0,3482425,5.33094,467,3482915,23,3482426,22,-1
V,-,3482426,0.00188893,0.0,7941,7926,15,10,13,gene,C02A12.4,0,3482425,5.33094,489,3482915,1,3482426,0,-1
V,-,3444703,0.00495049,0.0,202,201,1,1,0,gene,F27E11.3,0,3444701,0.784698,22579,3467282,2,3444703,0,-2
V,-,3431275,0.0,5.82077e-11,34,34,0,0,0,gene,T20D4.19,0,3431272,0.0268724,10058,3441333,3,3431272,3,0
V,-,3387989,0.0,9.53674e-07,20,20,0,0,0,gene,C04E12.11,0,3387982,0.0137658,1126,3389115,7,3387982,7,0
V,-,3357029,0.0,7.27596e-12,37,37,0,0,0,gene,C04E12.7,0,3357019,0.0431631,13737,3370766,10,3357019,10,0
V,-,3346310,0.2,0.0439453,10,8,2,2,0,gene,C17B7.11,0,3346296,0.173829,8183,3354493,14,3346310,0,-14
V,-,3319934,0.0,0.000244141,12,12,0,0,0,gene,F35F10.14,0,3319931,0.0104855,638,3320572,3,3319501,433,430
V,-,3318894,0.0526316,3.62396e-05,19,18,1,1,0,gene,F35F10.13,0,3318888,0.156818,405,3319299,6,3318888,6,0
V,-,3315067,0.0,5.29396e-23,74,74,0,0,0,gene,F35F10.12,0,3315060,0.222356,2929,3317996,7,3315067,0,-7
V,-,3311943,0.0,1.81899e-12,39,39,0,0,0,gene,F35F10.11,0,3311936,0.314138,1220,3313163,7,3311943,0,-7
V,-,3277971,0.0,0.000976562,10,10,0,0,1,gene,T28A11.21,0,3277957,0.390164,8214,3286185,14,3277957,14,0
V,-,3269335,0.0,1.16415e-10,33,33,0,0,0,gene,T28A11.19,0,3269332,0.0384849,1885,3271220,3,3269332,3,0
V,-,3259045,0.0,1.35525e-20,66,66,0,0,0,gene,T28A11.16,0,3259042,0.104115,4272,3263317,3,3259042,3,0
V,-,3255997,0.0,9.09495e-13,40,40,0,0,0,gene,T28A11.15,0,3255978,0.0154148,2213,3258210,19,3255978,19,0
V,-,3196689,0.00917431,1.67941e-31,109,108,1,1,8,gene,Y73C8B.1,1,3196667,0.230368,1682,3198371,22,3196696,-7,-29
V,-,3194829,0.0297619,2.8068e-42,168,163,5,2,6,gene,Y73C8B.2,2,3194828,0.351559,461,3195290,1,3194829,0,-1
V,-,3165345,0.0,0.03125,5,5,0,0,0,gene,C36C5.14,0,3165342,0.00220653,2448,3167793,3,3165342,3,0
V,-,3141117,0.0,0.5,1,1,0,0,0,gene,C36C5.6,0,3141117,0.00314474,1802,3142919,0,3141117,0,0
V,-,3113711,0.0,2.38419e-07,22,22,0,0,0,gene,Y73C8C.8,0,3113681,0.0636258,11680,3125391,30,3113681,30,0
V,-,3103682,0.0,0.5,1,1,0,0,0,gene,Y73C8C.5,0,3103666,0.00176268,2495,3106177,16,3104061,-379,-395
V,-,3094311,0.0,2.84217e-14,45,45,0,0,29,gene,C50H11.15,0,3094310,0.243531,672,3094983,1,3094328,-17,-18
V,-,3071476,0.0,0.00390625,8,8,0,0,0,gene,C50H11.13,1,3071475,0.00556279,8398,3079874,1,3071475,1,0
V,-,3039170,0.0,1.97215e-31,102,102,0,0,87,gene,F59D6.7,0,3039160,0.34591,20295,3059465,10,3039160,10,0
V,-,2922536,0.0,0.0078125,7,7,0,0,0,gene,C31B8.11,0,2922521,0.00202958,2469,2925005,15,2922521,15,0
V,-,2903152,0.0,1.32349e-23,76,76,0,0,0,gene,C31B8.7,0,2903137,0.103802,2442,2905594,15,2903137,15,0
V,-,2826656,0.0166667,5.20417e-17,60,59,1,1,1,gene,T03D3.5,0,2826647,0.175714,8580,2835236,9,2826653,3,-6
V,-,2807761,0.0,2.32831e-10,32,32,0,0,0,gene,F54E2.4,0,2807758,None,4595,2812356,3,2807687,74,71
V,-,2800818,0.0,0.03125,5,5,0,0,0,gene,F54E2.3,0,2800189,1.31958,11538,2812356,629,2800854,-36,-665
V,-,2742248,0.0,0.125,3,3,0,0,0,gene,C24B9.12,0,2742225,0.00444432,6558,2748806,23,2742225,23,0
V,-,2694195,0.00851064,0.0,235,233,2,2,1,gene,Y45G12B.3,0,2694187,0.45389,12601,2706796,8,2694195,0,-8
V,-,2664830,0.00456621,0.0,219,218,1,1,3,gene,W02G9.1,0,2664791,0.191402,23608,2688438,39,2664830,0,-39
V,-,2652484,0.0,7.62939e-06,17,17,0,0,91,gene,W02H5.8,0,2652470,0.30889,10305,2662789,14,2652484,0,-14
V,-,2620232,0.0,0.25,2,2,0,0,1,gene,W02H5.6,0,2620048,0.0113123,1645,2621877,184,2620541,-309,-493
V,-,2602890,0.00528402,0.0,757,753,4,4,2,gene,F53E10.6,0,2602887,1.26677,15428,2618318,3,2602890,0,-3
V,-,2598768,0.25,0.25,4,3,1,1,2,gene,F53E10.5,0,2598757,0.0114971,3211,2601979,11,2598757,11,0
V,-,2585736,0.00164204,0.0,609,608,1,1,0,gene,C29G2.6,0,2585722,0.602205,10024,2595760,14,2585736,0,-14
V,-,2487619,0.0105263,2.39814e-27,95,94,1,1,0,gene,C01B4.9,0,2487613,0,26487,2514106,6,2487613,6,0
V,-,2324980,0.00188206,0.0,9564,9546,18,15,14,gene,F15E11.15,0,2324980,5.67471,4227,2329207,0,2324980,0,0
V,-,2277999,0.0,0.00195312,9,9,0,0,16,gene,T27B7.1,0,2277975,0.112314,10163,2288162,24,2278074,-75,-99
V,-,2266886,0.0,0.000488281,11,11,0,0,0,gene,Y5H2A.2,0,2266875,0.0279283,4115,2271001,11,2266886,0,-11
V,-,2259638,0.0,0.00195312,9,9,0,0,18,gene,F41B5.9,0,2259626,0.227765,2679,2262317,12,2259626,12,0
V,-,2214304,0.0,1.90735e-06,19,19,0,0,1,gene,F44C8.9,0,2214288,0.104716,19336,2233640,16,2214288,16,0
V,-,2214296,0.0,2.11758e-22,72,72,0,0,4,gene,F44C8.9,0,2214288,0.104716,19344,2233640,8,2214288,8,0
V,-,2159253,0.0,2.40741e-35,115,115,0,0,0,gene,C45H4.14,0,2159240,0.285948,3055,2162308,13,2159246,7,-6
V,-,2139659,0.0,2.46519e-32,105,105,0,0,0,gene,F22F7.7,0,2139648,0.755123,5700,2145359,11,2139659,0,-11
V,-,2103038,0.0,3.05176e-05,15,15,0,0,17,gene,F36F12.1,0,2103035,0.0679434,446,2103484,3,2103046,-8,-11
V,-,2102922,0.0,0.5,1,1,0,0,6,gene,F36F12.1,0,2102914,0.0679434,562,2103484,8,2103046,-124,-132
V,-,2072726,0.0,6.01853e-36,117,117,0,0,1,gene,Y40B10A.9,0,2072706,0.264735,20364,2093090,20,2072723,3,-17
V,-,2066672,0.010101,1.56194e-28,99,98,1,1,47,gene,Y40B10A.8,0,2066672,0.597427,2299,2068971,0,2066672,0,0
V,-,2053431,0.0,1.52588e-05,16,16,0,0,0,gene,Y40B10A.7,0,2053428,0.0549157,7419,2060850,3,2053428,3,0
V,-,2045887,0.0,0.25,2,2,0,0,0,gene,Y40B10A.5,0,2045873,0.00549779,3162,2049049,14,2045934,-47,-61
V,-,1999409,0.0,0.0,433,433,0,0,0,gene,T08B1.3,0,1999406,0.349066,837,2000246,3,1999409,0,-3
V,-,1992746,0.0,0.0,341,341,0,0,10,gene,T08B1.2,0,1992714,1.24276,3182,1995928,32,1992714,32,0
V,-,1986861,0.0,0.0,168,168,0,0,38,gene,T08B1.1,0,1986831,1.05707,2441,1989302,30,1986857,4,-26
V,-,1917812,0.1,0.00976562,10,9,1,1,1,gene,Y32G9A.13,0,1917760,0.0261814,1336,1919148,52,1917760,52,0
V,-,1882068,0.00369231,0.0,1625,1619,6,6,0,gene,Y32G9A.8,0,1882018,1.67252,31360,1913428,50,1882068,0,-50
V,-,1868399,0.00240385,0.0,2080,2075,5,4,1,gene,T10B5.3,0,1868389,2.06414,1849,1870248,10,1868395,4,-6
V,-,1868392,0.0,4.76837e-07,21,21,0,0,233,gene,T10B5.3,0,1868389,2.06414,1856,1870248,3,1868395,-3,-6
V,-,1828694,0.0,0.5,1,1,0,0,0,gene,Y32G9B.1,0,1828684,0.29683,19199,1847893,10,1828694,0,-10
V,-,1821151,0.00890208,0.0,337,334,3,3,0,gene,Y46H3A.6,0,1821118,1.5683,1827,1822978,33,1821151,0,-33
V,-,1813215,0.5,0.5,2,1,1,1,1,gene,Y46H3A.4,0,1813210,0.171446,2470,1815685,5,1813215,0,-5
V,-,1804724,0.0,0.00390625,8,8,0,0,168,gene,Y46H3A.3,0,1804698,2.9781,4660,1809384,26,1804799,-75,-101
V,-,1781848,0.00689655,3.25101e-42,145,144,1,1,0,gene,F36H9.5,0,1781846,0.256914,17703,1799551,2,1781846,2,0
V,-,1774747,0.00649351,7.00649e-45,154,153,1,1,0,gene,F36H9.7,0,1774747,0.279505,3404,1778151,0,1774747,0,0
V,-,1771867,0.0,0.03125,5,5,0,0,4,gene,F36H9.3,0,1771755,2.36583,1756,1773623,112,1771556,311,199
V,-,1771563,0.00299401,0.0,1002,999,3,3,30,gene,F36H9.3,0,1771556,2.36583,2060,1773623,7,1771556,7,0
V,-,1740996,0.0,0.125,3,3,0,0,0,gene,ZK697.7,0,1740986,0.00451563,7263,1748259,10,1740986,10,0
V,-,1731391,0.0147059,2.30393e-19,68,67,1,0,1,gene,ZK697.6,0,1731371,0.0897867,7363,1738754,20,1731391,0,-20
V,-,1629261,0.0,9.53674e-07,20,20,0,0,43,gene,Y46H3D.7,0,1629256,0.105299,28797,1658058,5,1629261,0,-5
V,-,1626647,0.0,7.27596e-12,37,37,0,0,0,gene,Y46H3D.6,0,1626647,0.0614303,1287,1627934,0,1626647,0,0
V,-,1624267,0.0,0.0625,4,4,0,0,0,gene,Y46H3D.5,0,1624262,0.140177,759,1625026,5,1624262,5,0
V,-,1623899,0.0,2.93874e-39,128,128,0,0,1,gene,Y46H3D.5,0,1623866,0.140177,1127,1625026,33,1623899,0,-33
V,-,1621349,0.0188679,6.85939e-29,106,104,2,1,41,gene,F16B4.12,0,1621346,0.129277,1055,1622404,3,1621349,0,-3
V,-,1617997,1.0,0.5,1,0,1,0,2,gene,F16B4.11,0,1617865,0.0435566,1025,1619022,132,1617771,226,94
V,-,1607666,0.0,0.125,3,3,0,0,2,gene,F16B4.9,0,1607644,0.0357888,4964,1612630,22,1607675,-9,-31
V,-,1534252,0.0,0.5,1,1,0,0,0,gene,K02H11.6,0,1534244,0.00189221,799,1535051,8,1534244,8,0
V,-,1511464,0.0,3.8147e-06,18,18,0,0,0,gene,C38C3.9,0,1511459,0.0139065,8826,1520290,5,1511459,5,0
V,-,1485487,0.0,7.62939e-06,17,17,0,0,1,gene,C38C3.6,0,1485487,0.0511985,15732,1501219,0,1485487,0,0
V,-,1431966,0.0,0.0,604,604,0,0,0,gene,R12A1.4,0,1431966,0.453233,11842,1443808,0,1431966,0,0
V,-,1411445,0.0,4.65661e-10,31,31,0,0,0,gene,R12A1.2,0,1411388,0.187362,11175,1422620,57,1411445,0,-57
V,-,1383083,0.00642398,0.0,467,464,3,3,1,gene,Y75B7AL.4,0,1383068,1.3492,7909,1390992,15,1383068,15,0
V,-,1361140,0.0,1.50463e-36,119,119,0,0,0,gene,Y75B7AL.3,0,1361139,0.327882,11361,1372501,1,1361147,-7,-8
V,-,1357986,0.0,2.32831e-10,32,32,0,0,0,gene,Y75B7AL.2,0,1357980,0.0512875,30,1358016,6,1357993,-7,-13
V,-,1317746,0.0,0.0,235,235,0,0,0,gene,F16B3.3,0,1317734,0.359867,14366,1332112,12,1317726,20,8
V,-,1299161,0.0,8.88178e-16,50,50,0,0,0,gene,F16B3.1,0,1299140,0.140718,16314,1315475,21,1299161,0,-21
V,-,1285529,0.0181818,4.61838e-30,110,108,2,1,0,gene,ZK1005.1,0,1285513,0.545841,3671,1289200,16,1285529,0,-16
V,-,1263819,0.00285307,0.0,1402,1398,4,3,2,gene,C39F7.4,0,1263786,11.0375,10199,1274018,33,1263819,0,-33
V,-,1235275,0.00649351,7.00649e-45,154,153,1,1,2,gene,C39F7.2,0,1235264,0.66628,27175,1262450,11,1235275,0,-11
V,-,1195947,0.0120482,8.582e-24,83,82,1,1,33,gene,Y50D4A.4,0,1195923,0.305591,1702,1197649,24,1195927,20,-4
V,-,1161392,0.0,0.25,2,2,0,0,0,gene,T21H3.5,0,1161383,0.00685447,21735,1183127,9,1161392,0,-9
V,-,1055606,0.0,0.25,2,2,0,0,0,gene,K10C9.9,0,1055603,0.0120795,736,1056342,3,1055603,3,0
V,-,1048410,0.00536193,0.0,373,371,2,2,0,gene,C02E11.1,0,1048407,2.31976,1544,1049954,3,1048407,3,0
V,-,1026901,0.00383142,0.0,261,260,1,1,1,gene,R09A1.3,0,1026895,0.116398,823,1027724,6,1026895,6,0
V,-,1003572,0.00128866,0.0,776,775,1,1,0,gene,Y50D4C.5,0,1003563,0.408939,14658,1018230,9,1003422,150,141
V,-,964619,0.0,0.0,196,196,0,0,103,gene,Y50D4C.4,1,964607,0.246144,32953,997572,12,964630,-11,-23
V,-,949688,0.818182,3.38499e-12,110,20,90,67,1,gene,Y50D4C.6,2,949679,0.393169,1708,951396,9,949679,9,0
V,-,945074,0.927536,1.41875e-27,138,10,128,95,1,gene,Y50D4C.3,3,945074,0.386382,1484,946558,0,945074,0,0
V,-,870959,0.0,0.0,541,541,0,0,0,gene,T02B11.4,0,870956,0.903369,6398,877357,3,870959,0,-3
V,-,866659,0.00131341,0.0,6091,6083,8,7,3,gene,T02B11.3,0,866656,5.36274,2651,869310,3,866659,0,-3
V,-,761806,0.0,0.0625,4,4,0,0,1,gene,C05E4.12,0,761783,0.0150347,40574,802380,23,761783,23,0
V,-,719665,0.0,0.25,2,2,0,0,0,gene,H24O09.1,0,719661,0.00631589,2802,722467,4,719661,4,0
V,-,699171,0.0,0.125,3,3,0,0,13,gene,Y49C4A.8,0,698970,0.268265,11299,710470,201,698986,185,-16
V,-,698986,0.0,1.77636e-15,49,49,0,0,170,gene,Y49C4A.8,0,698970,0.268265,11484,710470,16,698986,0,-16
V,-,695927,1.0,0.5,1,0,1,1,0,gene,Y49C4A.7,0,695844,None,426,696353,83,695835,92,9
V,-,667339,0.0135135,3.91753e-21,74,73,1,1,10,gene,F31F4.12,0,667324,0.158099,385,667724,15,667324,15,0
V,-,628450,0.0,0.0625,4,4,0,0,0,gene,F48G7.9,0,628445,0.00505211,5477,633927,5,628445,5,0
V,-,483168,0.00327869,0.0,305,304,1,1,2,gene,T01G6.8,0,483158,0.216191,16943,500111,10,483168,0,-10
V,-,417961,0.0,0.5,1,1,0,0,1,gene,ZK6.11,0,417919,5.31551,19442,437403,42,417535,426,384
V,-,417931,0.0,0.5,1,1,0,0,5,gene,ZK6.11,0,417919,5.31551,19472,437403,12,417535,396,384
V,-,417449,0.0,0.125,3,3,0,0,241,gene,ZK6.11,0,417405,5.31551,19954,437403,44,417495,-46,-90
V,-,336279,0.0,3.8147e-06,18,18,0,0,0,gene,T22H9.4,0,336267,0.0369392,37956,374235,12,336690,-411,-423
V,-,330554,0.0,2.22045e-16,52,52,0,0,0,gene,Y39D8C.1,0,330553,0.321234,3881,334435,1,330553,1,0
V,-,311364,0.0147783,0.0,203,200,3,3,8,gene,F33E11.6,1,311364,0.759782,12239,323603,0,311364,0,0
V,-,311318,0.0,0.5,1,1,0,0,89,gene,F33E11.6,1,311231,0.759782,12285,323603,87,311364,-46,-133
V,-,304542,0.900312,0.0,321,32,289,229,0,gene,F33E11.3,2,304525,0.663672,726,305268,17,304542,0,-17
V,-,281545,0.0,0.0,171,171,0,0,0,gene,Y58G8A.4,0,281537,0.304733,18323,299868,8,281545,0,-8
V,-,272766,0.00763359,4.81218e-38,131,130,1,1,0,gene,Y58G8A.5,0,272765,0.503475,4052,276818,1,272765,1,0
V,-,257814,0.0,3.76158e-37,121,121,0,0,1,gene,R02C2.4,0,257809,0.134182,13937,271751,5,257809,5,0
V,-,251518,0.0,0.125,3,3,0,0,85,gene,R02C2.3,0,251479,1.815,673,252191,39,251575,-57,-96
V,-,245678,0.0,7.17465e-43,140,140,0,0,1,gene,R02C2.2,0,245675,0.137679,750,246428,3,245675,3,0
V,-,238021,0.0144928,1.16891e-19,69,68,1,1,0,gene,R02C2.1,0,238017,0.124397,733,238754,4,238021,0,-4
V,-,234501,0.0,1.42109e-14,46,46,0,0,0,gene,DC2.7,0,234497,0.106625,2017,236518,4,234501,0,-4
V,-,172039,0.0416667,1.43051e-06,24,23,1,1,0,gene,Y108G3AL.3,0,172032,0.114291,2314,174353,7,172039,0,-7
V,-,151216,0.0,0.0,236,236,0,0,4,gene,W03F9.4,0,151210,0.62132,12446,163662,6,151452,-236,-242
V,-,133389,0.0,0.0625,4,4,0,0,0,gene,W03F9.3,0,133104,0.0332957,3537,136926,285,132826,563,278
V,-,133149,0.0,0.03125,5,5,0,0,0,gene,W03F9.3,0,133104,0.0332957,3777,136926,45,132826,323,278
V,-,127785,0.00298507,0.0,335,334,1,0,57,gene,W03F9.2,0,127779,0.276683,4497,132282,6,127810,-25,-31
V,-,126523,0.0,5.16988e-26,84,84,0,0,470,gene,W03F9.1,1,126477,0.879408,311,126834,46,126579,-56,-102
V,-,126481,0.0,0.0625,4,4,0,0,106,gene,W03F9.1,1,126477,0.879408,353,126834,4,126579,-98,-102
V,-,122617,0.38981,2.98523e-11,844,515,329,259,0,gene,Y38C9A.2,2,122580,1.79113,1180,123797,37,122617,0,-37
V,-,103892,0.00329231,0.0,74112,73868,244,222,525,gene,F56E10.4,0,103864,169.401,14135,118027,28,103892,0,-28
V,-,7650,0.00744879,0.0,1074,1066,8,8,0,gene,B0348.6,0,7646,4.6417,47668,55318,4,7650,0,-4
X,-,17682205,0.0,0.0,615,615,0,0,2,gene,T23E7.6,0,17682205,2.43892,1071,17683276,0,17682205,0,0
X,-,17627886,0.00625,0.0,320,318,2,2,0,gene,H18N23.2,0,17627879,1.21662,52730,17680616,7,17627886,0,-7
X,-,17609959,0.0,0.0,174,174,0,0,0,gene,C16H3.3,0,17609955,0.550441,12666,17622625,4,17609959,0,-4
X,-,17571853,0.0,0.0625,4,4,0,0,3,gene,F39B3.2,0,17571831,0.113955,6751,17578604,22,17571834,19,-3
X,-,17561389,0.0119048,4.3427e-24,84,83,1,1,0,gene,F31A3.5,0,17561338,0.274063,5173,17566562,51,17561376,13,-38
X,-,17533976,0.037037,2.01166e-07,27,26,1,0,0,gene,F31A3.3,0,17533976,0.158685,13751,17547727,0,17533976,0,0
X,-,17486741,0.0,2.91038e-11,35,35,0,0,0,gene,R106.2,0,17486733,0.115415,14548,17501289,8,17486731,10,2
X,-,17474447,0.0046729,0.0,428,426,2,2,54,gene,ZK54.2,0,17474441,0.741364,8546,17482993,6,17474447,0,-6
X,-,17473629,0.0,0.03125,5,5,0,0,0,gene,ZK54.2,0,17473611,0.741364,9364,17482993,18,17473629,0,-18
X,-,17456499,0.0059657,0.0,10728,10664,64,51,4,gene,C36E6.5,0,17456480,30.4864,4192,17460691,19,17456499,0,-19
X,-,17421734,0.0,0.25,2,2,0,0,7,gene,F11C7.5,0,17421567,15.7012,33956,17455690,167,17421496,238,71
X,-,17413926,0.0,4.23516e-22,71,71,0,0,14,gene,F11C7.4,0,17413777,0.300575,6196,17420122,149,17413763,163,14
X,-,17391529,0.0,0.0,162,162,0,0,0,gene,F10D7.5,0,17391475,0.791587,2327,17393856,54,17391527,2,-52
X,-,17391522,0.0,0.125,3,3,0,0,103,gene,F10D7.5,0,17391475,0.791587,2334,17393856,47,17391527,-5,-52
X,-,17381743,0.75,0.25,4,1,3,3,0,gene,F10D7.4,0,17381732,0.0579123,1295,17383038,11,17381732,11,0
X,-,17374545,0.00740741,3.09945e-39,135,134,1,1,2,gene,F10D7.3,0,17374514,0.707411,3931,17378476,31,17374790,-245,-276
X,-,17368555,0.0,1.0842e-19,63,63,0,0,3,gene,F10D7.2,0,17368552,0.373892,2749,17371304,3,17368555,0,-3
X,-,17256696,0.0,4.65661e-10,31,31,0,0,0,gene,Y40C7B.4,0,17256693,0.0372152,1552,17258248,3,17256693,3,0
X,-,17235751,0.0145985,5.34712e-38,137,135,2,1,18,gene,T25G12.7,0,17235750,1.10442,1064,17236815,1,17235750,1,0
X,-,17217019,0.0,0.0,915,915,0,0,3,gene,T25G12.5,1,17217016,3.74659,8091,17225110,3,17217019,0,-3
X,-,17214838,0.5,0.5,2,1,1,1,1,gene,T08G2.3,2,17214810,4.3277,94,17214932,28,17214817,21,-7
X,-,17214817,0.864827,0.0,1413,191,1222,739,5,gene,T08G2.3,2,17214810,4.3277,115,17214932,7,17214817,0,-7
X,-,17209279,0.0,9.53674e-07,20,20,0,0,1,gene,T08G2.2,0,17209279,0.0706603,3779,17213058,0,17209279,0,0
X,-,17195058,0.047619,1.00136e-05,21,20,1,0,2,gene,B0302.5,0,17195032,1.46169,10276,17205334,26,17195032,26,0
X,-,17195051,0.0,0.0,245,245,0,0,23,gene,B0302.5,0,17195032,1.46169,10283,17205334,19,17195032,19,0
X,-,17157876,0.0,0.00390625,8,8,0,0,2,gene,T23C6.5,0,17157871,0.0814384,18522,17176398,5,17157871,5,0
X,-,17149839,0.00273224,0.0,366,365,1,1,0,gene,T23C6.4,0,17149831,0.45103,5171,17155010,8,17149831,8,0
X,-,17138024,0.0,6.46235e-27,87,87,0,0,1,gene,T23C6.3,0,17138021,0.57034,9426,17147450,3,17138024,0,-3
X,-,17134439,0.0,0.125,3,3,0,0,0,gene,K09E3.7,0,17134406,0.0621965,1474,17135913,33,17134441,-2,-35
X,-,17115103,0.0,3.05176e-05,15,15,0,0,2,gene,K09E3.6,0,17115091,0.0471761,16159,17131262,12,17115091,12,0
X,-,17110567,0.0,3.55271e-15,48,48,0,0,0,gene,K09E3.5,0,17110539,0.0638769,2399,17112966,28,17110539,28,0
X,-,17107684,0.125,0.03125,8,7,1,1,1,gene,C08A9.9,0,17107655,0.011444,1481,17109165,29,17107684,0,-29
X,-,17104803,0.0,3.05176e-05,15,15,0,0,2,gene,C08A9.8,0,17104785,0.00523868,1711,17106514,18,17104785,18,0
X,-,17100668,0.0,1.79366e-43,142,142,0,0,1,gene,C08A9.7,0,17100654,0.0943615,2089,17102757,14,17100666,2,-12
X,-,17096470,0.0,0.0,169,169,0,0,1,gene,C08A9.6,0,17096451,0.177649,2496,17098966,19,17096451,19,0
X,-,17072100,0.0,9.31323e-10,30,30,0,0,0,gene,C30G4.5,0,17072096,0.0752499,3753,17075853,4,17072102,-2,-6
X,-,17066762,0.0,0.0,198,198,0,0,1,gene,C30G4.4,0,17066628,0.348827,9091,17075853,134,17066762,0,-134
X,-,17058284,0.0,0.25,2,2,0,0,79,gene,C30G4.7,0,17058273,0.888011,17569,17075853,11,17058450,-166,-177
X,-,17058160,0.0,0.00012207,13,13,0,0,76,gene,C30G4.7,0,17058134,0.888011,17693,17075853,26,17058450,-290,-316
X,-,17030134,0.0229885,2.41756e-23,87,85,2,1,0,gene,F35B3.5,0,17030115,0.663527,4974,17035108,19,17030134,0,-19
X,-,16976051,0.0,1.45519e-11,36,36,0,0,0,gene,F52G3.5,0,16976045,0.0986227,43477,17019528,6,16976045,6,0
X,-,16952452,0.0,4.23516e-22,71,71,0,0,8,gene,F52G3.4,0,16952446,0.00116884,20689,16973141,6,16952028,424,418
X,-,16903065,0.0,0.125,3,3,0,0,4,gene,F39F10.4,0,16903063,0.121443,2496,16905561,2,16903065,0,-2
X,-,16868946,0.0,0.0,763,763,0,0,0,gene,T20F7.6,0,16868931,0.655761,9048,16877994,15,16868946,0,-15
X,-,16836317,0.0,0.5,1,1,0,0,0,gene,F41G4.7,0,16836303,0.00371705,6953,16843270,14,16836319,-2,-16
X,-,16819183,0.0,1.73472e-18,59,59,0,0,1,gene,F41G4.3,0,16819182,0.248431,4760,16823943,1,16819183,0,-1
X,-,16813571,0.0010929,0.0,915,914,1,0,2,gene,F41G4.2,0,16813568,2.0099,2608,16816179,3,16813568,3,0
X,-,16807030,0.0,2.32831e-10,32,32,0,0,4,gene,T01C8.7,0,16807029,0.0517843,346,16807376,1,16807030,0,-1
X,-,16793041,0.00272851,0.0,2199,2193,6,5,1,gene,T01C8.5,0,16793027,2.73062,10242,16803283,14,16793041,0,-14
X,-,16770413,0.00253165,0.0,395,394,1,1,0,gene,C10E2.6,0,16770410,2.10652,9661,16780074,3,16770413,0,-3
X,-,16753443,0.0,0.000244141,12,12,0,0,1,gene,C10E2.5,0,16753395,0.0172736,13678,16767121,48,16753588,-145,-193
X,-,16677638,0.00262927,0.0,10269,10242,27,20,586,gene,F22H10.3,0,16677622,23.5193,6580,16684218,16,16677640,-2,-18
X,-,16674806,0.0,0.25,2,2,0,0,1,gene,F43B10.2,0,16674783,0.578213,2486,16677292,23,16674647,159,136
X,-,16674678,0.0,8.88178e-16,50,50,0,0,6,gene,F43B10.2,0,16674647,0.578213,2614,16677292,31,16674647,31,0
X,-,16654420,0.0,1.13687e-13,43,43,0,0,2,gene,C06G1.6,0,16654398,None,6536,16660956,22,16654398,22,0
X,-,16643473,0.0,5.68434e-14,44,44,0,0,0,gene,C06G1.5,0,16643417,0.546453,8547,16652020,56,16642976,497,441
X,-,16609439,0.0031746,0.0,315,314,1,1,0,gene,F59C12.3,0,16609434,0.738574,28673,16638112,5,16609439,0,-5
X,-,16553802,0.0,1.38778e-17,56,56,0,0,0,gene,K08B5.2,0,16553791,0.246994,48586,16602388,11,16553791,11,0
X,-,16413222,0.0,0.0,234,234,0,0,0,gene,T24D11.1,0,16413155,0.447027,42186,16455408,67,16413222,0,-67
X,-,16403106,0.0,2.24208e-44,145,145,0,0,3,gene,F01G12.6,0,16403104,1.15632,3015,16406121,2,16403104,2,0
X,-,16389407,0.0,1.52588e-05,16,16,0,0,1,gene,F01G12.5,0,16389243,5.24039,7659,16397066,164,16389407,0,-164
X,-,16317645,0.00626959,0.0,319,317,2,1,0,gene,T01B4.3,0,16317645,0.44982,62868,16380513,0,16317647,-2,-2
X,-,16286697,0.0,0.0,488,488,0,0,2,gene,F52E10.4,0,16286673,0.624252,28141,16314838,24,16286673,24,0
X,-,16269977,0.0,6.16298e-33,107,107,0,0,0,gene,F52E10.5,0,16269966,0.58476,12742,16282719,11,16269971,6,-5
X,-,16265601,0.000887311,0.0,1127,1126,1,1,1,gene,W10G6.3,0,16265596,1.67984,1511,16267112,5,16265601,0,-5
X,-,16260043,0.00854701,7.04168e-34,117,116,1,1,0,gene,W10G6.2,0,16260035,0.520654,2167,16262210,8,16260043,0,-8
X,-,16240617,0.0,5.82077e-11,34,34,0,0,0,gene,F23A7.6,0,16240611,None,7043,16247660,6,16240611,6,0
X,-,16210565,0.00130208,0.0,768,767,1,1,7,gene,R11.4,0,16210534,1.07704,26541,16237106,31,16210566,-1,-32
X,-,16146939,0.0,0.0,150,150,0,0,0,gene,F09C8.2,0,16146854,1.28848,12624,16159563,85,16146939,0,-85
X,-,16128732,0.00181159,0.0,1104,1102,2,1,4,gene,ZK1073.1,0,16128730,2.23507,11689,16140421,2,16128732,0,-2
X,-,16079697,0.0,0.25,2,2,0,0,1,gene,C30F2.2,0,16079675,0.101572,44163,16123860,22,16079697,0,-22
X,-,16075618,0.004914,0.0,407,405,2,2,1,gene,C30F2.4,0,16075584,1.23545,1073,16076691,34,16075584,34,0
X,-,16058855,0.0333333,2.79397e-08,30,29,1,1,0,gene,T27A8.2,0,16058850,0.119562,5221,16064076,5,16058855,0,-5
X,-,16039449,0.0,0.015625,6,6,0,0,27,gene,B0395.3,0,16039404,1.37639,18191,16057640,45,16039430,19,-26
X,-,16039424,0.0,9.31323e-10,30,30,0,0,54,gene,B0395.3,0,16039404,1.37639,18216,16057640,20,16039430,-6,-26
X,-,16039147,0.0,0.0,161,161,0,0,13,gene,B0395.3,0,16039141,1.37639,18493,16057640,6,16039147,0,-6
X,-,15996852,0.0,1.73472e-18,59,59,0,0,0,gene,C09G1.4,0,15996838,0.22308,16670,16013522,14,15996853,-1,-15
X,-,15939240,0.0,1.65436e-24,79,79,0,0,0,gene,E03G2.2,0,15939240,0.196012,26787,15966027,0,15939242,-2,-2
X,-,15887510,0.00662252,5.32493e-44,151,150,1,1,0,gene,F53H4.3,0,15887505,0.477487,28105,15915615,5,15887564,-54,-59
X,-,15865837,0.0196078,2.26485e-14,51,50,1,1,0,gene,F53H4.1,0,15865831,0.17773,19689,15885526,6,15865831,6,0
X,-,15860525,0.1875,0.000210989,32,26,6,4,0,gene,F53H4.6,0,15860520,0.0559007,688,15861213,5,15860527,-2,-7
X,-,15847512,0.0263158,3.77194e-20,76,74,2,1,1,gene,F59F4.3,0,15847503,0.318149,4987,15852499,9,15847508,4,-5
X,-,15838465,0.0,0.0,276,276,0,0,0,gene,F59F4.1,0,15838444,0.525278,3880,15842345,21,15838465,0,-21
X,-,15799619,0.0,6.61744e-24,77,77,0,0,0,gene,Y7A5A.6,0,15799615,0.123628,1591,15801210,4,15799615,4,0
X,-,15794992,0.0,0.125,3,3,0,0,2,gene,Y7A5A.10,0,15794970,0.0153288,2170,15797162,22,15794856,136,114
X,-,15772655,0.0,3.08149e-33,108,108,0,0,3,gene,Y7A5A.2,1,15772649,0.0820164,4363,15777018,6,15772655,0,-6
X,-,15771413,0.0294118,0.0,340,330,10,7,6,gene,Y7A5A.1,2,15771411,1.35805,214,15771627,2,15771413,0,-2
X,-,15757189,0.0,0.0,354,354,0,0,2,gene,ZK678.5,0,15757184,0.67657,539,15757728,5,15757189,0,-5
X,-,15675642,0.0,4.59177e-41,134,134,0,0,1,gene,F59D12.2,0,15675579,0.226485,61120,15736762,63,15675642,0,-63
X,-,15651272,0.0,0.5,1,1,0,0,1,gene,F59D12.3,0,15651265,0.0146021,21018,15672290,7,15650825,447,440
X,-,15647289,0.00682594,0.0,293,291,2,2,50,gene,F59D12.5,0,15647277,0.347392,892,15648181,12,15647277,12,0
X,-,15630360,0.00263158,0.0,380,379,1,0,0,gene,K09E9.4,0,15630336,0.592987,15940,15646300,24,15630336,24,0
X,-,15616439,0.00234192,0.0,427,426,1,1,34,gene,K09E9.2,1,15616434,0.799655,11647,15628086,5,15616439,0,-5
X,-,15613711,0.00512821,0.0,195,194,1,1,1,gene,K09E9.3,2,15613680,0.478811,1,15613712,31,15613711,0,-31
X,-,15606555,0.0,0.0,163,163,0,0,0,gene,K09A9.2,0,15606536,1.7005,5189,15611744,19,15606555,0,-19
X,-,15590317,0.00175516,0.0,2279,2275,4,3,0,gene,K09A9.5,0,15590311,4.51632,5784,15596101,6,15590317,0,-6
X,-,15546968,0.0,0.0078125,7,7,0,0,4,gene,C02C6.3,0,15546923,1.18216,39771,15586739,45,15546968,0,-45
X,-,15507800,0.0059952,0.0,834,829,5,4,4,gene,H13N06.5,0,15507784,3.2946,38834,15546634,16,15507800,0,-16
X,-,15504288,0.0,0.0,437,437,0,0,3,gene,H13N06.6,0,15504209,0.830096,1647,15505935,79,15504288,0,-79
X,-,15503307,0.0,0.0625,4,4,0,0,0,gene,H13N06.6,0,15503303,0.830096,2628,15505935,4,15503307,0,-4
X,-,15477323,0.0,7.62939e-06,17,17,0,0,0,gene,C46E1.3,0,15477322,0.0260077,22853,15500176,1,15477322,1,0
X,-,15428175,0.0,1.52588e-05,16,16,0,0,0,gene,F39D8.4,0,15428009,0.0636853,1669,15429844,166,15428009,166,0
X,-,15377736,0.0652174,2.15721e-10,46,43,3,0,0,gene,C33A11.4,0,15377726,0.467397,31326,15409062,10,15377604,132,122
X,-,15317159,0.0,1.52588e-05,16,16,0,0,0,gene,Y15E3A.2,0,15317137,0.0473126,5007,15322166,22,15317137,22,0
X,-,15273647,0.0,3.00927e-36,118,118,0,0,7,gene,F46F2.2,0,15273611,1.70169,6458,15280105,36,15273647,0,-36
X,-,15246311,0.0,4.33681e-19,61,61,0,0,5,gene,F39B1.1,0,15246284,0.371926,13187,15259498,27,15246284,27,0
X,-,15230547,0.0,1.11022e-16,53,53,0,0,2,gene,H03A11.2,0,15230540,0.220442,4201,15234748,7,15230540,7,0
X,-,15213178,0.00456621,0.0,219,218,1,1,0,gene,H03A11.1,0,15213151,0.69063,12676,15225854,27,15213178,0,-27
X,-,15199059,0.0,2.98023e-08,25,25,0,0,0,gene,T10B10.5,0,15199055,0.0720873,10149,15209208,4,15199055,4,0
X,-,15181383,0.0,0.0,154,154,0,0,7,gene,T10B10.3,0,15181373,0.729943,11648,15193031,10,15181383,0,-10
X,-,15166140,0.0,5.68434e-14,44,44,0,0,4,gene,T10B10.8,0,15166135,0.287243,8810,15174950,5,15166135,5,0
X,-,15147658,0.0,6.10352e-05,14,14,0,0,0,gene,R07D5.1,0,15147563,0.359061,9622,15157280,95,15147658,0,-95
X,-,15142322,0.0,4.44089e-16,51,51,0,0,1,gene,C11G10.2,0,15142288,0.0808281,14958,15157280,34,15142322,0,-34
X,-,15116534,0.0,0.015625,6,6,0,0,1,gene,R07D5.2,0,15116528,0.0582008,4246,15120780,6,15116536,-2,-8
X,-,15107703,0.0,5.68434e-14,44,44,0,0,150,gene,F09B12.1,0,15107659,1.14095,2070,15109773,44,15107659,44,0
X,-,15107687,0.0,0.0,376,376,0,0,324,gene,F09B12.1,0,15107659,1.14095,2086,15109773,28,15107659,28,0
X,-,15100335,0.0277778,6.29104e-28,108,105,3,2,1,gene,F09B12.2,0,15100323,0.633942,1367,15101702,12,15100323,12,0
X,-,15084004,0.0,0.125,3,3,0,0,0,gene,H40L08.1,0,15084000,0.712668,9477,15093481,4,15084004,0,-4
X,-,15056746,0.0,2.38419e-07,22,22,0,0,0,gene,H03G16.5,0,15056740,0.0531479,1679,15058425,6,15056740,6,0
X,-,15040520,0.0,2.06795e-25,82,82,0,0,10,gene,C18B12.4,0,15040515,1.76008,2354,15042874,5,15040520,0,-5
X,-,15007226,0.0,0.0625,4,4,0,0,2,gene,C18B12.6,1,15007171,0.334354,23874,15031100,55,15007226,0,-55
X,-,15003859,0.675141,1.04878e-11,354,115,239,137,10,gene,F20D1.9,2,15003841,1.30505,191,15004050,18,15003750,109,91
X,-,14999118,0.0,0.00012207,13,13,0,0,0,gene,F20D1.8,0,14999027,0.16381,2835,15001953,91,14999045,73,-18
X,-,14991298,0.0,7.45058e-09,27,27,0,0,0,gene,F20D1.7,0,14991291,0.0878129,3372,14994670,7,14991298,0,-7
X,-,14970189,0.0105079,0.0,571,565,6,4,1,gene,F20D1.1,0,14970170,2.86751,10632,14980821,19,14970189,0,-19
X,-,14954564,0.0,0.015625,6,6,0,0,0,gene,F45B8.4,0,14954439,0.140178,5895,14960459,125,14954439,125,0
X,-,14946235,0.00259291,0.0,1157,1154,3,3,0,gene,F14F4.3,0,14946235,1.28524,4432,14950667,0,14946235,0,0
X,-,14928861,0.0,0.00195312,9,9,0,0,0,gene,F14F4.1,0,14928852,0.0247639,9552,14938413,9,14928852,9,0
X,-,14928853,0.0,0.00012207,13,13,0,0,13,gene,F14F4.1,0,14928852,0.0247639,9560,14938413,1,14928852,1,0
X,-,14905162,0.0,7.45058e-09,27,27,0,0,2,gene,Y70D2A.2,0,14905147,0.168013,19772,14924934,15,14905180,-18,-33
X,-,14872786,0.0,2.91038e-11,35,35,0,0,0,gene,F31F6.3,0,14872780,0.0451327,29022,14901808,6,14872780,6,0
X,-,14868225,0.0,2.32831e-10,32,32,0,0,0,gene,F31F6.1,0,14868219,0.112768,712,14868937,6,14868219,6,0
X,-,14853681,0.0135135,0.0,222,219,3,3,0,gene,C27C12.1,0,14853673,0.275281,3534,14857215,8,14853673,8,0
X,-,14824459,0.00451467,0.0,443,441,2,2,1,gene,T04C10.1,0,14824453,1.07339,1501,14825960,6,14824459,0,-6
X,-,14818426,0.0105634,0.0,852,843,9,8,0,gene,T04C10.2,0,14818413,4.06335,1401,14819827,13,14818426,0,-13
X,-,14760833,0.0,0.00390625,8,8,0,0,13,gene,C05G5.5,0,14760803,0.110947,1016,14761849,30,14760882,-49,-79
X,-,14751930,0.00564972,0.0,177,176,1,0,3,gene,C05G5.3,0,14751921,0.249708,4048,14755978,9,14751930,0,-9
X,-,14744215,0.08,8.9407e-06,25,23,2,2,1,gene,C05G5.7,0,14744129,None,6553,14750768,86,14743699,516,430
X,-,14743749,0.016791,0.0,536,527,9,4,34,gene,C05G5.7,0,14743717,None,130,14743879,32,14743699,50,18
X,-,14739855,0.0,0.0078125,7,7,0,0,0,gene,C05G5.1,0,14739779,0.25332,3655,14743510,76,14739855,0,-76
X,-,14737397,0.0,7.10543e-15,47,47,0,0,1,gene,C05G5.1,0,14737294,0.25332,6113,14743510,103,14737397,0,-103
X,-,14706776,0.00161117,0.0,1862,1859,3,1,1,gene,F40E10.6,0,14706774,3.87765,19768,14726544,2,14706776,0,-2
X,-,14692919,0.0,2.84217e-14,45,45,0,0,1,gene,F40E10.2,0,14692915,0.319498,3417,14696336,4,14692915,4,0
X,-,14636385,0.0,2.38419e-07,22,22,0,0,1,gene,F54E4.3,0,14636327,0.670732,4907,14641292,58,14636327,58,0
X,-,14636341,0.00293255,0.0,341,340,1,1,5,gene,F54E4.3,0,14636327,0.670732,4951,14641292,14,14636327,14,0
X,-,14599073,0.0,3.8147e-06,18,18,0,0,1,gene,C44H4.6,0,14599072,0.0562404,26431,14625504,1,14599081,-8,-9
X,-,14589023,0.0,7.34684e-40,130,130,0,0,0,gene,C44H4.4,0,14589008,0.49948,7304,14596327,15,14589009,14,-1
X,-,14514993,0.00393701,0.0,254,253,1,1,2,gene,D1025.2,0,14514991,0.884247,9681,14524674,2,14515001,-8,-10
X,-,14503780,0.0,0.0,161,161,0,0,1,gene,M163.1,0,14503744,2.16635,7399,14511179,36,14503833,-53,-89
X,-,14455439,0.0,5.60519e-45,147,147,0,0,33,gene,Y66C5A.1,0,14455425,0.211404,46967,14502406,14,14455425,14,0
X,-,14453755,0.0014039,0.0,7123,7113,10,8,421,gene,F23D12.7,0,14453752,11.7547,852,14454607,3,14453766,-11,-14
X,-,14428065,0.0,0.5,1,1,0,0,0,gene,F23D12.1,0,14428025,0.537835,3717,14431782,40,14428072,-7,-47
X,-,14424620,0.0,0.5,1,1,0,0,890,gene,F23D12.11,0,14424618,None,648,14425268,2,14424669,-49,-51
X,-,14421499,0.0,0.0625,4,4,0,0,0,gene,F23D12.2,0,14421490,0.0258442,2293,14423792,9,14421392,107,98
X,-,14415659,0.727273,0.0805664,11,3,8,6,0,gene,F23D12.10,0,14415586,None,385,14416044,73,14415666,-7,-80
X,-,14412791,0.25,0.109375,8,6,2,2,0,gene,T14C1.3,0,14412775,None,706,14413497,16,14412775,16,0
X,-,14381824,0.0,0.000244141,12,12,0,0,1,gene,Y60A9.2,0,14381811,None,11438,14393262,13,14381811,13,0
X,-,14358985,0.0,2.98023e-08,25,25,0,0,0,gene,K04G11.5,0,14358976,0.118159,17888,14376873,9,14358985,0,-9
X,-,14347518,0.0,1.11022e-16,53,53,0,0,8,gene,K04G11.3,0,14347494,0.0713723,5695,14353213,24,14347494,24,0
X,-,14340401,0.0136986,1.18662e-40,146,144,2,1,4,gene,K04G11.2,0,14340392,0.456015,4801,14345202,9,14340401,0,-9
X,-,14340356,0.0,8.67362e-19,60,60,0,0,40,gene,K04G11.2,0,14340356,0.456015,4846,14345202,0,14340401,-45,-45
X,-,14320318,0.00173913,0.0,575,574,1,1,0,gene,C11H1.9,0,14320261,0.614455,12340,14332658,57,14320318,0,-57
X,-,14311603,0.00328947,0.0,304,303,1,1,0,gene,C11H1.3,1,14311589,0.676858,6437,14318040,14,14311603,0,-14
X,-,14307687,0.980392,2.26485e-14,51,1,50,31,0,gene,C11H1.2,2,14307674,0.152138,93,14307780,13,14307687,0,-13
X,-,14303094,0.0,3.8147e-06,18,18,0,0,0,gene,C11H1.5,0,14303060,0.114116,1758,14304852,34,14303060,34,0
X,-,14296578,0.0224719,6.32664e-24,89,87,2,2,0,gene,C11H1.8,0,14296576,0.668585,1434,14298012,2,14296576,2,0
X,-,14291230,0.0114943,0.0,174,172,2,0,5,gene,E02H4.3,0,14290860,0.795075,6782,14298012,370,14291230,0,-370
X,-,14291207,0.0,0.5,1,1,0,0,387,gene,E02H4.3,0,14290860,0.795075,6805,14298012,347,14291230,-23,-370
X,-,14281544,0.0,0.015625,6,6,0,0,0,gene,E02H4.2,0,14281519,0.00939963,3132,14284676,25,14281519,25,0
X,-,14255174,0.0,0.00390625,8,8,0,0,0,gene,E02H4.5,0,14255052,0.02124,7898,14263072,122,14255052,122,0
X,-,14252057,0.00442478,0.0,226,225,1,1,0,gene,E02H4.6,0,14252057,0.22013,1819,14253876,0,14252057,0,0
X,-,14246533,0.0,2.84217e-14,45,45,0,0,0,gene,K04C1.4,0,14246532,0.109139,3900,14250433,1,14246532,1,0
X,-,14243316,0.0114943,5.62224e-25,87,86,1,0,0,gene,K04C1.3,0,14243314,0.21297,2229,14245545,2,14243316,0,-2
X,-,14209076,0.0,0.125,3,3,0,0,0,gene,C37E2.5,0,14209010,0.588043,10163,14219239,66,14209074,2,-64
X,-,14199652,0.0,1.57772e-30,99,99,0,0,0,gene,C37E2.5,0,14199650,0.588043,19587,14219239,2,14199652,0,-2
X,-,14185520,0.0,3.15544e-30,98,98,0,0,1,gene,C37E2.4,0,14185463,0.200124,11773,14197293,57,14185518,2,-55
X,-,14173310,0.0045208,0.0,1106,1101,5,4,1,gene,C37E2.1,0,14173309,2.68369,9837,14183147,1,14173310,0,-1
X,-,14169540,0.0127389,0.0,314,310,4,2,72,gene,R03E1.1,1,14169527,0.80356,1189,14170729,13,14169540,0,-13
X,-,14164427,0.894765,0.0,1853,195,1658,962,0,gene,R03E1.2,2,14164426,5.39582,128,14164555,1,14164427,0,-1
X,-,14140022,0.0,0.0625,4,4,0,0,0,gene,F28H6.3,0,14139991,0.00620953,15012,14155034,31,14139991,31,0
X,-,14134263,0.0,1.19209e-07,23,23,0,0,1,gene,F28H6.8,0,14134210,0.0372523,3756,14138019,53,14134210,53,0
X,-,14125800,0.0,0.0,229,229,0,0,0,gene,F28H6.6,0,14125795,0.239568,7989,14133789,5,14125795,5,0
X,-,14125694,1.0,0.5,1,0,1,0,0,gene,F28H6.6,0,14125664,0.239568,8095,14133789,30,14125795,-101,-131
X,-,14098583,0.0277778,5.41254e-19,72,70,2,1,0,gene,F16B12.4,0,14098576,0.351186,12599,14111182,7,14098576,7,0
X,-,14084239,0.0,0.0,210,210,0,0,0,gene,C33G3.6,0,14084236,0.239286,11424,14095663,3,14084239,0,-3
X,-,14067905,0.00507614,0.0,197,196,1,0,0,gene,C33G3.3,0,14067905,1.34857,8332,14076237,0,14067905,0,0
X,-,13995755,0.0,0.0,239,239,0,0,0,gene,C31E10.5,0,13995726,0.446699,7186,14002941,29,13995755,0,-29
X,-,13980434,0.0,0.00195312,9,9,0,0,0,gene,F48F7.7,0,13980427,0.0368873,3489,13983923,7,13980427,7,0
X,-,13980429,0.0,0.000488281,11,11,0,0,0,gene,F48F7.7,0,13980427,0.0368873,3494,13983923,2,13980427,2,0
X,-,13969336,0.0,0.125,3,3,0,0,0,gene,F48F7.4,0,13969283,0.685477,9761,13979097,53,13969489,-153,-206
X,-,13929556,0.00246914,0.0,405,404,1,1,0,gene,K02B9.1,0,13929535,0.942777,36090,13965646,21,13929553,3,-18
X,-,13926051,0.383838,0.00554637,99,61,38,28,0,gene,K02B9.2,0,13926030,0.187197,907,13926958,21,13926098,-47,-68
X,-,13917093,0.0142857,6.98093e-39,140,138,2,1,0,gene,Y26E6A.1,0,13917091,0.440217,5471,13922564,2,13917095,-2,-4
X,-,13912900,0.0967742,2.09315e-06,31,28,3,2,0,gene,Y26E6A.2,0,13912891,0.10524,1824,13914724,9,13912902,-2,-11
X,-,13909817,0.0227273,0.0,176,172,4,4,106,gene,Y26E6A.3,0,13909808,0.406286,1028,13910845,9,13909860,-43,-52
X,-,13900071,0.0,0.5,1,1,0,0,0,gene,T21H8.3,0,13900069,0.000349842,913,13900984,2,13900069,2,0
X,-,13893301,0.0,0.25,2,2,0,0,1,gene,T21H8.2,0,13893267,0.0459804,4866,13898167,34,13893256,45,11
X,-,13893276,0.0,1.03398e-25,83,83,0,0,2,gene,T21H8.2,0,13893267,0.0459804,4891,13898167,9,13893256,20,11
X,-,13880942,0.0,1.12104e-44,146,146,0,0,1,gene,T21H8.5,0,13880936,0.704829,9796,13890738,6,13880936,6,0
X,-,13872672,0.0,0.5,1,1,0,0,0,gene,T21H8.1,0,13872664,1.08358,2010,13874682,8,13872672,0,-8
X,-,13864214,0.0,1.0842e-19,63,63,0,0,3,gene,M03B6.3,0,13864210,0.609892,746,13864960,4,13864214,0,-4
X,-,13809791,0.0,0.0,217,217,0,0,1,gene,ZK1086.1,0,13809684,0.545592,7706,13817497,107,13809779,12,-95
X,-,13803495,0.0,4.44089e-16,51,51,0,0,0,gene,ZK1086.1,0,13803493,0.545592,14002,13817497,2,13803493,2,0
X,-,13793545,0.0,0.000488281,11,11,0,0,0,gene,ZK1086.2,0,13793519,0.0303213,4595,13798140,26,13793519,26,0
X,-,13770480,0.00763359,0.0,524,520,4,2,7,gene,F55F3.3,0,13770434,3.22003,19152,13789632,46,13770480,0,-46
X,-,13711928,0.0,6.01853e-36,117,117,0,0,1,gene,K02D3.2,0,13711888,0.140455,7140,13719068,40,13711885,43,3
X,-,13668748,0.00684932,1.63672e-42,146,145,1,1,0,gene,C04A11.2,0,13668618,0.204257,39791,13708539,130,13668732,16,-114
X,-,13631086,0.0169492,1.02349e-16,59,58,1,0,0,gene,C40C9.5,0,13631039,0.354148,11180,13642266,47,13631037,49,2
X,-,13621648,0.00385604,0.0,778,775,3,3,2,gene,Y12A6A.1,0,13621642,1.06933,3692,13625340,6,13621648,0,-6
X,-,13621590,0.0,0.0625,4,4,0,0,25,gene,Y12A6A.1,0,13621497,1.06933,3750,13625340,93,13621648,-58,-151
X,-,13603840,0.0,3.63798e-12,38,38,0,0,24,gene,F54B11.8,0,13603838,0.0527601,16021,13619861,2,13603838,2,0
X,-,13595988,0.00806452,5.83045e-36,124,123,1,1,1,gene,F54B11.5,0,13595987,0.593761,6781,13602769,1,13595987,1,0
X,-,13569874,0.0,2.38419e-07,22,22,0,0,0,gene,R01E6.7,0,13569850,0.0747668,24165,13594039,24,13569874,0,-24
X,-,13556086,0.0,2.06795e-25,82,82,0,0,0,gene,R01E6.6,0,13556076,0.158835,9319,13565405,10,13556085,1,-9
X,-,13525743,0.0,2.93874e-39,128,128,0,0,2,gene,F18H3.3,0,13525739,5.15315,273,13526016,4,13525743,0,-4
X,-,13518831,0.0,8.67362e-19,60,60,0,0,0,gene,F18H3.5,0,13518824,0.538155,3351,13522182,7,13518824,7,0
X,-,13500582,0.2,0.0138855,15,12,3,3,0,gene,F15A2.6,0,13500506,0.285004,9376,13509958,76,13500570,12,-64
X,-,13477368,0.0,3.8147e-06,18,18,0,0,0,gene,F15A2.5,0,13477365,0.0425099,1173,13478541,3,13476902,466,463
X,-,13456464,0.0,0.03125,5,5,0,0,19,gene,F02D10.5,0,13456455,0.136821,442,13456906,9,13456464,0,-9
X,-,13456416,0.0,0.125,3,3,0,0,5,gene,F02D10.5,0,13456412,0.136821,490,13456906,4,13456464,-48,-52
X,-,13451600,0.0384615,3.8743e-07,26,25,1,1,0,gene,F02D10.6,0,13451593,0.0842135,995,13452595,7,13451593,7,0
X,-,13419824,0.00293902,0.0,1361,1357,4,1,240,gene,C29F7.3,0,13419818,1.73775,1922,13421746,6,13419826,-2,-8
X,-,13395018,0.0,0.0625,4,4,0,0,1,gene,F02C12.4,0,13394993,0.0236327,3002,13398020,25,13395027,-9,-34
X,-,13387550,0.0,0.00012207,13,13,0,0,10,gene,C49F8.3,0,13387542,3.20813,4288,13391838,8,13387469,81,73
X,-,13387469,0.00369914,0.0,811,808,3,2,27,gene,C49F8.3,0,13387464,3.20813,4369,13391838,5,13387469,0,-5
X,-,13376913,0.0,0.0,161,161,0,0,1,gene,C49F8.2,0,13376870,0.206183,8886,13385799,43,13376913,0,-43
X,-,13364916,0.00628931,0.0,159,158,1,1,2,gene,C49F8.1,0,13364848,0.2512,6547,13371463,68,13365215,-299,-367
X,-,13350725,0.0047619,0.0,1680,1672,8,6,1,gene,F46G10.6,0,13350711,2.8294,10399,13361124,14,13350725,0,-14
X,-,13311668,0.0,0.00390625,8,8,0,0,5096,gene,F46G10.1,0,13311647,4.12884,37891,13349559,21,13311704,-36,-57
X,-,13290550,0.00954654,0.0,419,415,4,2,1,gene,R04D3.3,1,13290547,0.56885,2784,13293334,3,13290549,1,-2
X,-,13288736,0.9,4.67042e-24,140,14,126,96,0,gene,R04D3.4,2,13288726,0.227385,101,13288837,10,13288729,7,-3
X,-,13286554,0.031746,0.0,252,244,8,8,1,gene,R04D3.2,0,13286551,0.407187,1140,13287694,3,13286554,0,-3
X,-,13278919,0.0,0.0078125,7,7,0,0,0,gene,K09A11.5,0,13278897,0.00545432,3096,13282015,22,13278897,22,0
X,-,13234899,0.0,7.27596e-12,37,37,0,0,0,gene,K08H2.2,0,13234878,0.0829412,6129,13241028,21,13234878,21,0
X,-,13232275,0.0,0.00195312,9,9,0,0,0,gene,K08H2.9,0,13232265,0.0222793,1744,13234019,10,13232249,26,16
X,-,13226597,0.0,0.0,994,994,0,0,1,gene,K08H2.1,0,13226585,1.55416,1830,13228427,12,13226585,12,0
X,-,13224652,0.0,0.5,1,1,0,0,0,gene,R12H7.3,1,13224629,1.25255,1078,13225730,23,13224629,23,0
X,-,13224633,0.00126103,0.0,793,792,1,0,12,gene,R12H7.3,1,13224629,1.25255,1097,13225730,4,13224629,4,0
X,-,13223467,0.884731,0.0,668,77,591,247,1,gene,R12H7.5,2,13223458,0.854878,2263,13225730,9,13223467,0,-9
X,-,13178368,0.0,0.0,207,207,0,0,6,gene,F48C11.3,0,13178338,1.51881,3861,13182229,30,13178375,-7,-37
X,-,13169996,0.00724638,3.96041e-40,138,137,1,1,50,gene,F09A5.4,0,13169995,1.99445,7781,13177777,1,13169996,0,-1
X,-,13161396,0.0119048,4.3427e-24,84,83,1,0,0,gene,F09A5.4,0,13161388,1.99445,16381,13177777,8,13161396,0,-8
X,-,13155728,0.00446429,0.0,448,446,2,2,4,gene,F09A5.4,0,13155710,1.99445,22049,13177777,18,13155728,0,-18
X,-,13122211,0.0,4.76837e-07,21,21,0,0,2,gene,F17H10.3,0,13122201,0.459896,30529,13152740,10,13122211,0,-10
X,-,13119136,0.0,0.0,175,175,0,0,0,gene,F17H10.3,0,13119070,0.459896,33604,13152740,66,13119136,0,-66
X,-,13068158,0.0142857,5.92923e-20,70,69,1,0,0,gene,K03A11.2,0,13068104,0.092348,26320,13094478,54,13068104,54,0
X,-,13021957,0.0,3.72529e-09,28,28,0,0,0,gene,C53C7.1,0,13021944,0.0574597,45249,13067206,13,13021944,13,0
X,-,12989128,0.00838926,0.0,596,591,5,5,7,gene,F11C1.1,1,12989128,0.576931,29362,13018490,0,12989233,-105,-105
X,-,12987139,0.836806,5.70749e-33,288,47,241,129,13,gene,F11C1.2,2,12987126,0.558928,113,12987252,13,12987139,0,-13
X,-,12975567,0.0,4.23516e-22,71,71,0,0,6,gene,VF11C1L.1,0,12975563,0.322004,10141,12985708,4,12975563,4,0
X,-,12946488,0.0,0.0,190,190,0,0,9,gene,C05E7.3,0,12946482,0.229686,22333,12968821,6,12946482,6,0
X,-,12935020,0.0,0.125,3,3,0,0,1,gene,C34E7.4,0,12934937,3.79337,3595,12938615,83,12934897,123,40
X,-,12884781,0.0,0.000244141,12,12,0,0,0,gene,K02A4.2,0,12884630,0.386461,47346,12932127,151,12884781,0,-151
X,-,12882349,0.0120482,8.582e-24,83,82,1,1,2,gene,K02A4.2,0,12882331,0.386461,49778,12932127,18,12882349,0,-18
X,-,12882343,0.0,0.125,3,3,0,0,49,gene,K02A4.2,0,12882331,0.386461,49784,12932127,12,12882349,-6,-18
X,-,12863816,0.0,8.88178e-16,50,50,0,0,1,gene,T14G8.4,0,12863811,0.0544054,17241,12881057,5,12863811,5,0
X,-,12852521,0.00392157,0.0,255,254,1,0,0,gene,T14G8.1,0,12852503,1.09844,9297,12861818,18,12852521,0,-18
X,-,12813920,0.0,0.00390625,8,8,0,0,0,gene,T22H6.6,0,12813832,0.694641,31809,12845729,88,12813867,53,-35
X,-,12813867,0.0,1.03398e-25,83,83,0,0,3,gene,T22H6.6,0,12813832,0.694641,31862,12845729,35,12813867,0,-35
X,-,12808238,0.0,5.55112e-17,54,54,0,0,0,gene,F16H9.2,0,12808169,0.000532263,37491,12845729,69,12808238,0,-69
X,-,12802098,0.0,0.5,1,1,0,0,1,gene,T22H6.6,0,12801692,0.694641,43631,12845729,406,12802098,0,-406
X,-,12800503,0.0,0.25,2,2,0,0,0,gene,T22H6.6,0,12800492,0.694641,45226,12845729,11,12800503,0,-11
X,-,12797508,0.0,1.52588e-05,16,16,0,0,0,gene,T22H6.6,0,12797508,0.694641,48221,12845729,0,12797508,0,0
X,-,12769715,0.0,0.0625,4,4,0,0,0,gene,T22H6.1,0,12769713,0.00403842,25407,12795122,2,12769713,2,0
X,-,12749500,0.0111111,7.27014e-26,90,89,1,1,0,gene,F22E10.3,2,12749493,0.26021,1994,12751494,7,12749500,0,-7
X,-,12667772,0.0186916,0.0,214,210,4,2,0,gene,C02B4.2,0,12667770,0.484482,27896,12695668,2,12667772,0,-2
X,-,12653440,0.00123609,0.0,4854,4848,6,5,2,gene,H36L18.2,0,12653425,9.24668,5535,12658975,15,12653440,0,-15
X,-,12640479,0.0,0.0,196,196,0,0,0,gene,R09A8.5,0,12640409,0.53627,11568,12652047,70,12640409,70,0
X,-,12634276,0.0,1.92593e-34,112,112,0,0,0,gene,R09A8.3,0,12634137,1.71227,1744,12636020,139,12634276,0,-139
X,-,12629032,0.00609756,0.0,328,326,2,2,0,gene,R09A8.3,0,12628965,1.71227,6988,12636020,67,12629032,0,-67
X,-,12599226,0.0350877,1.10745e-14,57,55,2,2,0,gene,T24D5.5,0,12599218,0.00814284,25350,12624576,8,12599218,8,0
X,-,12586367,0.0357143,1.04308e-07,28,27,1,1,0,gene,T24D5.2,0,12586360,0.156869,11583,12597950,7,12586360,7,0
X,-,12551598,0.0,6.10352e-05,14,14,0,0,1,gene,C16D6.2,0,12551442,0.0895627,32201,12583799,156,12551598,0,-156
X,-,12540780,0.0,0.00195312,9,9,0,0,0,gene,C16D6.2,0,12540779,0.0895627,43019,12583799,1,12540780,0,-1
X,-,12525704,0.0,2.71051e-20,65,65,0,0,0,gene,C16D6.1,0,12525642,0.10873,11213,12536917,62,12525704,0,-62
X,-,12513969,0.0,1.03398e-25,83,83,0,0,0,gene,H20J18.1,0,12513786,2.35985,8581,12522550,183,12513969,0,-183
X,-,12509140,0.00265957,0.0,376,375,1,1,2,gene,H20J18.1,0,12509138,2.35985,13410,12522550,2,12509140,0,-2
X,-,12503259,0.0,9.31323e-10,30,30,0,0,0,gene,F45E6.6,0,12503253,0.0487104,561,12503820,6,12503259,0,-6
X,-,12454248,0.0,0.000244141,12,12,0,0,2,gene,T18D3.9,0,12454238,0.100123,4646,12458894,10,12454238,10,0
X,-,12413957,0.0434783,2.74181e-06,23,22,1,1,0,gene,F17E5.1,0,12413947,0.289309,37172,12451129,10,12413947,10,0
X,-,12391396,0.0,3.76158e-37,121,121,0,0,0,gene,F19H6.1,0,12391394,0.333881,8044,12399440,2,12391394,2,0
X,-,12378315,0.0,5.29396e-23,74,74,0,0,0,gene,F19H6.7,0,12378272,0.144717,11238,12389553,43,12378272,43,0
X,-,12371345,0.0,1.90735e-06,19,19,0,0,0,gene,F19H6.3,0,12371343,0.00815521,1702,12373047,2,12371343,2,0
X,-,12352869,0.0,0.0,315,315,0,0,17,gene,F42F12.4,0,12352867,0.668036,3247,12356116,2,12352869,0,-2
X,-,12320624,0.0,0.0,185,185,0,0,3,gene,F17A2.5,0,12320622,0.210722,19679,12340303,2,12320622,2,0
X,-,12296550,0.0,3.05176e-05,15,15,0,0,160,gene,W06D11.2,0,12296486,0.181208,4960,12301510,64,12296567,-17,-81
X,-,12270863,0.0,0.5,1,1,0,0,0,gene,H19J13.1,0,12270861,0.0224286,2695,12273558,2,12270863,0,-2
X,-,12212823,0.0,5.55112e-17,54,54,0,0,79,gene,C23H4.1,0,12212770,6.29268,54011,12266834,53,12212823,0,-53
X,-,12205554,0.00267023,0.0,749,747,2,2,3,gene,C23H4.1,0,12205554,6.29268,61280,12266834,0,12205554,0,0
X,-,12171603,0.00287121,0.0,2438,2431,7,7,1,gene,F57G12.1,0,12171587,3.06298,27974,12199577,16,12171603,0,-16
X,-,12159972,0.0196078,2.26485e-14,51,50,1,1,0,gene,F57G12.2,0,12159961,0.148457,9044,12169016,11,12159961,11,0
X,-,12154009,0.0,0.0,234,234,0,0,2,gene,M153.2,0,12154001,0.167297,2347,12156356,8,12154011,-2,-10
X,-,12141076,0.0,9.09495e-13,40,40,0,0,1,gene,T01H10.8,0,12141073,0.101059,9086,12150162,3,12141073,3,0
X,-,12080194,0.00289017,0.0,346,345,1,1,3,gene,W03G11.4,0,12080144,1.67772,19924,12100118,50,12080194,0,-50
X,-,12073785,0.0,0.5,1,1,0,0,0,gene,C15A7.2,0,12073761,0.037156,2628,12076413,24,12073761,24,0
X,-,12049267,0.0,8.67362e-19,60,60,0,0,1,gene,B0198.3,0,12049258,0.187486,21398,12070665,9,12049250,17,8
X,-,12033957,0.0,1.57772e-30,99,99,0,0,1,gene,B0198.1,0,12033945,0.268841,8560,12042517,12,12033945,12,0
X,-,12005053,0.0,0.25,2,2,0,0,3,gene,W06B3.2,0,12005046,1.17606,9122,12014175,7,12005014,39,32
X,-,12004969,0.0,0.5,1,1,0,0,11,gene,W06B3.2,0,12004926,1.17606,9206,12014175,43,12004926,43,0
X,-,12001309,0.0,0.0,227,227,0,0,0,gene,W06B3.2,0,12001267,1.17606,12866,12014175,42,12001267,42,0
X,-,12000554,0.0,1.81899e-12,39,39,0,0,0,gene,W06B3.2,0,12000549,1.17606,14,12000568,5,12000554,0,-5
X,-,11983548,0.0,0.0,231,231,0,0,0,gene,C49F5.3,0,11983541,0.352764,7858,11991406,7,11983821,-273,-280
X,-,11982005,0.0,0.5,1,1,0,0,5,gene,C49F5.4,0,11981906,0.0226401,629,11982634,99,11982097,-92,-191
X,-,11974601,0.0,0.0,381,381,0,0,2,gene,C49F5.2,0,11974598,0.218371,5530,11980131,3,11974598,3,0
X,-,11962568,0.0,0.0,274,274,0,0,1,gene,C49F5.9,0,11962522,None,1046,11963614,46,11962568,0,-46
X,-,11946754,0.0178571,1.19716e-30,112,110,2,2,0,gene,T08D10.1,0,11946724,0.355292,5251,11952005,30,11946756,-2,-32
X,-,11941979,0.5,0.5,2,1,1,1,0,gene,F55G7.3,0,11941973,0.00246337,2301,11944280,6,11941973,6,0
X,-,11931575,0.0,0.03125,5,5,0,0,1,gene,F55G7.2,0,11931568,0.0496007,6544,11938119,7,11931568,7,0
X,-,11909995,0.0,6.10352e-05,14,14,0,0,45,gene,Y62H9A.15,0,11909964,None,19705,11929700,31,11910063,-68,-99
X,-,11902676,0.0,0.5,1,1,0,0,0,gene,Y62H9A.10,0,11902671,0.0100791,2239,11904915,5,11902671,5,0
X,-,11892354,0.0,0.125,3,3,0,0,0,gene,Y62H9A.8,0,11892344,0.0209489,3143,11895497,10,11892344,10,0
X,-,11854919,0.0192308,1.15463e-14,52,51,1,1,0,gene,F54F7.8,0,11854918,0.0763725,12972,11867891,1,11854918,1,0
X,-,11837399,0.0,1.97215e-31,102,102,0,0,3,gene,F54F7.1,0,11837386,0.17701,9140,11846539,13,11837397,2,-11
X,-,11811461,0.0,0.0625,4,4,0,0,0,gene,C34E11.2,0,11811430,0.117109,24681,11836142,31,11811386,75,44
X,-,11767979,0.0,3.63798e-12,38,38,0,0,0,gene,C40H5.5,0,11767966,0.0519817,13588,11781567,13,11767979,0,-13
X,-,11733618,0.0,8.88178e-16,50,50,0,0,0,gene,D1053.3,0,11733612,0.186631,30777,11764395,6,11733612,6,0
X,-,11727720,0.00436681,0.0,229,228,1,1,400,gene,D1053.1,0,11727718,1.81855,1788,11729508,2,11727819,-99,-101
X,-,11723715,0.0,0.0,284,284,0,0,1,gene,D1053.4,0,11723693,0.438491,2478,11726193,22,11723693,22,0
X,-,11716433,0.00616016,0.0,974,968,6,3,0,gene,C44C10.9,0,11716431,0.448082,5213,11721646,2,11716431,2,0
X,-,11712202,0.0,0.0,3482,3482,0,0,53,gene,C44C10.1,0,11712202,2.52603,958,11713160,0,11712202,0,0
X,-,11710112,0.0,3.55271e-15,48,48,0,0,0,gene,C44C10.11,0,11710106,0.183246,1117,11711229,6,11710106,6,0
X,-,11679584,0.0,0.125,3,3,0,0,1,gene,T04F8.7,0,11679491,0.413646,7337,11686921,93,11679584,0,-93
X,-,11661583,0.00275862,0.0,725,723,2,2,1,gene,T04F8.1,0,11661579,0.740481,15854,11677437,4,11661583,0,-4
X,-,11656492,0.0,0.0,323,323,0,0,2,gene,T04F8.2,0,11656491,0.529653,3036,11659528,1,11656492,0,-1
X,-,11650767,0.0,7.45058e-09,27,27,0,0,0,gene,T04F8.4,0,11650753,0.0895306,2719,11653486,14,11650840,-73,-87
X,-,11628385,0.0,0.25,2,2,0,0,0,gene,Y71H9A.1,0,11628385,0.00589011,19731,11648116,0,11628385,0,0
X,-,11622017,0.0,0.00195312,9,9,0,0,0,gene,F52D10.5,0,11621918,0.00836458,870,11622887,99,11621918,99,0
X,-,11605334,0.00282061,0.0,10636,10606,30,25,25,gene,F52D10.3,0,11605302,28.4974,14633,11619967,32,11605334,0,-32
X,-,11591639,0.0,0.0,548,548,0,0,0,gene,F52D10.2,0,11591636,0.536083,11992,11603631,3,11591641,-2,-5
X,-,11546418,0.00972763,0.0,514,509,5,4,7,gene,C35C5.3,0,11546418,3.0276,43192,11589610,0,11546418,0,0
X,-,11518983,0.00526316,0.0,380,378,2,1,1,gene,F29G6.3,0,11518940,4.19502,6110,11525093,43,11518983,0,-43
X,-,11454117,0.0,7.34684e-40,130,130,0,0,13,gene,F48C5.2,0,11454109,0.321258,36892,11491009,8,11454119,-2,-10
X,-,11446557,0.0,1.57772e-30,99,99,0,0,2,gene,F48C5.1,0,11446544,0.303858,4988,11451545,13,11446544,13,0
X,-,11433507,0.0,1.32349e-23,76,76,0,0,15,gene,F46C3.3,0,11433448,0.554411,1501,11435008,59,11433448,59,0
X,-,11433498,0.0,0.125,3,3,0,0,31,gene,F46C3.3,0,11433448,0.554411,1510,11435008,50,11433448,50,0
X,-,11426244,0.0181818,1.52656e-15,55,54,1,1,2,gene,F46C3.3,0,11426130,0.554411,8764,11435008,114,11426244,0,-114
X,-,11425955,0.0,0.5,1,1,0,0,0,gene,F46C3.3,0,11425954,0.554411,9053,11435008,1,11425954,1,0
X,-,11419944,0.0263158,1.38243e-10,38,37,1,1,249,gene,F46C3.6,0,11419874,None,466,11420410,70,11419986,-42,-112
X,-,11418686,0.0,7.62939e-06,17,17,0,0,0,gene,F46C3.2,0,11418666,0.0467158,348,11419034,20,11418666,20,0
X,-,11414772,0.0,4.23516e-22,71,71,0,0,2,gene,F46C3.1,0,11414765,0.537753,1869,11416641,7,11414737,35,28
X,-,11414712,0.0,1.52588e-05,16,16,0,0,30,gene,F46C3.1,0,11414695,0.537753,1929,11416641,17,11414737,-25,-42
X,-,11407656,0.00113563,0.0,6164,6157,7,4,37,gene,F08B12.4,0,11407628,10.0362,2451,11410107,28,11407656,0,-28
X,-,11407594,0.00481928,0.0,1660,1652,8,2,172,gene,F08B12.4,0,11407580,10.0362,2513,11410107,14,11407656,-62,-76
X,-,11401233,0.0,2.91038e-11,35,35,0,0,1,gene,F08B12.3,0,11401233,0.337371,1733,11402966,0,11401233,0,0
X,-,11377396,0.000483325,0.0,6207,6204,3,3,15,gene,F42E11.4,0,11377387,4.27265,17136,11394532,9,11377396,0,-9
X,-,11375732,1.0,0.125,3,0,3,1,0,gene,F42E11.3,0,11375717,0.0143427,72,11375804,15,11375535,197,182
X,-,11324177,0.0,0.0,162,162,0,0,0,gene,ZK455.4,0,11324177,0.295985,197,11324374,0,11324177,0,0
X,-,11310185,0.0416667,1.43051e-06,24,23,1,1,9,gene,F08G12.5,1,11310172,0.259049,2947,11313132,13,11310148,37,24
X,-,11305799,0.881579,1.88553e-12,76,9,67,29,2,gene,F08G12.1,2,11305799,0.350852,139,11305938,0,11305799,0,0
X,-,11299553,0.0,2.1684e-19,62,62,0,0,796,gene,F08G12.2,0,11299526,1.44872,2408,11301961,27,11299613,-60,-87
X,-,11296657,0.00172414,0.0,580,579,1,1,2,gene,F08G12.10,0,11296655,2.08438,1352,11298009,2,11296657,0,-2
X,-,11287643,0.00337838,0.0,888,885,3,2,0,gene,F38B2.4,0,11287640,1.61609,7235,11294878,3,11287643,0,-3
X,-,11286270,0.0,0.0625,4,4,0,0,1,gene,F38B2.3,0,11286245,0.00365089,234,11286504,25,11286272,-2,-27
X,-,11281211,0.0,0.015625,6,6,0,0,1,gene,F38B2.6,0,11281135,None,429,11281640,76,11281162,49,-27
X,-,11279302,0.0,1.73472e-18,59,59,0,0,0,gene,F38B2.2,0,11279293,0.153126,1264,11280566,9,11279293,9,0
X,-,11237306,0.0,6.10352e-05,14,14,0,0,0,gene,C34F6.10,0,11237290,0.387503,3033,11240339,16,11237308,-2,-18
X,-,11222734,0.0,2.32831e-10,32,32,0,0,1,gene,C34F6.9,0,11222572,0.315743,3652,11226386,162,11222572,162,0
X,-,11215395,0.00578035,0.0,173,172,1,0,2,gene,C34F6.7,0,11215394,0.41118,496,11215891,1,11215395,0,-1
X,-,11208813,0.0,3.46945e-18,58,58,0,0,3,gene,C34F6.5,0,11208797,0.283178,1219,11210032,16,11208797,16,0
X,-,11196766,0.0,5.55112e-17,54,54,0,0,0,gene,C34F6.1,0,11196759,0.0982202,5635,11202401,7,11196766,0,-7
X,-,11189533,0.0,2.84217e-14,45,45,0,0,0,gene,F13D2.4,0,11189497,0.161188,2876,11192409,36,11189489,44,8
X,-,11152744,0.0,0.125,3,3,0,0,0,gene,C05C9.3,0,11152736,0.0305792,11137,11163881,8,11152744,0,-8
X,-,11125542,0.0,6.16298e-33,107,107,0,0,0,gene,R08B4.2,0,11125482,0.330556,17307,11142849,60,11125539,3,-57
X,-,11105429,0.0,0.125,3,3,0,0,0,gene,W02H3.1,0,11105414,0.082707,10604,11116033,15,11105384,45,30
X,-,11078168,0.0,0.5,1,1,0,0,1,gene,W04G3.10,0,11078167,0.0131156,1065,11079233,1,11078167,1,0
X,-,11043083,0.0,0.5,1,1,0,0,0,gene,C09F12.3,0,11042998,0.0272572,33021,11076104,85,11042781,302,217
X,-,11010589,0.0,5.55112e-17,54,54,0,0,4,gene,F58A3.4,0,11010564,0.146548,30374,11040963,25,11010580,9,-16
X,-,11008978,0.0,0.0,1261,1261,0,0,5,gene,F58A3.5,0,11008977,2.16339,460,11009438,1,11008994,-16,-17
X,-,11001774,0.0,3.05176e-05,15,15,0,0,0,gene,F59F3.2,0,11001774,0.0522759,3169,11004943,0,11001774,0,0
X,-,10999180,0.0,0.03125,5,5,0,0,1,gene,F59F3.6,0,10999164,0.19638,426,10999606,16,10999202,-22,-38
X,-,10979191,0.0,8.47033e-22,70,70,0,0,4,gene,K09C8.5,0,10979189,0.190272,18708,10997899,2,10979189,2,0
X,-,10941279,0.0,1.00974e-28,93,93,0,0,1,gene,T21B6.2,0,10941278,0.132451,3796,10945075,1,10941278,1,0
X,-,10928923,0.0,4.59177e-41,134,134,0,0,0,gene,T21B6.1,0,10928805,1.71283,9198,10938121,118,10928909,14,-104
X,-,10923444,0.00543478,0.0,736,732,4,4,0,gene,T21B6.1,0,10923434,1.71283,14677,10938121,10,10923444,0,-10
X,-,10919678,0.0,0.000976562,10,10,0,0,0,gene,T21B6.5,0,10919638,0.00857947,763,10920441,40,10919938,-260,-300
X,-,10914006,0.0194175,5.17986e-28,103,101,2,2,0,gene,F47B10.9,0,10914000,0.457006,2506,10916512,6,10914000,6,0
X,-,10906753,0.0,0.00195312,9,9,0,0,8,gene,F47B10.8,0,10906655,0.106646,5329,10912082,98,10906505,248,150
X,-,10900039,0.00145349,0.0,688,687,1,0,4,gene,F47B10.1,0,10900031,5.21889,5065,10905104,8,10900039,0,-8
X,-,10896277,0.0,0.015625,6,6,0,0,79,gene,F47B10.2,0,10896250,2.31093,1320,10897597,27,10896344,-67,-94
X,-,10890412,0.0,0.0,214,214,0,0,30,gene,F47B10.5,0,10890397,0.376857,3077,10893489,15,10890451,-39,-54
X,-,10876226,0.0,0.25,2,2,0,0,0,gene,T21E8.1,0,10876189,0.0412935,12783,10889009,37,10876226,0,-37
X,-,10876153,0.0,0.125,3,3,0,0,3,gene,T21E8.1,0,10876130,0.0412935,12856,10889009,23,10876153,0,-23
X,-,10870178,0.0,0.0078125,7,7,0,0,0,gene,T21E8.2,0,10870162,0.00374168,981,10871159,16,10870162,16,0
X,-,10864316,0.0,0.0625,4,4,0,0,23,gene,T21E8.3,0,10864310,0.0228611,576,10864892,6,10864347,-31,-37
X,-,10844599,0.003003,0.0,333,332,1,1,0,gene,C05A9.2,0,10844598,1.26906,9645,10854244,1,10844599,0,-1
X,-,10833493,0.0,6.10352e-05,14,14,0,0,0,gene,F31B12.3,0,10833484,0.0811032,8624,10842117,9,10833493,0,-9
X,-,10812497,0.0,0.00390625,8,8,0,0,0,gene,F31B12.1,0,10812464,0.274126,6872,10819369,33,10812497,0,-33
X,-,10783841,0.0,2.91038e-11,35,35,0,0,0,gene,T05A10.2,0,10783832,0.24156,5697,10789538,9,10783832,9,0
X,-,10746413,0.0107527,9.3906e-27,93,92,1,1,0,gene,R07A4.2,0,10746340,0.253881,5155,10751568,73,10746413,0,-73
X,-,10721978,0.0,2.77556e-17,55,55,0,0,0,gene,T01C1.2,0,10721973,0.0551527,22310,10744288,5,10721980,-2,-7
X,-,10717045,0.00961538,0.0,208,206,2,1,70,gene,T01C1.4,0,10717032,0.232648,2434,10719479,13,10717099,-54,-67
X,-,10711793,0.0,1.86265e-09,29,29,0,0,0,gene,F13E6.6,0,10711784,0.166991,4455,10716248,9,10711784,9,0
X,-,10677036,0.00274914,0.0,1455,1451,4,4,12,gene,F13E6.1,0,10677028,3.82142,861,10677897,8,10677036,0,-8
X,-,10674220,0.0,1.19209e-07,23,23,0,0,2,gene,F13E6.2,0,10674142,0.0416075,1419,10675639,78,10674220,0,-78
X,-,10628734,0.0166667,5.37154e-33,120,118,2,2,1,gene,M79.2,0,10628732,0.402573,39421,10668155,2,10628732,2,0
X,-,10624127,0.0,4.81482e-35,114,114,0,0,1,gene,M79.1,0,10624091,0.586913,2315,10626442,36,10624112,15,-21
X,-,10593262,0.00990099,0.0,404,400,4,4,3,gene,F57C7.3,0,10593239,4.64981,12497,10605759,23,10593262,0,-23
X,-,10555167,0.0,0.0,180,180,0,0,2,gene,F59F5.6,0,10555146,0.583625,25817,10580984,21,10555167,0,-21
X,-,10524493,0.031746,2.11745e-16,63,61,2,0,9,gene,F14F3.3,0,10524485,0.355769,3438,10527931,8,10524493,0,-8
X,-,10521411,1.0,0.5,1,0,1,1,1,gene,F14F3.4,0,10521378,0.277837,322,10521733,33,10521333,78,45
X,-,10463520,0.0,0.0078125,7,7,0,0,4,gene,C39B10.1,0,10463510,0.0535504,10755,10474275,10,10463510,10,0
X,-,10463514,0.0,0.0078125,7,7,0,0,2,gene,C39B10.1,0,10463510,0.0535504,10761,10474275,4,10463510,4,0
X,-,10428580,0.0,0.0,213,213,0,0,0,gene,ZC504.4,0,10428504,0.922289,22223,10450803,76,10428580,0,-76
X,-,10419687,0.0103093,0.0,194,192,2,2,0,gene,ZC504.3,0,10419681,0.298707,1898,10421585,6,10419681,6,0
X,-,10386424,0.0,0.03125,5,5,0,0,0,gene,F46F6.4,0,10386397,0.158634,16032,10402456,27,10386388,36,9
X,-,10385820,0.0,0.5,1,1,0,0,1,gene,F46F6.4,0,10385637,0.158634,16636,10402456,183,10385820,0,-183
X,-,10383515,0.0909091,0.00537109,11,10,1,1,3,gene,F46F6.4,0,10383500,0.158634,18941,10402456,15,10383515,0,-15
X,-,10377592,0.0,2.35099e-38,125,125,0,0,15,gene,F46F6.1,0,10377540,0.808775,1285,10378877,52,10377592,0,-52
X,-,10372282,0.0232558,5.1355e-34,129,126,3,2,0,gene,Y49A10A.2,0,10372282,0.577976,880,10373162,0,10372282,0,0
X,-,10344010,0.0,5.42101e-20,64,64,0,0,0,gene,R07E3.7,0,10344004,0.336799,26665,10370675,6,10343984,26,20
X,-,10340951,0.0,0.5,1,1,0,0,1,gene,R07E3.1,0,10340922,3.03946,717,10341668,29,10340951,0,-29
X,-,10338128,0.0,5.96046e-08,24,24,0,0,0,gene,R07E3.3,0,10338119,0.274482,1025,10339153,9,10338119,9,0
X,-,10337711,0.0,0.125,3,3,0,0,0,gene,R07E3.3,0,10337514,0.274482,1442,10339153,197,10338119,-408,-605
X,-,10331830,0.00460829,0.0,651,648,3,2,5,gene,R07E3.4,0,10331803,0.55633,1958,10333788,27,10331803,27,0
X,-,10327386,0.0,0.0,152,152,0,0,19,gene,R07E3.5,0,10327385,0.717162,3080,10330466,1,10327386,0,-1
X,-,10327337,0.0,0.03125,5,5,0,0,24,gene,R07E3.5,0,10327300,0.717162,3129,10330466,37,10327337,0,-37
X,-,10326757,0.0,0.000244141,12,12,0,0,0,gene,R07E3.5,0,10326732,0.717162,3709,10330466,25,10326757,0,-25
X,-,10315933,0.0,0.00390625,8,8,0,0,0,gene,F41E7.9,0,10315926,0.0284835,8150,10324083,7,10315935,-2,-9
X,-,10285665,0.0,0.25,2,2,0,0,0,gene,F41E7.3,0,10285626,0.063325,21308,10306973,39,10285665,0,-39
X,-,10285626,0.0,0.000976562,10,10,0,0,0,gene,F41E7.3,0,10285626,0.063325,21347,10306973,0,10285665,-39,-39
X,-,10248643,0.0,0.125,3,3,0,0,0,gene,C14H10.2,0,10248527,1.10891,487,10249130,116,10248532,111,-5
X,-,10245277,0.00990099,3.98375e-29,101,100,1,1,17,gene,C14H10.2,0,10245204,1.10891,3853,10249130,73,10245277,0,-73
X,-,10245105,0.0,0.25,2,2,0,0,0,gene,C14H10.2,0,10244991,1.10891,4025,10249130,114,10245105,0,-114
X,-,10236874,0.00230947,0.0,433,432,1,0,6,gene,C14H10.1,0,10236851,1.60166,2812,10239686,23,10236874,0,-23
X,-,10228067,0.00155039,0.0,645,644,1,1,1,gene,C14H10.3,0,10228066,0.682487,5587,10233654,1,10228066,1,0
X,-,10218657,0.0,0.0,677,677,0,0,23,gene,F44A6.5,0,10218654,0.467945,1917,10220574,3,10218690,-33,-36
X,-,10215419,0.0131926,0.0,379,374,5,4,10,gene,F44A6.4,0,10215409,0.758026,1819,10217238,10,10215484,-65,-75
X,-,10205351,0.00110375,0.0,906,905,1,0,0,gene,F44A6.2,0,10205351,1.25287,9036,10214387,0,10205351,0,0
X,-,10194307,0.0212766,3.33955e-13,47,46,1,1,0,gene,F21A10.2,0,10194273,1.71843,6952,10201259,34,10194307,0,-34
X,-,10187888,0.0,0.0078125,7,7,0,0,18,gene,F21A10.2,0,10187876,1.71843,13371,10201259,12,10187888,0,-12
X,-,10141889,0.0,0.0078125,7,7,0,0,110,gene,F09B9.1,0,10141841,0.36819,14897,10156786,48,10141944,-55,-103
X,-,10138551,0.0,0.0,261,261,0,0,0,gene,T06H11.4,0,10138549,0.332926,754,10139305,2,10138550,1,-1
X,-,10109629,0.0,0.5,1,1,0,0,3,gene,T06H11.1,0,10109578,0.189306,12971,10122600,51,10109799,-170,-221
X,-,10095155,0.0182648,0.0,219,215,4,1,3,gene,W07E11.3,0,10095086,1.16917,9387,10104542,69,10095155,0,-69
X,-,10092895,0.00561798,0.0,356,354,2,0,2,gene,W07E11.2,0,10092849,0.897441,1468,10094363,46,10092895,0,-46
X,-,10087891,0.00383877,0.0,1563,1557,6,5,1,gene,W07E11.4,0,10087889,3.04988,4001,10091892,2,10087889,2,0
X,-,10074171,0.0,0.0078125,7,7,0,0,54,gene,ZC373.5,0,10074138,0.202983,13075,10087246,33,10074222,-51,-84
X,-,10069734,0.0,6.61744e-24,77,77,0,0,0,gene,ZC373.4,0,10069715,0.174248,2404,10072138,19,10069715,19,0
X,-,10008694,0.0,0.00390625,8,8,0,0,0,gene,F19C6.3,0,10008687,0.0587228,6280,10014974,7,10008687,7,0
X,-,9999042,0.0,5.55112e-17,54,54,0,0,21,gene,F19C6.1,0,9998983,0.494977,1447,10000489,59,9999110,-68,-127
X,-,9973937,0.0,0.25,2,2,0,0,0,gene,ZC506.4,0,9973913,0.0437526,8397,9982334,24,9973913,24,0
X,-,9954465,0.0,0.0,381,381,0,0,3,gene,C17G1.7,0,9954465,1.73385,14096,9968561,0,9954465,0,0
X,-,9948992,0.0,0.0,185,185,0,0,0,gene,C17G1.6,0,9948991,0.594126,3518,9952510,1,9948992,0,-1
X,-,9931392,0.0,0.0,221,221,0,0,1,gene,C17G1.4,0,9931384,0.912507,13384,9944776,8,9931392,0,-8
X,-,9924808,0.857143,0.0546875,7,1,6,2,1,gene,C17G1.3,0,9924729,1.09663,998,9925806,79,9924808,0,-79
X,-,9917378,0.0,3.67342e-40,131,131,0,0,7,gene,F21G4.6,0,9917376,0.117867,5471,9922849,2,9917376,2,0
X,-,9899408,0.0,0.0,203,203,0,0,0,gene,F21G4.4,0,9899402,0.167539,9318,9908726,6,9899408,0,-6
X,-,9892260,0.0,6.31089e-30,97,97,0,0,0,gene,F21G4.1,0,9892254,0.212946,4978,9897238,6,9892260,0,-6
X,-,9882144,0.0,4.03897e-28,91,91,0,0,1,gene,R07B1.12,0,9882138,0.291513,7383,9889527,6,9882138,6,0
X,-,9862892,0.00162206,0.0,1233,1231,2,2,2,gene,R07B1.4,0,9862887,2.09222,7846,9870738,5,9862887,5,0
X,-,9837971,0.0,0.0,309,309,0,0,0,gene,F47A4.5,0,9837965,0.390975,23606,9861577,6,9837971,0,-6
X,-,9831216,0.0454545,5.24521e-06,22,21,1,0,0,gene,F47A4.3,0,9831151,0.241234,2065,9833281,65,9831142,74,9
X,-,9822203,0.00819672,2.29456e-35,122,121,1,1,0,gene,F47A4.2,0,9822143,0.618306,1484,9823687,60,9822205,-2,-62
X,-,9807594,0.0,0.125,3,3,0,0,0,gene,F47A4.1,0,9807498,0.189778,2540,9810134,96,9807594,0,-96
X,-,9806961,0.0,0.0078125,7,7,0,0,0,gene,F47A4.1,0,9806954,0.189778,3173,9810134,7,9806961,0,-7
X,-,9794205,0.0,1.4013e-45,149,149,0,0,0,gene,F36G3.2,0,9794197,0.632196,6810,9801015,8,9794205,0,-8
X,-,9789142,0.0,2.64698e-23,75,75,0,0,30,gene,F36G3.1,0,9789124,0.526659,3199,9792341,18,9789142,0,-18
X,-,9774303,0.0,0.00390625,8,8,0,0,6,gene,T09B9.4,0,9774269,0.586746,5997,9780300,34,9774284,19,-15
X,-,9774284,0.0,0.0,395,395,0,0,9,gene,T09B9.4,0,9774269,0.586746,6016,9780300,15,9774284,0,-15
X,-,9764854,0.0,3.38813e-21,68,68,0,0,0,gene,T09B9.2,0,9764851,0.0475775,6775,9771629,3,9764854,0,-3
X,-,9737683,0.0,1.81899e-12,39,39,0,0,25,gene,F15G9.5,0,9737667,0.290106,21546,9759229,16,9737682,1,-15
X,-,9680101,0.00460829,0.0,217,216,1,1,8,gene,C43C3.1,0,9680098,1.35375,28403,9708504,3,9680101,0,-3
X,-,9667120,0.0,9.09495e-13,40,40,0,0,1,gene,T14B1.1,0,9667117,1.97943,7188,9674308,3,9667120,0,-3
X,-,9653049,0.0,3.8147e-06,18,18,0,0,0,gene,T14B1.2,0,9653048,0.0689447,11379,9664428,1,9653049,0,-1
X,-,9634958,0.00452489,0.0,221,220,1,1,3,gene,F34H10.3,0,9634958,1.06846,15974,9650932,0,9634958,0,0
X,-,9575815,0.0,2.1684e-19,62,62,0,0,0,gene,F49E2.4,0,9575799,0.180017,57402,9633217,16,9575799,16,0
X,-,9565912,0.0,3.55271e-15,48,48,0,0,0,gene,F49E2.1,0,9565912,0.166658,7989,9573901,0,9565912,0,0
X,-,9523147,0.0,0.03125,5,5,0,0,6,gene,C07B5.3,0,9523106,0.317922,13326,9536473,41,9523160,-13,-54
X,-,9460865,0.0,6.93889e-18,57,57,0,0,0,gene,ZK899.5,0,9460864,0.0807823,55443,9516308,1,9460865,0,-1
X,-,9451925,0.00483092,0.0,414,412,2,2,0,gene,ZK899.2,0,9451923,1.16278,3493,9455418,2,9451925,0,-2
X,-,9449359,0.2,0.0138855,15,12,3,1,2,gene,ZK899.7,0,9449357,0.0429749,797,9450156,2,9449330,29,27
X,-,9441502,0.00787402,7.46439e-37,127,126,1,1,2,gene,B0272.2,0,9441495,0.37353,6148,9447650,7,9441495,7,0
X,-,9441456,0.0,0.125,3,3,0,0,79,gene,B0272.2,0,9441446,0.37353,6194,9447650,10,9441495,-39,-49
X,-,9436824,0.0,4.59177e-41,134,134,0,0,0,gene,B0272.1,0,9436822,0.498886,3263,9440087,2,9436824,0,-2
X,-,9349819,0.0,1.12104e-44,146,146,0,0,1,gene,E01H11.3,0,9349803,1.11908,84564,9434383,16,9349821,-2,-18
X,-,9349810,0.0,1.05879e-22,73,73,0,0,1030,gene,E01H11.3,0,9349803,1.11908,84573,9434383,7,9349821,-11,-18
X,-,9347359,0.00347222,0.0,288,287,1,1,0,gene,T20B5.3,0,9347348,0.377403,1848,9349207,11,9347350,9,-2
X,-,9319111,0.0,0.03125,5,5,0,0,0,gene,F35G8.1,0,9319111,0.0603391,24153,9343264,0,9319111,0,0
X,-,9314422,0.0,1.86265e-09,29,29,0,0,0,gene,F35G8.2,0,9314419,0.0869486,927,9315349,3,9314621,-199,-202
X,-,9297863,0.0,0.0,260,260,0,0,22,gene,B0416.7,0,9297855,0.669245,12693,9310556,8,9297863,0,-8
X,-,9297575,0.0,0.5,1,1,0,0,2,gene,B0416.7,0,9297537,0.669245,12981,9310556,38,9297575,0,-38
X,-,9296553,0.0,2.01948e-28,92,92,0,0,0,gene,B0416.6,0,9296549,0.412856,317,9296870,4,9296553,0,-4
X,-,9270784,0.0125,0.0,640,632,8,7,1,gene,B0416.5,0,9270767,3.78627,2258,9273042,17,9270767,17,0
X,-,9264262,0.00999001,0.0,1001,991,10,8,1,gene,F18G5.6,0,9264255,1.52873,4298,9268560,7,9264262,0,-7
X,-,9232068,0.0,2.91038e-11,35,35,0,0,0,gene,C35B8.2,0,9232034,0.475421,1500,9233568,34,9232007,61,27
X,-,9224256,0.0,1.16415e-10,33,33,0,0,0,gene,C35B8.2,0,9224250,0.475421,9312,9233568,6,9224256,0,-6
X,-,9174443,0.0,2.22045e-16,52,52,0,0,1,gene,B0563.8,0,9174424,0.0854981,5551,9179994,19,9174424,19,0
X,-,9154248,0.0,2.91038e-11,35,35,0,0,0,gene,B0563.7,0,9154118,0.104856,12432,9166680,130,9154118,130,0
X,-,9021689,1.0,0.125,3,0,3,2,0,gene,T25B6.5,2,9021655,0.005973,167,9021856,34,9021655,34,0
X,-,8961105,0.0,0.00195312,9,9,0,0,0,gene,C48C5.3,0,8961102,0.0400629,45415,9006520,3,8961107,-2,-5
X,-,8951014,0.0,2.22045e-16,52,52,0,0,0,gene,D1073.1,0,8950929,0.0986028,6636,8957650,85,8950915,99,14
X,-,8919361,0.0034965,0.0,286,285,1,1,10,gene,D1009.4,0,8919330,1.31945,19872,8939233,31,8919361,0,-31
X,-,8874786,0.0,2.58494e-26,85,85,0,0,0,gene,C06E2.1,0,8874714,0.197059,42573,8917359,72,8874572,214,142
X,-,8869094,0.214286,0.0222168,14,11,3,1,1,gene,C06E2.7,0,8869068,0.0478234,3777,8872871,26,8869194,-100,-126
X,-,8857892,0.0,0.0,228,228,0,0,1,gene,C06E2.5,0,8857892,0.529193,5540,8863432,0,8857892,0,0
X,-,8853560,0.0,3.05176e-05,15,15,0,0,0,gene,C28G1.4,0,8853559,0.0620811,3419,8856979,1,8853559,1,0
X,-,8835653,0.00276243,0.0,362,361,1,1,0,gene,C28G1.3,0,8835650,0.359455,13342,8848995,3,8835653,0,-3
X,-,8828450,0.0131004,0.0,229,226,3,1,12,gene,C28G1.5,0,8828425,0.95181,1421,8829871,25,8828456,-6,-31
X,-,8824386,0.0,0.0,378,378,0,0,2,gene,R04E5.10,0,8824376,0.894289,2172,8826558,10,8824386,0,-10
X,-,8806049,0.003663,0.0,273,272,1,1,6,gene,R04E5.8,0,8806043,1.05594,1,8806050,6,8806049,0,-6
X,-,8742929,0.0,7.62939e-06,17,17,0,0,2,gene,M02D8.7,0,8742916,0.0196838,5437,8748366,13,8742996,-67,-80
X,-,8736952,0.0,4.03897e-28,91,91,0,0,1,gene,M02D8.3,0,8736945,0.285531,3761,8740713,7,8736954,-2,-9
X,-,8727156,0.0,0.015625,6,6,0,0,71,gene,EGAP4.1,0,8727123,0.513425,4057,8731213,33,8727345,-189,-222
X,-,8723489,0.00100351,0.0,1993,1991,2,2,5,gene,F53A9.10,0,8723481,11.365,3250,8726739,8,8723489,0,-8
X,-,8720701,0.00522648,0.0,574,571,3,2,3,gene,F53A9.9,0,8720697,0.695357,795,8721496,4,8720697,4,0
X,-,8718858,0.0,0.0,151,151,0,0,136,gene,F53A9.8,0,8718843,32.2143,1307,8720165,15,8718913,-55,-70
X,-,8718844,0.00182009,0.0,42855,42777,78,45,882,gene,F53A9.8,0,8718843,32.2143,1321,8720165,1,8718913,-69,-70
X,-,8716866,0.0,4.23516e-22,71,71,0,0,9,gene,F53A9.7,0,8716861,4.01266,1596,8718462,5,8716938,-72,-77
X,-,8713748,0.0,8.27181e-25,80,80,0,0,6,gene,F53A9.6,0,8713743,9.18206,2720,8716468,5,8713750,-2,-7
X,-,8643409,0.0,0.000488281,11,11,0,0,0,gene,F12D9.1,0,8643211,0.0396919,3136,8646545,198,8643211,198,0
X,-,8625175,0.0,0.00012207,13,13,0,0,1,gene,K01A12.3,0,8625150,0.0277619,14140,8639315,25,8625177,-2,-27
X,-,8548994,0.0,1.13687e-13,43,43,0,0,2,gene,D2021.4,0,8548924,0.15668,14230,8563224,70,8548912,82,12
X,-,8548916,0.0,0.5,1,1,0,0,8,gene,D2021.4,0,8548912,0.15668,14308,8563224,4,8548912,4,0
X,-,8545959,0.00619195,0.0,323,321,2,2,0,gene,C03G5.1,0,8545953,3.34085,406,8546365,6,8545959,0,-6
X,-,8515402,0.0,0.00390625,8,8,0,0,1,gene,H03E18.2,0,8515402,0.0500274,19208,8534610,0,8515402,0,0
X,-,8476114,0.0,0.0,271,271,0,0,2,gene,T01B10.4,0,8476114,0.934534,38013,8514127,0,8476114,0,0
X,-,8463276,0.0,1.73472e-18,59,59,0,0,21,gene,F16F9.4,0,8463268,0.374451,2492,8465768,8,8463268,8,0
X,-,8455578,0.0,4.76837e-07,21,21,0,0,0,gene,F16F9.2,0,8455578,0.259556,4181,8459759,0,8455578,0,0
X,-,8423669,0.00322165,0.0,3104,3094,10,6,7,gene,F08F1.8,1,8423647,3.95652,26650,8450319,22,8423669,0,-22
X,-,8421993,0.0127389,0.0,471,465,6,2,2,gene,F08F1.7,2,8421990,1.82549,391,8422384,3,8421993,0,-3
X,-,8418544,0.0,4.44089e-16,51,51,0,0,4,gene,F08F1.6,0,8418327,0.728709,42,8418586,217,8418389,155,-62
X,-,8418476,0.0,4.54747e-13,41,41,0,0,10,gene,F08F1.6,0,8418327,0.728709,110,8418586,149,8418389,87,-62
X,-,8416710,0.0,0.5,1,1,0,0,23,gene,F08F1.5,0,8416701,0.1494,650,8417360,9,8416857,-147,-156
X,-,8392520,0.00393701,0.0,254,253,1,1,0,gene,F41D9.3,0,8392519,1.04953,10964,8403484,1,8392519,1,0
X,-,8351017,0.0,0.5,1,1,0,0,1,gene,F55E10.7,0,8350786,0.19306,31627,8382644,231,8350998,19,-212
X,-,8350998,0.0,1.4013e-45,149,149,0,0,5,gene,F55E10.7,0,8350786,0.19306,31646,8382644,212,8350998,0,-212
X,-,8326390,0.0295567,0.0,203,197,6,5,0,gene,R09F10.8,0,8326387,0.687744,1108,8327498,3,8326390,0,-3
X,-,8307631,0.0,0.0,354,354,0,0,0,gene,R09F10.5,0,8307618,0.552047,5738,8313369,13,8307618,13,0
X,-,8302331,0.002331,0.0,429,428,1,0,1,gene,R09F10.4,0,8302313,1.54491,3829,8306160,18,8302320,11,-7
X,-,8299604,0.0,0.25,2,2,0,0,1,gene,R09F10.9,0,8299527,0.000671947,364,8299968,77,8299592,12,-65
X,-,8285157,0.00248447,0.0,1610,1606,4,4,0,gene,F13B9.8,0,8285140,1.46348,12938,8298095,17,8285157,0,-17
X,-,8270907,0.0,1.32349e-23,76,76,0,0,14,gene,F13B9.6,0,8270862,0.310045,12306,8283213,45,8270960,-53,-98
X,-,8261116,0.0,8.88178e-16,50,50,0,0,2,gene,M60.7,0,8261114,0.194984,1243,8262359,2,8261114,2,0
X,-,8236253,0.000781861,0.0,3837,3834,3,1,1,gene,M60.4,0,8236253,12.7319,6817,8243070,0,8236253,0,0
X,-,8232910,0.00188707,0.0,6889,6876,13,11,6,gene,M60.4,0,8232909,12.7319,2156,8235066,1,8232910,0,-1
X,-,8232833,0.0,0.03125,5,5,0,0,529,gene,M60.4,0,8232797,12.7319,2233,8235066,36,8232910,-77,-113
X,-,8231607,0.0,0.5,1,1,0,0,2,gene,K02A6.3,0,8231596,0.407907,586,8232193,11,8231607,0,-11
X,-,8224842,0.0,0.25,2,2,0,0,9,gene,K02A6.2,0,8224841,0.155562,3165,8228007,1,8224926,-84,-85
X,-,8210735,0.00273723,0.0,1096,1093,3,1,2,gene,C47D2.2,0,8210734,1.19286,7586,8218321,1,8211088,-353,-354
X,-,8203722,0.0,6.46235e-27,87,87,0,0,0,gene,C17H11.6,0,8203719,0.949,4970,8208692,3,8203719,3,0
X,-,8194702,0.0137931,2.34073e-40,145,143,2,2,3,gene,C17H11.6,0,8194653,0.949,8901,8203603,49,8194702,0,-49
X,-,8183539,0.0,0.000488281,11,11,0,0,0,gene,C17H11.5,0,8183477,0.0678334,1583,8185122,62,8183477,62,0
X,-,8163014,0.0,6.46235e-27,87,87,0,0,1,gene,F22F1.3,0,8163009,0.107487,18071,8181085,5,8163016,-2,-7
X,-,8136267,0.0,0.0,160,160,0,0,2,gene,C02B8.6,0,8136260,0.326649,1395,8137662,7,8136269,-2,-9
X,-,8098804,0.0,1.92593e-34,112,112,0,0,0,gene,K07E3.7,0,8098768,0.235084,21545,8120349,36,8098804,0,-36
X,-,8088515,0.00107143,0.0,2800,2797,3,0,5,gene,K07E3.8,0,8088502,2.12726,714,8089229,13,8088515,0,-13
X,-,8088507,0.0,0.5,1,1,0,0,1013,gene,K07E3.8,0,8088502,2.12726,722,8089229,5,8088515,-8,-13
X,-,8086491,0.0,0.0,577,577,0,0,0,gene,K07E3.3,0,8086490,1.91752,983,8087474,1,8086491,0,-1
X,-,8058167,0.0,0.00195312,9,9,0,0,1,gene,C18A11.7,0,8058152,9.78897,22651,8080818,15,8058160,7,-8
X,-,8052621,0.00162646,0.0,7378,7366,12,10,8,gene,C18A11.7,0,8052619,9.78897,28197,8080818,2,8052621,0,-2
X,-,7992752,0.0,3.23117e-27,88,88,0,0,5,gene,F45E1.7,0,7992751,0.701866,57663,8050415,1,7992752,0,-1
X,-,7982013,0.00129828,0.0,3081,3077,4,3,7,gene,F45E1.6,0,7981997,6.24076,6860,7988873,16,7982013,0,-16
X,-,7961666,0.00900901,4.27556e-32,111,110,1,1,2,gene,C14F5.5,1,7961655,1.06349,19659,7981325,11,7961655,11,0
X,-,7958246,0.271739,1.49934e-10,184,134,50,26,2,gene,C14F5.4,2,7958240,0.489633,1149,7959395,6,7958246,0,-6
X,-,7944652,0.0,0.0,155,155,0,0,0,gene,C14F5.3,0,7944515,1.48588,11488,7956140,137,7944502,150,13
X,-,7944500,0.0,0.5,1,1,0,0,129,gene,C14F5.3,0,7944485,1.48588,11640,7956140,15,7944485,15,0
X,-,7892337,0.0,0.000244141,12,12,0,0,0,gene,C39D10.5,0,7892334,0.0806363,3830,7896167,3,7892339,-2,-5
X,-,7880711,0.0,0.015625,6,6,0,0,5,gene,C39D10.8,0,7880617,0.879652,8956,7889667,94,7880617,94,0
X,-,7861441,0.0,0.125,3,3,0,0,0,gene,C54D2.5,0,7861380,0.142885,18273,7879714,61,7861249,192,131
X,-,7861249,0.0,2.27374e-13,42,42,0,0,0,gene,C54D2.5,0,7861205,0.142885,18465,7879714,44,7861249,0,-44
X,-,7809052,0.0,1.77636e-15,49,49,0,0,5,gene,R03G5.6,0,7809052,0.396033,17973,7827025,0,7809025,27,27
X,-,7809036,0.0,6.77626e-21,67,67,0,0,260,gene,R03G5.6,0,7809025,0.396033,17989,7827025,11,7809025,11,0
X,-,7799610,0.0,0.5,1,1,0,0,100,gene,R03G5.5,0,7799522,0.297676,6013,7805623,88,7799720,-110,-198
X,-,7798232,0.0136986,7.72918e-21,73,72,1,1,0,gene,ZK154.7,0,7798222,0.18479,663,7798895,10,7798227,5,-5
X,-,7793503,0.0,0.0,186,186,0,0,2,gene,ZK154.6,0,7793397,0.750871,1483,7794986,106,7793485,18,-88
X,-,7787875,0.00552486,0.0,181,180,1,1,4,gene,ZK154.5,0,7787865,0.330314,2244,7790119,10,7787875,0,-10
X,-,7782350,0.0078125,0.0,256,254,2,2,47,gene,ZK154.4,0,7782350,0.880362,780,7783130,0,7782378,-28,-28
X,-,7736211,0.0,3.63798e-12,38,38,0,0,0,gene,K09F5.5,0,7736088,0.0659137,20428,7756639,123,7736088,123,0
X,-,7707065,0.0,7.62939e-06,17,17,0,0,0,gene,C53C9.3,0,7707026,0.0781596,26198,7733263,39,7707026,39,0
X,-,7670700,0.0,3.8147e-06,18,18,0,0,0,gene,F27D9.7,0,7670672,0.0930626,5751,7676451,28,7670531,169,141
X,-,7664857,0.0,2.52435e-29,95,95,0,0,3,gene,F27D9.6,0,7664854,0.742731,854,7665711,3,7664854,3,0
X,-,7660926,0.00491228,0.0,1425,1418,7,7,11,gene,F27D9.5,0,7660918,5.07279,924,7661850,8,7660926,0,-8
X,-,7637115,0.0,0.0,340,340,0,0,0,gene,F26A10.2,0,7637098,0.790252,19220,7656335,17,7637028,87,70
X,-,7608094,0.0,0.0078125,7,7,0,0,4,gene,C44E12.3,0,7607980,0.180409,6997,7615091,114,7608078,16,-98
X,-,7569666,0.00300978,0.0,1329,1325,4,4,3,gene,F08C6.6,0,7569664,1.8129,245,7569911,2,7569666,0,-2
X,-,7559087,0.0,0.25,2,2,0,0,0,gene,PDB1.1,0,7559080,0.790367,9016,7568103,7,7559015,72,65
X,-,7558396,0.0,0.0625,4,4,0,0,0,gene,PDB1.1,0,7558395,0.790367,9707,7568103,1,7558395,1,0
X,-,7554371,0.0,2.06795e-25,82,82,0,0,1,gene,F46C8.8,0,7554364,0.846402,2365,7556736,7,7554371,0,-7
X,-,7540076,0.0,0.015625,6,6,0,0,0,gene,F46C8.7,0,7540074,0.0351522,11067,7551143,2,7540076,0,-2
X,-,7537737,0.0,0.0,690,690,0,0,1,gene,F46C8.6,0,7537733,2.36831,50,7537787,4,7537737,0,-4
X,-,7532695,0.0,3.55271e-15,48,48,0,0,0,gene,F46C8.5,0,7532677,0.202741,3663,7536358,18,7532677,18,0
X,-,7518104,0.0,0.5,1,1,0,0,1,gene,F48E3.8,0,7518086,0.150758,9670,7527774,18,7517639,465,447
X,-,7501287,1.0,0.5,1,0,1,0,0,gene,F48E3.3,0,7501268,1.36814,74,7501361,19,7500922,365,346
X,-,7500928,0.00308642,0.0,324,323,1,1,0,gene,F48E3.3,0,7500922,1.36814,433,7501361,6,7500922,6,0
X,-,7493056,0.0,0.125,3,3,0,0,0,gene,F48E3.2,0,7493031,0.0923087,635,7493691,25,7493066,-10,-35
X,-,7493044,0.25,0.25,4,3,1,1,12,gene,F48E3.2,0,7493031,0.0923087,647,7493691,13,7493066,-22,-35
X,-,7460494,0.00645161,0.0,310,308,2,2,44,gene,K08A8.2,0,7460456,1.46655,4639,7465133,38,7460494,0,-38
X,-,7459697,0.0,9.53674e-07,20,20,0,0,1,gene,K08A8.2,0,7459685,1.46655,5436,7465133,12,7459697,0,-12
X,-,7442523,0.00540541,0.0,370,368,2,1,1,gene,C01C10.3,0,7442521,0.858615,15705,7458228,2,7442523,0,-2
X,-,7437946,0.0,1.29247e-26,86,86,0,0,33,gene,C01C10.2,0,7437917,0.636927,1400,7439346,29,7437927,19,-10
X,-,7424854,0.0,5.68434e-14,44,44,0,0,0,gene,C10A4.8,0,7424828,0.115752,10697,7435551,26,7424828,26,0
X,-,7322359,0.0,0.0,194,194,0,0,0,gene,T08A9.13,0,7322354,0.174728,75147,7397506,5,7322354,5,0
X,-,7320300,0.00244141,0.0,20480,20430,50,33,143,gene,T08A9.9,0,7320299,72.3754,1636,7321936,1,7320300,0,-1
X,-,7318702,0.0,0.0,595,595,0,0,269,gene,T08A9.8,0,7318701,2.82531,1010,7319712,1,7318722,-20,-21
X,-,7315299,0.0022658,0.0,11475,11449,26,17,58,gene,T08A9.7,0,7315295,25.4316,642,7315941,4,7315299,0,-4
X,-,7305818,0.0,0.0625,4,4,0,0,1,gene,K03A1.5,0,7305769,1.37584,3693,7309511,49,7305517,301,252
X,-,7305517,0.00338983,0.0,885,882,3,2,4,gene,K03A1.5,0,7305516,1.37584,3994,7309511,1,7305517,0,-1
X,-,7296152,0.0,0.0625,4,4,0,0,1,gene,K03A1.4,0,7295996,0.153459,147,7296299,156,7296430,-278,-434
X,-,7280267,0.0163934,2.64545e-17,61,60,1,0,0,gene,T10A3.1,0,7280248,0.216704,6667,7286934,19,7280248,19,0
X,-,7260332,0.0172414,2.01228e-16,58,57,1,1,3,gene,F46H5.8,0,7260324,0.11213,7534,7267866,8,7260324,8,0
X,-,7256932,0.0,0.00012207,13,13,0,0,0,gene,F46H5.5,0,7256925,0.0433182,1153,7258085,7,7256925,7,0
X,-,7254551,0.0163934,2.64545e-17,61,60,1,1,20,gene,F46H5.4,0,7254551,0.416176,1161,7255712,0,7254553,-2,-2
X,-,7242744,0.0,0.0,437,437,0,0,96,gene,F46H5.7,0,7242739,2.22387,2276,7245020,5,7242744,0,-5
X,-,7238610,1.0,0.03125,5,0,5,2,0,gene,F46H5.3,0,7238610,35.0506,9,7238619,0,7238610,0,0
X,-,7232433,0.0,4.1359e-25,81,81,0,0,35,gene,F46H5.3,0,7232415,35.0506,6186,7238619,18,7232433,0,-18
X,-,7170574,0.0,3.23117e-27,88,88,0,0,0,gene,C54D1.6,0,7170565,0.310282,16728,7187302,9,7170574,0,-9
X,-,7155982,0.00502513,0.0,199,198,1,1,2,gene,C54D1.7,0,7155886,0.315135,9972,7165954,96,7156001,-19,-115
X,-,7151182,0.00609756,0.0,820,815,5,3,2,gene,C54D1.5,0,7151135,1.66889,2638,7153820,47,7151184,-2,-49
X,-,7116945,0.00462963,0.0,216,215,1,1,0,gene,C36B7.7,0,7116932,0.113802,23509,7140454,13,7116945,0,-13
X,-,7100287,0.0,0.0,165,165,0,0,1,gene,C36B7.6,0,7100286,0.895508,15864,7116151,1,7100287,0,-1
X,-,7096393,0.0,0.25,2,2,0,0,2,gene,C36B7.5,0,7096286,0.0833147,1009,7097402,107,7096286,107,0
X,-,7096354,0.0,0.00390625,8,8,0,0,6,gene,C36B7.5,0,7096286,0.0833147,1048,7097402,68,7096286,68,0
X,-,7063278,0.0102041,3.09233e-28,98,97,1,1,1,gene,B0403.3,0,7063273,0.221763,3011,7066289,5,7063278,0,-5
X,-,7036039,0.0,5.96046e-08,24,24,0,0,0,gene,R173.3,0,7036032,0.0998403,25046,7061085,7,7036036,3,-4
X,-,6956349,0.0,1.35525e-20,66,66,0,0,1,gene,C16E9.4,0,6956293,0.499135,38370,6994719,56,6956349,0,-56
X,-,6951468,0.0,0.0,194,194,0,0,0,gene,C16E9.4,0,6951451,0.499135,43251,6994719,17,6951468,0,-17
X,-,6949522,0.0,0.5,1,1,0,0,1,gene,C16E9.4,0,6949507,0.499135,45197,6994719,15,6949507,15,0
X,-,6932370,0.0,0.00195312,9,9,0,0,2,gene,F14B8.6,0,6932057,0.8945,11318,6943688,313,6932310,60,-253
X,-,6928625,0.0,4.65661e-10,31,31,0,0,30,gene,F14B8.5,0,6928600,0.759746,588,6929213,25,6928600,25,0
X,-,6928617,0.0,0.0,237,237,0,0,138,gene,F14B8.5,0,6928600,0.759746,596,6929213,17,6928600,17,0
X,-,6924589,0.714286,0.164062,7,2,5,2,7,gene,F14B8.7,0,6924571,0.152159,166,6924755,18,6924403,186,168
X,-,6924403,0.0,2.32831e-10,32,32,0,0,10,gene,F14B8.7,0,6924403,0.152159,352,6924755,0,6924403,0,0
X,-,6899887,0.0103627,0.0,193,191,2,2,4,gene,F14B8.4,0,6899884,0.667625,21710,6921597,3,6899900,-13,-16
X,-,6885156,0.0,3.05176e-05,15,15,0,0,1,gene,F41C6.7,0,6884945,0.0624479,13448,6898604,211,6885229,-73,-284
X,-,6877990,0.0,0.00390625,8,8,0,0,0,gene,F41C6.5,0,6877817,0.689091,2870,6880860,173,6877486,504,331
X,-,6877488,0.0030303,0.0,660,658,2,1,1,gene,F41C6.5,0,6877486,0.689091,3372,6880860,2,6877486,2,0
X,-,6865891,0.0,2.1684e-19,62,62,0,0,3,gene,C53B7.5,0,6865887,0.0956214,2691,6868582,4,6865891,0,-4
X,-,6840670,0.0,2.98023e-08,25,25,0,0,1,gene,F41B4.4,1,6840654,0.142654,20232,6860902,16,6840567,103,87
X,-,6836067,0.0808625,0.0,371,341,30,18,2,gene,F41B4.3,2,6836056,0.543183,264,6836331,11,6836208,-141,-152
X,-,6831855,0.0221239,0.0,226,221,5,1,0,gene,F41B4.2,0,6831846,0.791642,3582,6835437,9,6831855,0,-9
X,-,6825771,0.0,7.70372e-34,110,110,0,0,53,gene,F41B4.1,0,6825769,0.613312,5432,6831203,2,6825790,-19,-21
X,-,6823221,0.0,0.0,722,722,0,0,1,gene,M03A8.4,0,6823199,1.27599,625,6823846,22,6823221,0,-22
X,-,6789705,0.0,0.00390625,8,8,0,0,0,gene,H22K11.4,0,6789657,0.289975,1571,6791276,48,6789505,200,152
X,-,6789101,0.0,0.5,1,1,0,0,3,gene,H22K11.4,0,6789086,0.289975,2175,6791276,15,6789101,0,-15
X,-,6761691,0.0169492,1.02349e-16,59,58,1,1,0,gene,R03E9.3,0,6761649,0.285239,4233,6765924,42,6761691,0,-42
X,-,6729610,0.0,0.0,170,170,0,0,4,gene,K11G12.6,1,6729610,0.6587,339,6729949,0,6729610,0,0
X,-,6728859,0.0,0.00012207,13,13,0,0,5,gene,K11G12.6,1,6728840,0.6587,1090,6729949,19,6728859,0,-19
X,-,6725621,0.880395,0.0,811,97,714,356,0,gene,K11G12.5,2,6725613,1.94353,114,6725735,8,6725621,0,-8
X,-,6723019,0.471831,0.0534315,142,75,67,38,38,gene,K11G12.4,3,6722996,0.316825,428,6723447,23,6723019,0,-23
X,-,6690038,0.0,9.53674e-07,20,20,0,0,0,gene,F38B6.6,0,6690036,0.137504,5636,6695674,2,6690038,0,-2
X,-,6682832,0.0,0.125,3,3,0,0,0,gene,F38B6.8,0,6682737,0.000922947,1562,6684394,95,6682737,95,0
X,-,6640575,0.0,3.00927e-36,118,118,0,0,0,gene,C25B8.6,0,6640575,0.229438,21170,6661745,0,6640575,0,0
X,-,6635258,0.0,0.00195312,9,9,0,0,8,gene,C25B8.5,0,6635228,0.0292733,1258,6636516,30,6634990,268,238
X,-,6603160,0.0,3.72529e-09,28,28,0,0,5,gene,F23G4.1,0,6603153,0.0551989,14234,6617394,7,6603153,7,0
X,-,6598663,0.00664452,0.0,301,299,2,2,2,gene,T28B4.4,0,6598656,0.352679,2848,6601511,7,6598663,0,-7
X,-,6597074,0.00712251,0.0,702,697,5,5,5,gene,T28B4.3,0,6597072,3.64316,789,6597863,2,6597076,-2,-4
X,-,6569445,0.0,0.00012207,13,13,0,0,1,gene,T14E8.3,0,6569428,0.0760611,12512,6581957,17,6569445,0,-17
X,-,6562381,0.0,0.015625,6,6,0,0,2,gene,T14E8.4,0,6562321,0.105612,1793,6564174,60,6562226,155,95
X,-,6562373,0.0,0.25,2,2,0,0,20,gene,T14E8.4,0,6562321,0.105612,1801,6564174,52,6562226,147,95
X,-,6530101,0.0,1.57772e-30,99,99,0,0,0,gene,F22A3.5,0,6530040,0.167579,3344,6533445,61,6530103,-2,-63
X,-,6504568,0.0273973,2.7825e-19,73,71,2,2,0,gene,C15B12.7,1,6504568,0.681121,17995,6522563,0,6504568,0,0
X,-,6484825,0.0588235,0.0001297,17,16,1,0,0,gene,C15B12.5,0,6484765,0.0648477,11952,6496777,60,6484765,60,0
X,-,6448871,0.0,0.0,553,553,0,0,1504,gene,K10C2.4,0,6448863,3.53061,1040,6449911,8,6448871,0,-8
X,-,6416364,0.0322581,1.44355e-08,31,30,1,1,1,gene,T22E5.6,0,6416355,0.129548,3693,6420057,9,6416355,9,0
X,-,6410182,0.00258398,0.0,6579,6562,17,13,5,gene,T22E5.5,0,6410163,9.47168,3921,6414103,19,6410182,0,-19
X,-,6391547,0.0,0.25,2,2,0,0,0,gene,T22E5.7,0,6391546,0.0763935,16872,6408419,1,6391546,1,0
X,-,6377639,0.00211379,0.0,5677,5665,12,11,10,gene,C03B1.12,0,6377609,9.86561,1713,6379352,30,6377639,0,-30
X,-,6360714,0.0,6.31089e-30,97,97,0,0,0,gene,C03B1.14,0,6360714,0.15108,15614,6376328,0,6360702,12,12
X,-,6337999,0.0344828,5.735e-15,58,56,2,1,0,gene,C03B1.13,0,6337991,0.172048,8573,6346572,8,6337711,288,280
X,-,6235498,0.00361991,0.0,1105,1101,4,1,0,gene,C14F11.5,0,6235473,2.25892,2509,6238007,25,6235498,0,-25
X,-,6213869,0.0175439,0.0,171,168,3,2,0,gene,C14F11.2,1,6213866,0.650414,12219,6226088,3,6213869,0,-3
X,-,6207939,1.0,0.0625,4,0,4,1,2,gene,T13C5.6,1,6207918,0.458588,175,6208114,21,6207646,293,272
X,-,6206363,0.757282,5.55925e-08,103,25,78,37,21,gene,T13C5.8,2,6206363,None,101,6206464,0,6206363,0,0
X,-,6204704,0.179348,1.36286e-37,368,302,66,39,26,gene,T13C5.5,3,6204701,1.16374,284,6204988,3,6204704,0,-3
X,-,6160479,0.0,0.0,267,267,0,0,0,gene,C34H3.2,0,6160443,0.39986,31069,6191548,36,6160443,36,0
X,-,6150501,0.0,9.31323e-10,30,30,0,0,1,gene,C34H3.1,0,6150492,0.330798,8847,6159348,9,6150499,2,-7
X,-,6133165,0.0,0.0,196,196,0,0,7,gene,Y72A10A.1,0,6133128,0.485893,9219,6142384,37,6133128,37,0
X,-,6128233,0.00215482,0.0,6033,6020,13,10,26,gene,C15H9.9,0,6128233,5.57551,1260,6129493,0,6128233,0,0
X,-,6112876,0.015625,3.46945e-18,64,63,1,0,20,gene,C15H9.8,0,6112874,0.367316,14542,6127418,2,6112874,2,0
X,-,6109296,0.00459418,0.0,653,650,3,2,1,gene,C15H9.7,0,6109293,1.10343,1417,6110713,3,6109296,0,-3
X,-,6103355,0.0147059,2.30393e-19,68,67,1,1,1015,gene,C15H9.11,0,6103346,0.752689,3528,6106883,9,6103355,0,-9
X,-,6091743,0.0022231,0.0,12595,12567,28,22,6,gene,C15H9.6,0,6091721,22.0959,11096,6102839,22,6091743,0,-22
X,-,6065945,0.0,0.0,245,245,0,0,2,gene,C45B2.7,0,6065924,0.949318,23027,6088972,21,6065945,0,-21
X,-,6048566,0.00551876,0.0,906,901,5,4,6,gene,C09B8.7,0,6048556,0.995976,12142,6060708,10,6048556,10,0
X,-,6048316,0.0,0.0625,4,4,0,0,2,gene,C09B8.7,0,6048259,0.995976,12392,6060708,57,6048316,0,-57
X,-,6047534,0.0,0.125,3,3,0,0,0,gene,C09B8.7,0,6047531,0.995976,13174,6060708,3,6047534,0,-3
X,-,6039194,0.00656234,0.0,1981,1968,13,8,20,gene,C09B8.6,0,6039190,5.85678,5072,6044266,4,6039194,0,-4
X,-,6037652,0.0,3.05176e-05,15,15,0,0,11,gene,C09B8.6,0,6037410,5.85678,6614,6044266,242,6037652,0,-242
X,-,6035732,0.0,0.0,242,242,0,0,2,gene,C09B8.6,0,6035718,5.85678,8534,6044266,14,6035732,0,-14
X,-,6019894,0.0,1.20371e-35,116,116,0,0,7,gene,C09B8.4,0,6019891,0.2906,930,6020824,3,6019894,0,-3
X,-,6001490,0.0,0.0,1376,1376,0,0,1,gene,F22F4.4,0,6001486,1.17778,5548,6007038,4,6001490,0,-4
X,-,5977796,0.00652742,0.0,766,761,5,3,0,gene,R07E4.6,0,5977782,4.63824,14317,5992113,14,5977788,8,-6
X,-,5974241,0.0,0.0,680,680,0,0,0,gene,R07E4.6,0,5974224,4.63824,17872,5992113,17,5974219,22,5
X,-,5953130,0.0,0.0,257,257,0,0,0,gene,R07E4.5,1,5953128,0.317693,17471,5970601,2,5953132,-2,-4
X,-,5948827,0.586957,0.020805,92,38,54,32,1,gene,R07E4.4,2,5948820,0.361613,656,5949483,7,5948827,0,-7
X,-,5942005,0.0,0.0,174,174,0,0,0,gene,C46F4.2,0,5941997,0.904128,3770,5945775,8,5942005,0,-8
X,-,5917335,0.037037,2.01166e-07,27,26,1,1,8,gene,Y23B4A.1,0,5917335,0.0271509,20188,5937523,0,5917562,-227,-227
X,-,5853365,0.0,3.8147e-06,18,18,0,0,0,gene,W06B11.4,0,5853359,0.330455,62702,5916067,6,5853365,0,-6
X,-,5834763,0.0,0.0,151,151,0,0,9,gene,F13D11.4,0,5834729,0.748813,3230,5837993,34,5834763,0,-34
X,-,5805880,0.0,0.0,263,263,0,0,15,gene,F13D11.3,0,5805866,0.65247,25999,5831879,14,5805880,0,-14
X,-,5798748,0.00355872,0.0,281,280,1,0,1,gene,F46G11.4,0,5798738,0.683919,5589,5804337,10,5798733,15,5
X,-,5780680,0.00100503,0.0,995,994,1,1,30,gene,C54H2.5,0,5780670,4.84882,16591,5797271,10,5780680,0,-10
X,-,5763350,0.0,0.0,259,259,0,0,2,gene,C54H2.3,0,5763320,0.467107,2869,5766219,30,5763334,16,-14
X,-,5743265,0.0,2.32831e-10,32,32,0,0,1,gene,C41G11.4,0,5743260,0.107976,16973,5760238,5,5743265,0,-5
X,-,5728614,0.0,1.54074e-33,109,109,0,0,2,gene,C41G11.3,0,5728595,0.266333,10104,5738718,19,5728614,0,-19
X,-,5710694,0.0,0.5,1,1,0,0,0,gene,W01C8.6,0,5710543,0.110547,6802,5717496,151,5710543,151,0
X,-,5710583,0.0,0.0625,4,4,0,0,0,gene,W01C8.6,0,5710543,0.110547,6913,5717496,40,5710543,40,0
X,-,5710577,0.0,0.03125,5,5,0,0,0,gene,W01C8.6,0,5710543,0.110547,6919,5717496,34,5710543,34,0
X,-,5697266,0.0,0.0,283,283,0,0,1,gene,W01C8.5,0,5697257,1.14973,8592,5705858,9,5697266,0,-9
X,-,5680183,0.926471,3.53183e-14,68,5,63,28,1,gene,W01C8.3,2,5680183,0.432404,103,5680286,0,5680183,0,0
X,-,5644905,0.0,0.00390625,8,8,0,0,0,gene,T22B7.5,0,5644898,0.0164358,6922,5651827,7,5644898,7,0
X,-,5641367,0.0,3.63798e-12,38,38,0,0,3,gene,T22B7.4,0,5641321,0.238507,1456,5642823,46,5641391,-24,-70
X,-,5611206,0.0,3.38813e-21,68,68,0,0,0,gene,F14D12.6,0,5611199,0.0578852,27332,5638538,7,5611208,-2,-9
X,-,5599289,0.0,4.76837e-07,21,21,0,0,5,gene,F14D12.5,0,5599250,0.190306,9791,5609080,39,5599289,0,-39
X,-,5538474,0.0,4.65661e-10,31,31,0,0,0,gene,C54G7.3,0,5538421,0.345247,7112,5545586,53,5538474,0,-53
X,-,5522780,0.0,7.88861e-31,100,100,0,0,0,gene,C54G7.2,0,5522772,0.968658,2355,5525135,8,5522780,0,-8
X,-,5517121,0.00244955,0.0,8573,8552,21,18,3,gene,T23F2.5,0,5517101,8.27559,2770,5519891,20,5517117,4,-16
X,-,5515039,0.0,0.0,892,892,0,0,0,gene,T23F2.4,0,5515009,1.8612,1630,5516669,30,5515009,30,0
X,-,5512288,0.00137606,0.0,5087,5080,7,2,83,gene,T23F2.3,0,5512265,7.57186,2403,5514691,23,5512288,0,-23
X,-,5505212,0.0,0.0,151,151,0,0,0,gene,T23F2.2,0,5505152,0.224612,6390,5511602,60,5505212,0,-60
X,-,5411715,0.0,2.84217e-14,45,45,0,0,0,gene,C41A3.2,1,5411688,0.0891715,38127,5449842,27,5411688,27,0
X,-,5406408,1.0,3.05176e-05,15,0,15,8,0,gene,C03F11.4,2,5406389,0.124411,123,5406531,19,5406408,0,-19
X,-,5400549,0.001221,0.0,819,818,1,1,30,gene,C03F11.3,0,5400535,1.08587,871,5401420,14,5400549,0,-14
X,-,5397060,0.0,0.00390625,8,8,0,0,4,gene,C03F11.2,0,5396981,0.0698633,571,5397631,79,5396893,167,88
X,-,5363757,0.0,0.125,3,3,0,0,0,gene,F35C8.7,0,5363728,0.444524,8355,5372112,29,5363757,0,-29
X,-,5359912,0.0,0.0,439,439,0,0,0,gene,F35C8.7,0,5359899,0.444524,12200,5372112,13,5359912,0,-13
X,-,5354037,0.0034459,0.0,1451,1446,5,4,19,gene,F35C8.6,0,5354019,3.86018,1573,5355610,18,5354109,-72,-90
X,-,5335433,0.0,0.0,225,225,0,0,0,gene,C26B9.6,0,5335396,0.239769,17589,5353022,37,5335396,37,0
X,-,5298005,0.00574713,0.0,348,346,2,2,0,gene,F32A6.4,0,5297991,0.645132,9449,5307454,14,5297991,14,0
X,-,5275252,0.0,3.63798e-12,38,38,0,0,6,gene,Y34B4A.8,0,5275247,0.351521,14434,5289686,5,5275247,5,0
X,-,5243371,0.00862069,0.0,232,230,2,1,2,gene,H28G03.6,0,5243354,0.200381,28402,5271773,17,5243459,-88,-105
X,-,5171149,0.0,3.72529e-09,28,28,0,0,0,gene,T03G11.10,0,5171129,0.0495289,6336,5177485,20,5171048,101,81
X,-,5159628,0.0,2.8026e-45,148,148,0,0,4,gene,C31H2.4,0,5159628,0.1844,9063,5168691,0,5159628,0,0
X,-,5116845,0.0,0.00195312,9,9,0,0,0,gene,C42D8.8,0,5116831,8.39563,31977,5148822,14,5116833,12,-2
X,-,5116833,0.00455581,0.0,1756,1748,8,6,30,gene,C42D8.8,0,5116831,8.39563,31989,5148822,2,5116833,0,-2
X,-,5107013,0.0,0.5,1,1,0,0,0,gene,C42D8.9,0,5107004,0.0123982,5375,5112388,9,5107004,9,0
X,-,5107007,0.0,0.000244141,12,12,0,0,0,gene,C42D8.9,0,5107004,0.0123982,5381,5112388,3,5107004,3,0
X,-,5097034,0.0,0.0,739,739,0,0,0,gene,C42D8.5,0,5097034,2.01905,9185,5106219,0,5097034,0,0
X,-,5081595,0.0,0.5,1,1,0,0,0,gene,C42D8.4,0,5081594,0.0206794,10819,5092414,1,5081590,5,4
X,-,5037740,0.0114943,5.62224e-25,87,86,1,0,1,gene,ZC449.5,0,5037675,0.793778,20592,5058332,65,5037740,0,-65
X,-,5029374,0.0,8.07794e-28,90,90,0,0,5,gene,ZC449.4,0,5029365,0.551624,5611,5034985,9,5029535,-161,-170
X,-,4997976,0.0,3.72529e-09,28,28,0,0,2,gene,ZC8.6,0,4997973,0.379237,30155,5028131,3,4997565,411,408
X,-,4997572,0.0,3.46945e-18,58,58,0,0,0,gene,ZC8.6,0,4997546,0.379237,30559,5028131,26,4997565,7,-19
X,-,4997565,0.0,0.0,186,186,0,0,20,gene,ZC8.6,0,4997546,0.379237,30566,5028131,19,4997565,0,-19
X,-,4970878,0.0311332,0.0,1606,1556,50,26,1,gene,M03F4.7,0,4970862,8.19805,1659,4972537,16,4970862,16,0
X,-,4969483,1.0,0.25,2,0,2,1,1,gene,M03F4.6,0,4969468,0.590517,16,4969499,15,4969326,157,142
X,-,4929724,0.0,9.09495e-13,40,40,0,0,0,gene,K05B2.5,0,4929718,0.971434,32961,4962685,6,4929718,6,0
X,-,4926899,0.00361011,0.0,277,276,1,0,13,gene,K05B2.5,0,4926810,0.971434,35786,4962685,89,4926899,0,-89
X,-,4920953,0.0,7.10543e-15,47,47,0,0,3,gene,K05B2.4,0,4920946,0.0938123,356,4921309,7,4920946,7,0
X,-,4915961,0.0,0.0078125,7,7,0,0,1,gene,K05B2.3,0,4915956,1.38379,3025,4918986,5,4915946,15,10
X,-,4915946,0.000661376,0.0,3024,3022,2,1,22,gene,K05B2.3,0,4915943,1.38379,3040,4918986,3,4915946,0,-3
X,-,4898131,0.0,1.61559e-27,89,89,0,0,1,gene,T07F12.4,0,4898131,0.406602,14144,4912275,0,4898121,10,10
X,-,4871027,0.0120482,8.582e-24,83,82,1,1,1,gene,F39C12.3,0,4870990,0.799425,25543,4896570,37,4871027,0,-37
X,-,4860004,0.0,0.000976562,10,10,0,0,9,gene,F39C12.2,0,4860004,0.246041,6645,4866649,0,4860004,0,0
X,-,4853043,0.0,1.19209e-07,23,23,0,0,13,gene,F39C12.1,0,4853033,0.261536,991,4854034,10,4853033,10,0
X,-,4811504,0.00793651,1.48112e-36,126,125,1,0,1,gene,R08E3.4,0,4811493,0.660854,23380,4834884,11,4811504,0,-11
X,-,4799622,0.0,0.0625,4,4,0,0,1,gene,F43C9.4,0,4799611,0.332356,6336,4805958,11,4799614,8,-3
X,-,4799614,0.0,2.64698e-23,75,75,0,0,9,gene,F43C9.4,0,4799611,0.332356,6344,4805958,3,4799614,0,-3
X,-,4769953,0.142857,0.0546875,7,6,1,1,0,gene,C39E6.6,0,4769942,0.0248852,7525,4777478,11,4769953,0,-11
X,-,4761567,0.0,2.38419e-07,22,22,0,0,9,gene,C39E6.4,0,4761565,0.211925,5553,4767120,2,4761580,-13,-15
X,-,4749051,0.00943396,1.30655e-30,106,105,1,1,4,gene,C39E6.1,0,4749050,0.313591,5595,4754646,1,4749051,0,-1
X,-,4727449,0.0,0.000976562,10,10,0,0,2,gene,F55D10.5,0,4727304,0.0414568,11482,4738931,145,4727449,0,-145
X,-,4726882,0.0,0.125,3,3,0,0,2,gene,F55D10.5,0,4726878,0.0414568,12049,4738931,4,4726839,43,39
X,-,4720616,0.0,1.52588e-05,16,16,0,0,1,gene,F55D10.4,0,4720612,0.0853223,2266,4722882,4,4720609,7,3
X,-,4711711,0.00371747,0.0,269,268,1,1,0,gene,K02G10.8,0,4711707,1.16979,4571,4716282,4,4711712,-1,-5
X,-,4704939,0.00704225,0.0,284,282,2,1,0,gene,K02G10.7,0,4704937,1.08791,4798,4709737,2,4704937,2,0
X,-,4699431,0.00884956,0.0,565,560,5,4,5,gene,K02G10.6,0,4699429,1.69395,3113,4702544,2,4699431,0,-2
X,-,4678093,0.0,1.11022e-16,53,53,0,0,0,gene,K02G10.4,0,4678037,3.17776,2858,4680951,56,4678037,56,0
X,-,4660289,0.0246914,1.34003e-21,81,79,2,1,0,gene,F16H11.5,0,4660269,0.568536,17032,4677321,20,4660289,0,-20
X,-,4654128,0.111111,0.0175781,9,8,1,1,0,gene,F16H11.4,0,4654126,0.0179466,2275,4656403,2,4654128,0,-2
X,-,4649168,0.0,0.0,295,295,0,0,2,gene,F16H11.3,0,4649165,0.131508,3949,4653117,3,4649165,3,0
X,-,4605899,0.0031746,0.0,315,314,1,1,0,gene,T13H2.5,0,4605867,0.819841,4988,4610887,32,4605867,32,0
X,-,4521019,0.00401606,0.0,249,248,1,0,1,gene,C07A12.7,0,4521018,1.23037,3443,4524462,1,4521019,0,-1
X,-,4519994,0.0,0.125,3,3,0,0,1,gene,C07A12.7,0,4519982,1.23037,4468,4524462,12,4519994,0,-12
X,-,4518655,0.0,0.5,1,1,0,0,4,gene,C07A12.7,0,4518451,1.23037,667,4519322,204,4518655,0,-204
X,-,4504360,0.00943396,1.30655e-30,106,105,1,1,4,gene,F46H6.2,0,4504222,1.37546,13358,4517718,138,4504360,0,-138
X,-,4497341,0.0,0.0,410,410,0,0,7,gene,F46H6.2,0,4497211,1.37546,20377,4517718,130,4497341,0,-130
X,-,4492178,0.0,8.67362e-19,60,60,0,0,1,gene,F46H6.5,0,4492176,0.141943,2710,4494888,2,4492180,-2,-4
X,-,4480063,0.0,0.00195312,9,9,0,0,25,gene,F02E8.6,0,4480060,0.286907,11538,4491601,3,4480089,-26,-29
X,-,4462434,0.0178571,1.19716e-30,112,110,2,1,1,gene,F02E8.5,0,4462429,0.346434,9788,4472222,5,4462582,-148,-153
X,-,4434475,0.0,1.90735e-06,19,19,0,0,1,gene,F15A8.6,0,4434475,0.221002,7363,4441838,0,4434475,0,0
X,-,4416050,0.0,8.88178e-16,50,50,0,0,0,gene,F15A8.5,0,4416043,0.127115,14788,4430838,7,4416043,7,0
X,-,4383339,0.0,1.12104e-44,146,146,0,0,0,gene,R160.7,0,4383331,0.76568,27951,4411290,8,4383339,0,-8
X,-,4370827,0.625,0.21875,8,3,5,5,1,gene,R160.5,2,4370827,0.00787433,1116,4371943,0,4370827,0,0
X,-,4368864,1.0,2.38419e-07,22,0,22,10,0,gene,R160.4,3,4368838,0.0355148,1121,4369985,26,4368823,41,15
X,-,4366298,0.0,1.19209e-07,23,23,0,0,0,gene,R160.3,0,4366291,0.0840269,784,4367082,7,4366291,7,0
X,-,4364926,0.0,0.0625,4,4,0,0,7,gene,F14H12.8,0,4364883,0.0377224,367,4365293,43,4364617,309,266
X,-,4336018,0.142857,0.0546875,7,6,1,1,0,gene,C24A8.4,0,4336008,0,20987,4357005,10,4336008,10,0
X,-,4332394,0.0,0.5,1,1,0,0,2,gene,C24A8.6,0,4332379,0,720,4333114,15,4332379,15,0
X,-,4328890,1.0,0.125,3,0,3,1,0,gene,C24A8.5,0,4328847,0.0126958,985,4329875,43,4328890,0,-43
X,-,4294324,0.0,1.32349e-23,76,76,0,0,1,gene,C52B9.7,0,4294317,0.331056,3510,4297834,7,4294324,0,-7
X,-,4279361,0.0,0.25,2,2,0,0,3,gene,C52B9.6,0,4279357,0.0571615,12088,4291449,4,4279186,175,171
X,-,4247169,0.0,1.54074e-33,109,109,0,0,166,gene,F48D6.4,0,4247108,7.97276,23974,4271143,61,4247159,10,-51
X,-,4247137,0.0,2.71051e-20,65,65,0,0,16994,gene,F48D6.4,0,4247108,7.97276,24006,4271143,29,4247157,-20,-49
X,-,4235820,0.0769231,0.00158691,13,12,1,1,0,gene,W01H2.3,0,4235786,0.121628,4132,4239952,34,4235820,0,-34
X,-,4231366,0.0,6.10352e-05,14,14,0,0,4,gene,W01H2.3,0,4231346,0.121628,8586,4239952,20,4231346,20,0
X,-,4231184,0.0,0.0625,4,4,0,0,0,gene,W01H2.3,0,4231181,0.121628,8768,4239952,3,4231184,0,-3
X,-,4217264,0.0,0.0,195,195,0,0,4,gene,F20B6.8,0,4217033,2.42945,989,4218253,231,4217264,0,-231
X,-,4214535,0.0,1.73472e-18,59,59,0,0,0,gene,F20B6.8,0,4214480,2.42945,3718,4218253,55,4214535,0,-55
X,-,4207459,0.0,0.000488281,11,11,0,0,0,gene,F20B6.9,0,4207391,0.0236477,3088,4210547,68,4207459,0,-68
X,-,4199903,0.0,0.5,1,1,0,0,0,gene,F20B6.5,0,4199865,0.00354405,1987,4201890,38,4199903,0,-38
X,-,4194759,0.0,5.96046e-08,24,24,0,0,1,gene,F20B6.4,0,4194759,0.0898484,4049,4198808,0,4194759,0,0
X,-,4186730,0.0,2.32831e-10,32,32,0,0,0,gene,F20B6.3,0,4186720,0.0972514,7263,4193993,10,4186421,309,299
X,-,4153417,0.0,0.0,320,320,0,0,0,gene,ZK470.5,0,4153393,1.642,22623,4176040,24,4153417,0,-24
X,-,4151204,0.0,0.5,1,1,0,0,2,gene,ZK470.5,0,4151010,1.642,24836,4176040,194,4150731,473,279
X,-,4150731,0.00806452,5.83045e-36,124,123,1,0,7,gene,ZK470.5,0,4150590,1.642,25309,4176040,141,4150731,0,-141
X,-,4128418,0.0,0.000976562,10,10,0,0,1,gene,F09F9.4,0,4128401,0.202801,11072,4139490,17,4128405,13,-4
X,-,4121005,0.0,0.015625,6,6,0,0,0,gene,F09F9.3,0,4120990,0.0358375,599,4121604,15,4120990,15,0
X,-,4104507,0.0,0.015625,6,6,0,0,0,gene,R02E4.1,0,4104495,0.0108256,5909,4110416,12,4104495,12,0
X,-,4102092,0.00542495,0.0,2765,2750,15,11,56,gene,R02E4.3,0,4102084,0.69408,1327,4103419,8,4102094,-2,-10
X,-,4071468,0.0,5.82077e-11,34,34,0,0,1,gene,T06F4.1,0,4071424,0.370137,7841,4079309,44,4071467,1,-43
X,-,4061294,0.0,7.62939e-06,17,17,0,0,5,gene,T06F4.1,0,4061278,0.370137,18015,4079309,16,4061268,26,10
X,-,4008952,0.00591716,0.0,507,504,3,3,2,gene,R02E12.6,0,4008949,1.90464,47855,4056807,3,4008952,0,-3
X,-,3973612,0.015625,3.46945e-18,64,63,1,1,1,gene,C16B8.4,0,3973600,0.296232,34421,4008033,12,3973612,0,-12
X,-,3968612,0.0,0.0,345,345,0,0,24,gene,C16B8.3,0,3968612,6.05491,1754,3970366,0,3968615,-3,-3
X,-,3943291,0.0,0.0,509,509,0,0,0,gene,T19D2.2,0,3943235,1.49451,18518,3961809,56,3943291,0,-56
X,-,3942355,0.0,0.0625,4,4,0,0,3,gene,T19D2.2,0,3942194,1.49451,19454,3961809,161,3942355,0,-161
X,-,3895884,0.0,0.5,1,1,0,0,1,gene,F47F2.3,0,3895880,0.0195954,13920,3909804,4,3895657,227,223
X,-,3873526,0.0,0.0625,4,4,0,0,0,gene,ZC64.4,0,3873275,0.102343,20447,3893973,251,3873275,251,0
X,-,3857777,0.0163934,2.64545e-17,61,60,1,1,2,gene,ZC64.3,0,3857734,0.524342,11613,3869390,43,3857777,0,-43
X,-,3842428,0.00274977,0.0,2182,2176,6,3,149,gene,ZC64.2,0,3842427,4.89136,919,3843347,1,3842428,0,-1
X,-,3826943,0.0,0.0,286,286,0,0,0,gene,K03C7.2,0,3826895,2.1127,13903,3840846,48,3826943,0,-48
X,-,3820550,0.00475059,0.0,421,419,2,1,1,gene,K03C7.2,0,3820550,2.1127,20296,3840846,0,3820550,0,0
X,-,3819610,0.0,0.5,1,1,0,0,2,gene,K03C7.2,0,3819566,2.1127,21236,3840846,44,3819610,0,-44
X,-,3818468,0.0,0.00195312,9,9,0,0,0,gene,K03C7.2,0,3818375,2.1127,22378,3840846,93,3818468,0,-93
X,-,3802753,0.0125786,1.68156e-44,159,157,2,1,0,gene,F35A5.8,0,3802736,0.452584,14074,3816827,17,3802736,17,0
X,-,3792799,0.0,1.52588e-05,16,16,0,0,2,gene,F35A5.4,0,3792790,0.171146,1095,3793894,9,3792799,0,-9
X,-,3781104,0.0,0.25,2,2,0,0,3,gene,F47B7.7,0,3781054,0.410557,8624,3789728,50,3781054,50,0
X,-,3770654,0.0,0.015625,6,6,0,0,0,gene,F47B7.6,0,3770627,0.00483947,7631,3778285,27,3770627,27,0
X,-,3742259,0.0,3.05176e-05,15,15,0,0,51,gene,T14G12.4,0,3742240,0.18626500000000001,14690,3756949,19,3742238,21,2
X,-,3741374,0.0,3.8147e-06,18,18,0,0,0,gene,T14G12.4,0,3741333,0.18626500000000001,15575,3756949,41,3741374,0,-41
X,-,3693225,0.0,6.31089e-30,97,97,0,0,1,gene,C02F12.8,0,3693220,0.19457,38650,3731875,5,3693225,0,-5
X,-,3689192,0.0,0.0,193,193,0,0,0,gene,C02F12.7,0,3689131,0.601602,974,3690166,61,3689194,-2,-63
X,-,3678544,0.0,5.73972e-42,137,137,0,0,1,gene,C02F12.4,0,3678541,0.535047,5653,3684197,3,3678542,2,-1
X,-,3650137,0.00714286,1.00445e-40,140,139,1,1,1,gene,R11G1.4,0,3650122,0.913398,17950,3668087,15,3650137,0,-15
X,-,3644493,0.0227273,1.23689e-23,88,86,2,1,1,gene,R11G1.6,0,3644470,0.661926,1812,3646305,23,3644493,0,-23
X,-,3633739,0.0119048,4.3427e-24,84,83,1,1,0,gene,R11G1.3,0,3633737,0.111562,5417,3639156,2,3633734,5,3
X,-,3617353,0.0,4.76837e-07,21,21,0,0,0,gene,C18B2.6,0,3617322,0.0320985,14992,3632345,31,3617365,-12,-43
X,-,3611079,0.00160256,0.0,2496,2492,4,4,3,gene,C18B2.5,0,3611077,3.16861,2299,3613378,2,3611079,0,-2
X,-,3605728,0.00167504,0.0,1791,1788,3,0,12,gene,C18B2.4,0,3605721,2.43923,992,3606720,7,3605728,0,-7
X,-,3600444,0.00429185,0.0,233,232,1,1,20,gene,T27A10.7,0,3600442,0.604934,3889,3604333,2,3600444,0,-2
X,-,3596340,0.0,3.55271e-15,48,48,0,0,233,gene,T27A10.6,0,3596338,0.716557,923,3597263,2,3596340,0,-2
X,-,3573563,0.0,0.5,1,1,0,0,1,gene,T27A10.5,0,3573549,0.000723263,15281,3588844,14,3573549,14,0
X,-,3506406,0.0,2.06795e-25,82,82,0,0,1,gene,C12D12.5,0,3506352,0.300503,5503,3511909,54,3506352,54,0
X,-,3465912,0.0,0.0,469,469,0,0,1,gene,ZK377.2,0,3465872,1.09033,39325,3505237,40,3465912,0,-40
X,-,3430107,0.015625,3.46945e-18,64,63,1,1,0,gene,ZK813.4,0,3430104,0.363363,18622,3448729,3,3430107,0,-3
X,-,3411602,0.0,0.0,1016,1016,0,0,2,gene,C04F6.4,0,3411601,1.03935,1260,3412862,1,3411602,0,-1
X,-,3400004,0.00183936,0.0,1631,1628,3,3,2,gene,C04F6.3,0,3400003,4.57586,4361,3404365,1,3400004,0,-1
X,-,3385449,0.0,1.65436e-24,79,79,0,0,16,gene,ZK563.6,0,3385448,0.151887,12151,3397600,1,3385448,1,0
X,-,3378886,0.00757576,2.42446e-38,132,131,1,1,3,gene,ZK563.5,0,3378876,0.459166,3969,3382855,10,3378886,0,-10
X,-,3374728,0.0,1.11022e-16,53,53,0,0,1,gene,ZK563.4,0,3374706,0.395757,2123,3376851,22,3374656,72,50
X,-,3362481,0.0,0.5,1,1,0,0,3,gene,ZK816.5,0,3362428,0.0290033,10745,3373226,53,3362481,0,-53
X,-,3280219,0.0,5.96046e-08,24,24,0,0,0,gene,K09C4.10,0,3280188,0.142631,44460,3324679,31,3280188,31,0
X,-,3270841,0.0,0.0078125,7,7,0,0,14,gene,K09C4.8,0,3270809,0.0631384,499,3271340,32,3270852,-11,-43
X,-,3250514,0.0,3.38813e-21,68,68,0,0,1,gene,F40F4.8,0,3250487,0.153286,16772,3267286,27,3250481,33,6
X,-,3245766,0.0,0.0,515,515,0,0,2,gene,F40F4.7,0,3245756,1.05835,1270,3247036,10,3245766,0,-10
X,-,3243615,0.00251256,0.0,1194,1191,3,3,19,gene,F40F4.6,0,3243613,5.10087,261,3243876,2,3243613,2,0
X,-,3235397,0.00973236,0.0,411,407,4,2,1,gene,F28B4.3,0,3235395,1.71377,347,3235744,2,3235397,0,-2
X,-,3220356,0.0,2.06795e-25,82,82,0,0,0,gene,F28B4.2,0,3220353,0.522648,7134,3227490,3,3220358,-2,-5
X,-,3199586,0.0,0.0625,4,4,0,0,1,gene,F56E3.4,0,3199280,0.0744949,3881,3203467,306,3199312,274,-32
X,-,3199572,0.0,0.5,1,1,0,0,29,gene,F56E3.4,0,3199280,0.0744949,3895,3203467,292,3199312,260,-32
X,-,3178686,0.0,1.46937e-39,129,129,0,0,4,gene,F56E3.3,0,3178686,0.529046,17406,3196092,0,3178693,-7,-7
X,-,3170477,0.0,0.125,3,3,0,0,1,gene,C15C7.6,0,3170467,0.0973125,932,3171409,10,3170499,-22,-32
X,-,3152452,0.00204394,0.0,1957,1953,4,2,2,gene,C15C7.5,0,3152443,5.62803,15075,3167527,9,3152452,0,-9
X,-,3127064,0.00675676,0.0,296,294,2,2,0,gene,K10B3.10,0,3127052,2.83693,24071,3151135,12,3127064,0,-12
X,-,3115584,0.0,0.5,1,1,0,0,5,gene,K10B3.9,1,3115556,1.58339,1848,3117432,28,3115580,4,-24
X,-,3115569,0.0,0.0,232,232,0,0,13,gene,K10B3.9,1,3115556,1.58339,1863,3117432,13,3115569,0,-13
X,-,3114680,0.0695612,0.0,6426,5979,447,202,45,gene,K10B3.8,2,3114678,1.58614,1,3114681,2,3114680,0,-2
X,-,3113332,0.880866,0.0,6371,759,5612,2471,6,gene,K10B3.7,3,3113312,12.1217,97,3113429,20,3113333,-1,-21
X,-,3102165,0.0194805,2.61384e-41,154,151,3,2,8,gene,F52E4.8,2,3102150,0.646599,1065,3103230,15,3102223,-58,-73
X,-,3099834,0.103175,2.00701e-21,126,113,13,6,1,gene,F52E4.7,3,3099828,0.344721,249,3100083,6,3099828,6,0
X,-,3099786,0.0,0.25,2,2,0,0,88,gene,F52E4.7,3,3099779,0.344721,297,3100083,7,3099828,-42,-49
X,-,3087328,0.00746269,6.15298e-39,134,133,1,1,0,gene,F52E4.5,0,3087322,0.323098,5055,3092383,6,3087330,-2,-8
X,-,3059453,0.0,0.25,2,2,0,0,0,gene,C33D12.6,0,3059376,0.0326418,9188,3068641,77,3059376,77,0
X,-,3059388,0.0666667,0.000457764,15,14,1,1,4,gene,C33D12.6,0,3059376,0.0326418,9253,3068641,12,3059376,12,0
X,-,3045836,0.0,0.0,194,194,0,0,0,gene,C33D12.2,0,3045797,0.148539,4526,3050362,39,3045783,53,14
X,-,3014277,0.00903614,0.0,332,329,3,0,1,gene,Y48D7A.2,0,3014269,1.27589,12965,3027242,8,3014277,0,-8
X,-,2923973,0.0142857,5.92923e-20,70,69,1,1,2,gene,F52B10.2,0,2923972,0.293369,21820,2945793,1,2923972,1,0
X,-,2891316,0.0,0.03125,5,5,0,0,1079,gene,B0410.3,0,2891274,1.52275,1171,2892487,42,2891484,-168,-210
X,-,2879572,0.00833333,0.0,360,357,3,3,5,gene,F53B3.5,0,2879564,2.41988,11034,2890606,8,2879612,-40,-48
X,-,2857233,0.0,1.11022e-16,53,53,0,0,156,gene,F53B3.1,0,2857230,0.585253,782,2858015,3,2857233,0,-3
X,-,2852402,0.0,0.25,2,2,0,0,88,gene,F58H12.1,0,2852380,0.537805,1265,2853667,22,2852472,-70,-92
X,-,2840285,0.0129032,2.60642e-43,155,153,2,2,0,gene,Y71H10B.1,0,2840275,1.64435,3630,2843915,10,2840285,0,-10
X,-,2838646,0.0,0.0,162,162,0,0,2,gene,Y71H10B.1,0,2838573,1.64435,5269,2843915,73,2838646,0,-73
X,-,2826822,0.0,1.81899e-12,39,39,0,0,1,gene,C14A11.7,0,2826804,0.134,7388,2834210,18,2826820,2,-16
X,-,2814138,0.0,1.90735e-06,19,19,0,0,2,gene,C14A11.6,0,2814118,0.309157,9320,2823458,20,2814118,20,0
X,-,2809647,0.0,0.25,2,2,0,0,3,gene,C14A11.9,0,2809624,None,830,2810477,23,2809624,23,0
X,-,2809628,0.00226757,0.0,441,440,1,1,20,gene,C14A11.9,0,2809624,None,849,2810477,4,2809624,4,0
X,-,2747970,0.0,0.0625,4,4,0,0,0,gene,T02C5.5,0,2747771,0.780672,8321,2756291,199,2747970,0,-199
X,-,2736399,0.0,1.52588e-05,16,16,0,0,0,gene,T02C5.5,0,2736364,0.780672,19892,2756291,35,2736271,128,93
X,-,2730628,0.0,0.25,2,2,0,0,0,gene,T02C5.5,0,2730551,0.780672,25663,2756291,77,2730628,0,-77
X,-,2719580,1.0,0.125,3,0,3,0,0,gene,T02C5.5,0,2719546,0.780672,36711,2756291,34,2719580,0,-34
X,-,2716997,0.0,0.5,1,1,0,0,4,gene,T02C5.5,0,2716906,0.780672,39294,2756291,91,2716997,0,-91
X,-,2713390,0.0,0.5,1,1,0,0,2,gene,T02C5.5,0,2713333,0.780672,42901,2756291,57,2713390,0,-57
X,-,2705853,0.0021978,0.0,1820,1816,4,3,18,gene,T02C5.3,0,2705850,2.67726,5061,2710914,3,2705850,3,0
X,-,2687177,0.0011655,0.0,858,857,1,1,0,gene,T14G11.3,0,2687150,1.78837,11069,2698246,27,2687177,0,-27
X,-,2664336,0.0,0.03125,5,5,0,0,0,gene,F54G2.1,0,2664317,0.363704,18484,2682820,19,2664366,-30,-49
X,-,2637802,0.0,0.03125,5,5,0,0,2,gene,F54G2.2,0,2637793,0.00486653,45018,2682820,9,2637793,9,0
X,-,2615719,0.00657895,0.0,456,453,3,1,3,gene,T03G6.3,0,2615719,1.20496,5548,2621267,0,2615719,0,0
X,-,2580568,0.0106952,0.0,187,185,2,2,2,gene,H01M10.1,0,2580567,0.302632,3823,2584391,1,2580562,6,5
X,-,2572647,0.0,2.91038e-11,35,35,0,0,0,gene,F52H2.7,0,2572647,0.17942,5558,2578205,0,2572647,0,0
X,-,2564141,0.043771,0.0,297,284,13,8,0,gene,F52H2.6,0,2564139,0.391612,2399,2566540,2,2564139,2,0
X,-,2559420,0.0333333,2.79397e-08,30,29,1,0,13,gene,F52H2.5,0,2559399,0.302552,40,2559460,21,2559420,0,-21
X,-,2541047,0.0172414,8.02872e-32,116,114,2,1,3,gene,F52H2.3,0,2541041,0.252739,2174,2543221,6,2541067,-20,-26
X,-,2532387,0.00473934,0.0,211,210,1,1,7,gene,R11B5.1,0,2532269,0.845445,7673,2540060,118,2532772,-385,-503
X,-,2515310,0.0425532,7.68097e-12,47,45,2,1,0,gene,K02E10.8,0,2515302,0.300249,9875,2525185,8,2515310,0,-8
X,-,2483193,0.0,0.125,3,3,0,0,1,gene,K02E10.6,0,2483193,0.303567,17795,2500988,0,2482904,289,289
X,-,2478837,0.0,2.27374e-13,42,42,0,0,3,gene,K02E10.5,0,2478786,0.0325028,1910,2480747,51,2478758,79,28
X,-,2450497,0.00175747,0.0,569,568,1,0,1,gene,T07D1.4,0,2450488,0.852922,16544,2467041,9,2450497,0,-9
X,-,2439151,0.0023753,0.0,421,420,1,1,5,gene,T07D1.2,0,2439107,1.05042,3812,2442963,44,2439151,0,-44
X,-,2344748,0.0,4.03897e-28,91,91,0,0,1,gene,T24D8.5,0,2344678,0.297914,20912,2365660,70,2344759,-11,-81
X,-,2338193,0.0,0.03125,5,5,0,0,37,gene,T01B6.4,0,2338172,0.360545,890,2339083,21,2338299,-106,-127
X,-,2319317,0.00666667,1.05097e-43,150,149,1,1,0,gene,T01B6.3,0,2319290,0.525134,18464,2337781,27,2319326,-9,-36
X,-,2287182,0.00176991,0.0,565,564,1,0,1,gene,T10H10.3,0,2287181,0.355478,27784,2314966,1,2287181,1,0
X,-,2274330,0.0,3.05176e-05,15,15,0,0,0,gene,AH9.4,0,2274309,0.0322966,9661,2283991,21,2274330,0,-21
X,-,2260519,0.00576369,0.0,347,345,2,1,2,gene,AH9.3,0,2260514,0.517323,2645,2263164,5,2260519,0,-5
X,-,2258094,0.0,7.88861e-31,100,100,0,0,1,gene,AH9.2,0,2258067,0.225488,1049,2259143,27,2258074,20,-7
X,-,2242611,0.00233507,0.0,56101,55970,131,102,0,gene,F07D10.1,0,2242609,61.8657,615,2243226,2,2242611,0,-2
X,-,2230088,0.0,0.00390625,8,8,0,0,194,gene,T14F9.5,0,2230077,0.289983,11650,2241738,11,2230094,-6,-17
X,-,2203763,0.0,0.0625,4,4,0,0,28,gene,T24C12.3,0,2203708,0.33539,278,2204041,55,2203887,-124,-179
X,-,2176404,0.00634921,0.0,315,313,2,2,0,gene,F48B9.8,0,2176400,0.446365,20113,2196517,4,2176406,-2,-6
X,-,2149294,0.0,4.33681e-19,61,61,0,0,2,gene,F48B9.5,0,2149246,0.140561,24591,2173885,48,2149246,48,0
X,-,2145641,0.00100604,0.0,994,993,1,1,4,gene,EGAP7.1,0,2145639,2.55458,1633,2147274,2,2145641,0,-2
X,-,2130235,0.00917431,1.67941e-31,109,108,1,1,0,gene,F53B1.8,0,2130235,0.448988,1445,2131680,0,2130235,0,0
X,-,2113096,0.00195312,0.0,512,511,1,1,1,gene,F53B1.4,0,2113078,2.66525,1460,2114556,18,2113078,18,0
X,-,2070435,0.00338409,0.0,591,589,2,2,6,gene,F49H12.6,0,2070390,0.954811,25249,2095684,45,2070435,0,-45
X,-,2035192,0.0,0.000488281,11,11,0,0,11,gene,Y102A11A.6,0,2035187,0.128203,728,2035920,5,2035239,-47,-52
X,-,1998119,0.0,4.23516e-22,71,71,0,0,0,gene,Y40A1A.3,0,1998097,0.120309,32700,2030819,22,1998106,13,-9
X,-,1989601,0.00600601,0.0,333,331,2,2,1,gene,F52D2.4,0,1989599,0.376833,5896,1995497,2,1989599,2,0
X,-,1974456,0.0,0.5,1,1,0,0,2,gene,F52D2.5,0,1974340,0.00593468,12003,1986459,116,1974577,-121,-237
X,-,1913351,0.0,1.00974e-28,93,93,0,0,0,gene,ZC53.1,0,1913343,0.099434,8225,1921576,8,1913250,101,93
X,-,1897248,0.0,0.125,3,3,0,0,36,gene,B0294.1,0,1897154,0.858139,13689,1910937,94,1897337,-89,-183
X,-,1856166,0.00775194,1.89548e-37,129,128,1,1,1,gene,T26C11.7,1,1855870,0.491153,35959,1892125,296,1856166,0,-296
X,-,1852730,0.926829,4.17616e-40,205,15,190,146,2,gene,T26C11.6,3,1852730,0.304184,108,1852838,0,1852730,0,0
X,-,1848669,0.899582,6.66577e-40,239,24,215,161,2,gene,T26C11.5,4,1848669,0.260147,118,1848787,0,1848669,0,0
X,-,1848660,1.0,0.5,1,0,1,0,381,gene,T26C11.5,4,1848557,0.260147,127,1848787,103,1848669,-9,-112
X,-,1845534,0.0,2.77556e-17,55,55,0,0,6,gene,T26C11.4,0,1845501,0.220278,1068,1846602,33,1845531,3,-30
X,-,1821327,0.0,0.00390625,8,8,0,0,0,gene,C14E2.4,0,1821318,0.00813168,2281,1823608,9,1821318,9,0
X,-,1718574,0.0,0.25,2,2,0,0,0,gene,F07G6.7,0,1718563,0.074577,1464,1720038,11,1718563,11,0
X,-,1706654,0.0,0.0625,4,4,0,0,1,gene,F07G6.5,0,1706633,0.00277521,3554,1710208,21,1706633,21,0
X,-,1703939,0.0,0.0625,4,4,0,0,0,gene,C36C9.5,0,1703933,0.0167497,2408,1706347,6,1703933,6,0
X,-,1678114,0.00793651,1.48112e-36,126,125,1,1,0,gene,C36C9.3,0,1678102,0.0932501,11019,1689133,12,1678102,12,0
X,-,1668389,0.0,0.5,1,1,0,0,1,gene,R09H3.3,0,1668354,0.00453795,3210,1671599,35,1668075,314,279
X,-,1521482,0.00436681,0.0,229,228,1,1,2,gene,F09E10.8,0,1521421,0.771016,12918,1534400,61,1521482,0,-61
X,-,1497661,0.0,3.8147e-06,18,18,0,0,2,gene,F09E10.6,0,1497616,0.168519,2514,1500175,45,1497676,-15,-60
X,-,1464792,0.04,7.45058e-07,25,24,1,0,1,gene,D1005.6,0,1464758,0.0128893,6199,1470991,34,1464415,377,343
X,-,1446638,0.00369231,0.0,1625,1619,6,5,1,gene,W05H7.4,1,1446571,1.26566,6052,1452690,67,1446571,67,0
X,-,1440256,0.893204,2.17394e-33,206,22,184,98,1,gene,W05H7.3,2,1440243,0.594152,105,1440361,13,1440243,13,0
X,-,1393986,0.0,0.0,740,740,0,0,1,gene,F56C3.9,0,1393982,0.403685,2284,1396270,4,1393986,0,-4
X,-,1336910,0.00234742,0.0,426,425,1,1,1,gene,F21E9.3,0,1336900,0.518829,6873,1343783,10,1336910,0,-10
X,-,1329940,0.0,9.09495e-13,40,40,0,0,0,gene,F21E9.2,0,1329935,0.151915,5419,1335359,5,1329935,5,0
X,-,1255622,0.0,0.00195312,9,9,0,0,0,gene,C25G6.5,0,1255610,0.0455987,72352,1327974,12,1255628,-6,-18
X,-,1230753,0.0,4.76837e-07,21,21,0,0,0,gene,C46H3.3,0,1230741,0.0507843,2146,1232899,12,1230753,0,-12
X,-,1219259,0.00296736,0.0,337,336,1,1,5,gene,C46H3.2,0,1219241,0.523394,6958,1226217,18,1219259,0,-18
X,-,1119402,0.00174368,0.0,1147,1145,2,2,1,gene,C05D9.7,0,1119394,0.675619,3016,1122418,8,1119404,-2,-10
X,-,1088145,0.00298063,0.0,671,669,2,1,0,gene,K03E6.7,0,1088121,0.912428,7400,1095545,24,1088145,0,-24
X,-,1080640,0.00267142,0.0,2246,2240,6,6,91,gene,K03E6.6,0,1080622,1.91608,3571,1084211,18,1080647,-7,-25
X,-,1062444,0.00873362,0.0,687,681,6,4,14,gene,K03E6.5,0,1062440,1.56205,4231,1066675,4,1062440,4,0
X,-,1046212,0.0,0.125,3,3,0,0,0,gene,F55A4.8,0,1046184,0.237303,1256,1047468,28,1046203,9,-19
X,-,1046203,0.0,0.0,260,260,0,0,2,gene,F55A4.8,0,1046184,0.237303,1265,1047468,19,1046203,0,-19
X,-,1026205,0.0,1.49012e-08,26,26,0,0,1,gene,F55A4.4,0,1026173,0.0356617,1465,1027670,32,1026173,32,0
X,-,1023809,0.0,1.35525e-20,66,66,0,0,2,gene,F55A4.3,0,1023777,0.103476,668,1024477,32,1023777,32,0
X,-,1023786,0.0,0.0625,4,4,0,0,83,gene,F55A4.3,0,1023777,0.103476,691,1024477,9,1023777,9,0
X,-,1017564,0.0,1.26218e-29,96,96,0,0,0,gene,F55A4.2,0,1017553,0.375644,5823,1023387,11,1017564,0,-11
X,-,991453,0.0,1.19209e-07,23,23,0,0,2,gene,C09E10.2,0,991371,0.331569,21263,1012716,82,991232,221,139
X,-,991232,0.0,0.5,1,1,0,0,4,gene,C09E10.2,0,991232,0.331569,21484,1012716,0,991232,0,0
X,-,978005,0.0,0.0,199,199,0,0,0,gene,C44C1.5,0,977999,0.619764,5095,983100,6,978005,0,-6
X,-,963262,0.0,7.62939e-06,17,17,0,0,1,gene,C44C1.3,0,963199,0.0857212,5809,969071,63,963199,63,0
X,-,948880,0.0,0.0,305,305,0,0,0,gene,F53H8.4,0,948880,0.490785,5610,954490,0,948882,-2,-2
X,-,924509,0.00934579,6.59438e-31,107,106,1,1,1,gene,F35H12.4,0,924507,0.21753,20322,944831,2,924514,-5,-7
X,-,902604,0.0,3.05176e-05,15,15,0,0,0,gene,ZC13.10,0,902597,0.0182192,17598,920202,7,902597,7,0
X,-,888392,0.0,9.53674e-07,20,20,0,0,4,gene,ZC13.3,0,888385,0.148108,3831,892223,7,888392,0,-7
X,-,871018,0.0,1.49012e-08,26,26,0,0,209,gene,F56F10.4,0,870997,0.259338,11930,882948,21,871078,-60,-81
X,-,863577,0.0,0.0,365,365,0,0,2,gene,F56F10.3,0,863573,1.08995,1181,864758,4,863850,-273,-277
X,-,863555,0.0,0.0625,4,4,0,0,1084,gene,F56F10.3,0,863512,1.08995,1203,864758,43,863850,-295,-338
X,-,851518,0.0,9.31323e-10,30,30,0,0,0,gene,F39H12.4,0,851500,0.37351,10748,862266,18,851506,12,-6
X,-,841492,0.0121951,0.0,246,243,3,3,0,gene,F39H12.3,0,841489,0.793682,4238,845730,3,841494,-2,-5
X,-,825472,0.00598802,0.0,167,166,1,0,0,gene,F25E2.5,0,825425,0.62661,12673,838145,47,825472,0,-47
X,-,815928,0.0,0.0,371,371,0,0,0,gene,F25E2.4,0,815916,0.839253,1997,817925,12,815928,0,-12
X,-,813106,0.0,1.03398e-25,83,83,0,0,13,gene,F25E2.3,0,813099,0.270679,745,813851,7,813125,-19,-26
X,-,768068,0.00222552,0.0,8088,8070,18,16,5,gene,T04G9.5,0,768064,17.303,13014,781082,4,768068,0,-4
X,-,759731,0.0266667,7.34536e-20,75,73,2,0,2,gene,C02H7.3,0,759721,0.266961,7281,767012,10,759731,0,-10
X,-,735715,0.0,0.0078125,7,7,0,0,0,gene,C02H7.2,0,735671,0.0221403,15485,751200,44,735671,44,0
X,-,725956,0.0,0.0,541,541,0,0,0,gene,M02A10.3,0,725954,0.813057,5201,731157,2,725956,0,-2
X,-,710006,0.0,0.015625,6,6,0,0,1,gene,M02A10.2,0,709998,0.0534012,10323,720329,8,710006,0,-8
X,-,682790,0.0,0.000244141,12,12,0,0,1,gene,Y9C12A.1,0,682779,0.115986,20442,703232,11,682779,11,0
X,-,666219,0.0,0.00195312,9,9,0,0,1,gene,T19D7.5,0,666200,0.114422,3464,669683,19,666200,19,0
X,-,661776,0.0,0.000976562,10,10,0,0,0,gene,T19D7.4,0,661756,0.0965611,2937,664713,20,661776,0,-20
X,-,652132,0.0,0.5,1,1,0,0,0,gene,M6.1,0,652125,2.52289,6322,658454,7,652132,0,-7
X,-,650105,0.0,0.0,154,154,0,0,0,gene,M6.1,0,650091,2.52289,8349,658454,14,650091,14,0
X,-,621290,0.00280112,0.0,357,356,1,0,1,gene,F13C5.6,0,621278,0.776198,12393,633683,12,621290,0,-12
X,-,608492,0.0,0.0,163,163,0,0,0,gene,F13C5.5,0,608485,0.828272,2628,611120,7,608492,0,-7
X,-,587483,0.0,2.46519e-32,105,105,0,0,1,gene,F57C12.5,1,587476,0.784545,8736,596219,7,587483,0,-7
X,-,586387,0.0,0.25,2,2,0,0,0,gene,F57C12.5,1,586373,0.784545,9832,596219,14,586387,0,-14
X,-,572702,0.0416667,1.43051e-06,24,23,1,1,1,gene,F57C12.4,2,572644,0.153356,3615,576317,58,572702,0,-58
X,-,557420,0.0,0.0078125,7,7,0,0,0,gene,F57C12.3,0,557360,0.018551,6303,563723,60,557192,228,168
X,-,551369,0.0,9.09495e-13,40,40,0,0,1,gene,F57C12.2,0,551368,0.0866658,1951,553320,1,551376,-7,-8
X,-,535757,0.0,0.0,187,187,0,0,4,gene,F28C10.3,0,535748,0.253127,1427,537184,9,535835,-78,-87
X,-,530075,0.0,0.0625,4,4,0,0,57,gene,B0310.5,0,530036,1.14384,480,530555,39,530177,-102,-141
X,-,514532,0.0,2.84217e-14,45,45,0,0,0,gene,B0310.3,0,514483,0.0705422,6078,520610,49,514483,49,0
X,-,506944,0.142857,0.0546875,7,6,1,0,1,gene,B0310.2,0,506934,0.395215,3863,510807,10,506944,0,-10
X,-,448934,0.0,5.96046e-08,24,24,0,0,1,gene,F52D1.2,0,448904,0.109815,1512,450446,30,448904,30,0
X,-,433800,0.00223714,0.0,447,446,1,1,1,gene,ZK1193.5,0,433794,0.984558,12456,446256,6,433800,0,-6
X,-,388797,0.0,8.67362e-19,60,60,0,0,9,gene,R04A9.5,0,388796,0.24796,719,389516,1,388797,0,-1
X,-,382710,0.00524246,0.0,1526,1518,8,6,3,gene,R04A9.4,1,382704,2.28198,1672,384382,6,382710,0,-6
X,-,380606,0.848485,3.39743e-13,99,15,84,36,1,gene,R04A9.3,2,380577,0.275692,738,381344,29,380569,37,8
X,-,346300,0.0,0.5,1,1,0,0,1,gene,C04E7.3,0,346289,0.112426,30818,377118,11,346289,11,0
X,-,252795,0.0,0.0625,4,4,0,0,0,gene,AC8.1,0,252767,None,16959,269754,28,252767,28,0
X,-,229782,0.0,6.93889e-18,57,57,0,0,0,gene,AC8.3,0,229761,0,5869,235651,21,229761,21,0
X,-,215586,0.0,1.19209e-07,23,23,0,0,0,gene,Y73B3B.2,0,215575,0.000200474,1469,217055,11,215575,11,0
X,-,163137,0.0,1.42109e-14,46,46,0,0,0,gene,T08D2.1,0,163134,0.0258226,16774,179911,3,163134,3,0
X,-,138126,0.0,0.00390625,8,8,0,0,0,gene,Y73B3A.7,0,138118,0,7818,145944,8,138075,51,43
X,-,104775,0.0,4.44089e-16,51,51,0,0,0,gene,Y73B3A.4,0,104762,0.0489988,2194,106969,13,104762,13,0
X,-,34439,0.0,6.31089e-30,97,97,0,0,0,gene,Y35H6.3,0,34439,0.00862063,8226,42665,0,34439,0,0
